post,comment,like,total_count,max_delta,last_person_event,max_delta_period_start,max_delta_period_end,id
652,6006,7504,14162,"8 days, 2:55:35",2013-02-22 09:17:52,2013-02-11 05:47:27,2013-02-19 08:43:02,4640
15,4516,5523,10054,"10 days, 22:24:22",2013-02-19 07:01:18,2013-02-19 07:01:18,2013-03-02 05:25:40,70
7,2761,3034,5802,"11 days, 19:50:35",2013-02-19 00:11:09,2010-02-01 10:32:08,2010-02-13 06:22:43,905
1020,6579,8102,15701,"11 days, 22:31:06",2013-02-18 06:54:34,2013-02-18 06:54:34,2013-03-02 05:25:40,1597
102,1439,2598,4139,"12 days, 15:38:21",2013-02-20 01:00:55,2013-02-07 09:22:34,2013-02-20 01:00:55,98
173,4542,5838,10553,"12 days, 20:01:57",2013-02-20 05:54:59,2013-02-07 09:53:02,2013-02-20 05:54:59,1847
2019,8539,8445,19003,"12 days, 20:50:41",2013-02-17 08:34:59,2013-02-17 08:34:59,2013-03-02 05:25:40,9660
130,6776,5291,12197,"12 days, 23:22:49",2013-02-17 06:02:51,2013-02-17 06:02:51,2013-03-02 05:25:40,8054
1056,9277,7044,17377,"13 days, 3:54:46",2013-02-17 01:30:54,2013-02-17 01:30:54,2013-03-02 05:25:40,6322
617,4744,5097,10458,"13 days, 16:45:39",2013-02-20 04:07:12,2013-02-06 11:21:33,2013-02-20 04:07:12,1907
695,2887,2872,6454,"13 days, 18:10:31",2013-02-16 11:15:09,2013-02-16 11:15:09,2013-03-02 05:25:40,9699
715,5751,6851,13317,"13 days, 19:29:05",2013-02-20 00:36:02,2010-02-01 10:32:08,2010-02-15 06:01:13,1327
45,3634,5086,8765,"14 days, 21:18:47",2013-02-15 08:06:53,2013-02-15 08:06:53,2013-03-02 05:25:40,8328
1193,8903,8058,18154,"14 days, 22:00:00",2013-02-15 07:25:40,2013-02-15 07:25:40,2013-03-02 05:25:40,6527
1010,3969,4541,9520,"14 days, 23:18:17",2013-02-16 03:00:15,2010-02-01 10:32:08,2010-02-16 09:50:25,7432
232,1440,2342,4014,"15 days, 2:50:22",2013-02-15 02:35:18,2013-02-15 02:35:18,2013-03-02 05:25:40,3628
433,2956,2765,6154,"15 days, 7:18:04",2013-02-19 01:41:20,2010-05-12 00:11:37,2010-05-27 07:29:41,1575
1728,5464,6530,13722,"15 days, 20:24:46",2013-02-14 09:00:54,2013-02-14 09:00:54,2013-03-02 05:25:40,9696
2239,6765,7183,16187,"15 days, 21:15:46",2013-02-14 08:09:54,2013-02-14 08:09:54,2013-03-02 05:25:40,9549
134,998,1446,2578,"15 days, 22:13:21",2013-02-14 07:12:19,2013-02-14 07:12:19,2013-03-02 05:25:40,7383
626,1613,2383,4622,"15 days, 23:54:02",2013-02-14 05:31:38,2013-02-14 05:31:38,2013-03-02 05:25:40,3970
645,9118,8331,18094,"16 days, 2:39:51",2013-02-14 02:45:49,2013-02-14 02:45:49,2013-03-02 05:25:40,9900
226,1491,2138,3855,"16 days, 3:18:51",2013-02-14 02:06:49,2013-02-14 02:06:49,2013-03-02 05:25:40,6500
391,7740,7959,16090,"16 days, 17:40:21",2013-02-13 11:45:19,2013-02-13 11:45:19,2013-03-02 05:25:40,6996
2187,2906,4393,9486,"16 days, 18:02:09",2013-02-13 11:23:31,2013-02-13 11:23:31,2013-03-02 05:25:40,6654
68,2355,4441,6864,"16 days, 18:03:44",2013-02-17 02:09:31,2010-02-01 10:32:08,2010-02-18 04:35:52,6395
2143,4693,4884,11720,"16 days, 20:00:59",2013-02-23 06:37:21,2013-02-06 10:36:22,2013-02-23 06:37:21,2263
110,5017,4944,10071,"16 days, 21:12:40",2013-02-13 08:13:00,2013-02-13 08:13:00,2013-03-02 05:25:40,6857
409,6346,6210,12965,"16 days, 21:23:55",2013-02-13 08:01:45,2013-02-13 08:01:45,2013-03-02 05:25:40,4702
976,2473,4124,7573,"17 days, 0:37:16",2013-02-13 04:48:24,2013-02-13 04:48:24,2013-03-02 05:25:40,945
215,4189,5270,9674,"17 days, 1:31:31",2013-02-13 03:54:09,2013-02-13 03:54:09,2013-03-02 05:25:40,6098
1318,6034,6596,13948,"17 days, 1:32:32",2013-02-13 03:53:08,2013-02-13 03:53:08,2013-03-02 05:25:40,9333
36,7760,7697,15493,"17 days, 2:06:45",2013-02-13 03:18:55,2013-02-13 03:18:55,2013-03-02 05:25:40,9421
282,818,1098,2198,"17 days, 2:06:57",2013-02-21 08:21:00,2010-03-02 06:17:18,2010-03-19 08:24:15,1624
1264,5284,6263,12811,"17 days, 2:14:25",2013-02-13 03:11:15,2013-02-13 03:11:15,2013-03-02 05:25:40,8350
51,5651,6806,12508,"17 days, 2:15:11",2013-02-13 03:10:29,2013-02-13 03:10:29,2013-03-02 05:25:40,5335
411,3091,3950,7452,"17 days, 15:22:29",2013-02-22 06:04:51,2010-02-01 10:32:08,2010-02-19 01:54:37,3688
569,4325,5069,9963,"17 days, 16:24:18",2013-02-25 02:43:57,2013-02-07 10:19:39,2013-02-25 02:43:57,6440
1211,8013,7402,16626,"17 days, 18:42:53",2013-02-12 10:42:47,2013-02-12 10:42:47,2013-03-02 05:25:40,265
1589,1553,3160,6302,"17 days, 20:38:06",2013-02-12 08:47:34,2013-02-12 08:47:34,2013-03-02 05:25:40,6768
1373,4576,5834,11783,"17 days, 21:29:48",2013-02-12 07:55:52,2013-02-12 07:55:52,2013-03-02 05:25:40,2713
1630,6361,6825,14816,"17 days, 23:58:25",2013-02-12 05:27:15,2013-02-12 05:27:15,2013-03-02 05:25:40,9434
613,5280,7250,13143,"18 days, 1:22:27",2013-02-12 04:03:13,2013-02-12 04:03:13,2013-03-02 05:25:40,2490
783,3043,2697,6523,"18 days, 2:34:23",2013-02-12 02:51:17,2013-02-12 02:51:17,2013-03-02 05:25:40,8058
2290,7248,8043,17581,"18 days, 4:59:47",2013-02-12 00:25:53,2013-02-12 00:25:53,2013-03-02 05:25:40,8457
862,475,495,1832,"18 days, 5:05:19",2013-02-12 00:20:21,2013-02-12 00:20:21,2013-03-02 05:25:40,9620
150,2391,3082,5623,"18 days, 17:44:30",2013-02-11 11:41:10,2013-02-11 11:41:10,2013-03-02 05:25:40,742
33,639,1194,1866,"18 days, 17:48:57",2013-02-11 11:36:43,2013-02-11 11:36:43,2013-03-02 05:25:40,5842
2450,7780,7461,17691,"18 days, 18:07:08",2013-02-14 10:30:47,2010-02-01 10:32:08,2010-02-20 04:39:16,9225
75,6876,5653,12604,"18 days, 18:39:13",2013-02-11 10:46:27,2013-02-11 10:46:27,2013-03-02 05:25:40,1693
23,3149,5112,8284,"18 days, 18:40:06",2013-02-11 10:45:34,2013-02-11 10:45:34,2013-03-02 05:25:40,6474
608,5058,5435,11101,"18 days, 19:25:30",2013-02-25 02:41:11,2013-02-06 07:15:41,2013-02-25 02:41:11,7512
618,3720,6478,10816,"18 days, 20:14:13",2013-02-11 09:11:27,2013-02-11 09:11:27,2013-03-02 05:25:40,8452
901,5347,4633,10881,"18 days, 20:31:19",2013-02-11 08:54:21,2013-02-11 08:54:21,2013-03-02 05:25:40,5343
31,2304,2430,4765,"18 days, 21:13:06",2013-02-11 08:12:34,2013-02-11 08:12:34,2013-03-02 05:25:40,9121
2203,2742,4277,9222,"18 days, 21:42:13",2013-02-11 07:43:27,2013-02-11 07:43:27,2013-03-02 05:25:40,7300
89,4566,5402,10057,"18 days, 22:05:01",2013-02-11 07:20:39,2013-02-11 07:20:39,2013-03-02 05:25:40,1556
2021,7091,7308,16420,"18 days, 22:11:13",2013-02-11 07:14:27,2013-02-11 07:14:27,2013-03-02 05:25:40,5226
834,4935,6874,12643,"18 days, 23:01:09",2013-02-11 06:24:31,2013-02-11 06:24:31,2013-03-02 05:25:40,5989
56,3798,3925,7779,"18 days, 23:36:58",2013-02-15 07:16:03,2010-02-01 10:32:08,2010-02-20 10:09:06,9429
1345,2714,3380,7439,"18 days, 23:45:05",2013-02-11 05:40:35,2013-02-11 05:40:35,2013-03-02 05:25:40,2885
122,6112,8355,14589,"19 days, 0:22:55",2013-02-11 05:02:45,2013-02-11 05:02:45,2013-03-02 05:25:40,7435
683,6208,5079,11970,"19 days, 2:42:19",2013-02-11 02:43:21,2013-02-11 02:43:21,2013-03-02 05:25:40,6214
109,2144,2567,4820,"19 days, 4:33:02",2013-02-11 00:52:38,2013-02-11 00:52:38,2013-03-02 05:25:40,4748
273,2416,3510,6199,"19 days, 4:33:38",2013-02-11 00:52:02,2013-02-11 00:52:02,2013-03-02 05:25:40,6004
109,5313,6187,11609,"19 days, 17:38:39",2013-02-10 11:47:01,2013-02-10 11:47:01,2013-03-02 05:25:40,6439
918,8217,8696,17831,"19 days, 18:56:08",2013-02-10 10:29:32,2013-02-10 10:29:32,2013-03-02 05:25:40,8532
1262,3327,3837,8426,"19 days, 19:01:23",2013-02-10 10:24:17,2013-02-10 10:24:17,2013-03-02 05:25:40,7270
1786,5046,5820,12652,"19 days, 19:29:20",2013-02-10 09:56:20,2013-02-10 09:56:20,2013-03-02 05:25:40,8909
358,2068,3493,5919,"19 days, 19:39:42",2013-02-10 09:45:58,2013-02-10 09:45:58,2013-03-02 05:25:40,9400
50,636,1257,1943,"19 days, 19:43:24",2013-02-10 09:42:16,2013-02-10 09:42:16,2013-03-02 05:25:40,9484
1030,4138,5613,10781,"19 days, 20:10:31",2013-02-14 08:40:30,2010-02-01 10:32:08,2010-02-21 06:42:39,3445
2135,3790,3786,9711,"19 days, 20:20:03",2013-02-10 09:05:37,2013-02-10 09:05:37,2013-03-02 05:25:40,5207
78,5018,5786,10882,"19 days, 20:40:45",2013-02-10 08:44:55,2013-02-10 08:44:55,2013-03-02 05:25:40,7028
204,6168,7265,13637,"19 days, 20:54:25",2013-02-10 08:31:15,2013-02-10 08:31:15,2013-03-02 05:25:40,8614
278,6993,5951,13222,"19 days, 21:07:11",2013-02-11 07:41:39,2010-02-27 09:57:38,2010-03-19 07:04:49,6315
1122,3782,5468,10372,"19 days, 21:36:25",2013-02-10 07:49:15,2013-02-10 07:49:15,2013-03-02 05:25:40,9457
1180,8345,6730,16255,"19 days, 22:03:55",2013-02-10 07:21:45,2013-02-10 07:21:45,2013-03-02 05:25:40,2043
42,5539,5636,11217,"19 days, 22:41:59",2013-02-10 06:43:41,2013-02-10 06:43:41,2013-03-02 05:25:40,4853
1077,1695,2806,5578,"19 days, 23:31:24",2013-02-10 05:54:16,2013-02-10 05:54:16,2013-03-02 05:25:40,5002
735,1441,2787,4963,"19 days, 23:35:58",2013-02-10 05:49:42,2013-02-10 05:49:42,2013-03-02 05:25:40,8568
1251,1800,3001,6052,"20 days, 0:22:32",2013-02-26 00:35:55,2013-02-06 00:13:23,2013-02-26 00:35:55,4511
65,5596,5012,10673,"20 days, 0:26:38",2013-02-10 04:59:02,2013-02-10 04:59:02,2013-03-02 05:25:40,7179
1320,2380,3054,6754,"20 days, 0:29:31",2013-02-10 04:56:09,2013-02-10 04:56:09,2013-03-02 05:25:40,2317
304,3466,5608,9378,"20 days, 0:39:47",2013-02-10 04:45:53,2013-02-10 04:45:53,2013-03-02 05:25:40,8455
350,6848,6944,14142,"20 days, 1:02:15",2013-02-10 04:23:25,2013-02-10 04:23:25,2013-03-02 05:25:40,4229
2027,3784,6547,12358,"20 days, 1:37:45",2013-02-10 03:47:55,2013-02-10 03:47:55,2013-03-02 05:25:40,1321
40,2015,3934,5989,"20 days, 1:38:09",2013-02-10 03:47:31,2013-02-10 03:47:31,2013-03-02 05:25:40,5261
419,1034,1641,3094,"20 days, 1:43:55",2013-02-10 03:41:45,2013-02-10 03:41:45,2013-03-02 05:25:40,4850
71,6270,7380,13721,"20 days, 2:06:50",2013-02-10 03:18:50,2013-02-10 03:18:50,2013-03-02 05:25:40,5739
336,7126,7204,14666,"20 days, 3:01:11",2013-02-10 02:24:29,2013-02-10 02:24:29,2013-03-02 05:25:40,1386
399,10314,8184,18897,"20 days, 3:10:23",2013-02-10 02:15:17,2013-02-10 02:15:17,2013-03-02 05:25:40,1892
1921,3432,4681,10034,"20 days, 3:18:09",2013-02-10 02:07:31,2013-02-10 02:07:31,2013-03-02 05:25:40,9792
155,7358,7587,15100,"20 days, 3:30:03",2013-02-10 01:55:37,2013-02-10 01:55:37,2013-03-02 05:25:40,6706
34,1480,1988,3502,"20 days, 4:44:36",2013-02-10 00:41:04,2013-02-10 00:41:04,2013-03-02 05:25:40,9461
171,7070,6368,13609,"20 days, 5:16:30",2013-02-10 00:09:10,2013-02-10 00:09:10,2013-03-02 05:25:40,7926
25,570,1137,1732,"20 days, 13:49:09",2013-02-13 05:01:14,2010-02-01 10:32:08,2010-02-22 00:21:17,792
256,235,745,1236,"20 days, 15:26:34",2013-02-14 11:46:35,2010-02-01 10:32:08,2010-02-22 01:58:42,5673
661,1728,1795,4184,"20 days, 17:28:02",2013-02-09 11:57:38,2013-02-09 11:57:38,2013-03-02 05:25:40,5683
508,3632,4047,8187,"20 days, 17:43:09",2013-02-09 11:42:31,2013-02-09 11:42:31,2013-03-02 05:25:40,1417
428,7355,5614,13397,"20 days, 17:49:57",2013-02-09 11:35:43,2013-02-09 11:35:43,2013-03-02 05:25:40,492
1524,10931,8388,20843,"20 days, 17:55:07",2013-02-09 11:30:33,2013-02-09 11:30:33,2013-03-02 05:25:40,8295
118,4014,5021,9153,"20 days, 18:16:59",2013-02-09 11:08:41,2013-02-09 11:08:41,2013-03-02 05:25:40,9776
371,6509,5545,12425,"20 days, 18:19:53",2013-02-27 04:56:55,2013-02-06 10:37:02,2013-02-27 04:56:55,7558
573,6855,6259,13687,"20 days, 18:35:53",2013-02-09 10:49:47,2013-02-09 10:49:47,2013-03-02 05:25:40,5531
1434,9894,7269,18597,"20 days, 18:49:11",2013-02-09 10:36:29,2013-02-09 10:36:29,2013-03-02 05:25:40,7936
55,6146,5841,12042,"20 days, 18:50:34",2013-02-09 10:35:06,2013-02-09 10:35:06,2013-03-02 05:25:40,6144
2056,5652,7827,15535,"20 days, 18:50:43",2013-02-09 10:34:57,2013-02-09 10:34:57,2013-03-02 05:25:40,155
1646,7972,5188,14806,"20 days, 19:02:48",2013-02-09 10:22:52,2013-02-09 10:22:52,2013-03-02 05:25:40,1123
126,3888,4268,8282,"20 days, 19:31:44",2013-02-09 09:53:56,2013-02-09 09:53:56,2013-03-02 05:25:40,9284
653,2673,4074,7400,"20 days, 20:10:14",2013-02-09 09:15:26,2013-02-09 09:15:26,2013-03-02 05:25:40,8593
1845,9478,7979,19302,"20 days, 20:26:40",2013-02-09 08:59:00,2013-02-09 08:59:00,2013-03-02 05:25:40,7626
1077,5906,5892,12875,"20 days, 20:37:51",2013-02-09 08:47:49,2013-02-09 08:47:49,2013-03-02 05:25:40,1340
2246,4910,5779,12935,"20 days, 20:52:34",2013-02-09 08:33:06,2013-02-09 08:33:06,2013-03-02 05:25:40,1395
728,6078,6093,12899,"20 days, 20:53:18",2013-02-09 08:32:22,2013-02-09 08:32:22,2013-03-02 05:25:40,3846
2027,10008,9040,21075,"20 days, 20:54:30",2013-02-09 08:31:10,2013-02-09 08:31:10,2013-03-02 05:25:40,838
652,4056,5382,10090,"20 days, 21:38:56",2013-02-09 07:46:44,2013-02-09 07:46:44,2013-03-02 05:25:40,4709
285,3910,4441,8636,"20 days, 21:49:23",2013-02-09 07:36:17,2013-02-09 07:36:17,2013-03-02 05:25:40,4858
259,3427,3092,6778,"20 days, 22:04:36",2013-02-09 07:21:04,2013-02-09 07:21:04,2013-03-02 05:25:40,4849
1012,11810,7780,20602,"20 days, 22:22:07",2013-02-09 07:03:33,2013-02-09 07:03:33,2013-03-02 05:25:40,9817
132,3876,4642,8650,"20 days, 23:07:28",2013-02-11 04:57:24,2010-02-01 10:32:08,2010-02-22 09:39:36,7500
1514,5953,6818,14285,"20 days, 23:12:53",2013-02-09 09:48:42,2010-02-01 10:32:08,2010-02-22 09:45:01,3724
24,1470,1998,3492,"20 days, 23:30:37",2013-02-09 05:55:03,2013-02-09 05:55:03,2013-03-02 05:25:40,2630
2612,5113,6897,14622,"20 days, 23:47:05",2013-02-09 05:38:35,2013-02-09 05:38:35,2013-03-02 05:25:40,9025
642,5013,4281,9936,"21 days, 0:02:11",2013-02-09 05:23:29,2013-02-09 05:23:29,2013-03-02 05:25:40,3364
377,865,1652,2894,"21 days, 0:24:02",2013-02-09 05:01:38,2013-02-09 05:01:38,2013-03-02 05:25:40,5476
2121,6323,6924,15368,"21 days, 0:35:29",2013-02-09 04:50:11,2013-02-09 04:50:11,2013-03-02 05:25:40,6101
2374,4492,3869,10735,"21 days, 0:42:22",2013-02-09 04:43:18,2013-02-09 04:43:18,2013-03-02 05:25:40,6229
419,4525,6543,11487,"21 days, 0:48:26",2013-02-09 04:37:14,2013-02-09 04:37:14,2013-03-02 05:25:40,5648
704,4904,4852,10460,"21 days, 0:55:34",2013-02-09 04:30:06,2013-02-09 04:30:06,2013-03-02 05:25:40,6875
964,6280,6127,13371,"21 days, 1:31:16",2013-02-09 03:54:24,2013-02-09 03:54:24,2013-03-02 05:25:40,721
43,2140,2540,4723,"21 days, 1:34:32",2013-02-09 03:51:08,2013-02-09 03:51:08,2013-03-02 05:25:40,184
1895,8315,8156,18366,"21 days, 1:38:24",2013-02-09 03:47:16,2013-02-09 03:47:16,2013-03-02 05:25:40,24
1486,6398,6443,14327,"21 days, 2:09:14",2013-02-09 03:16:26,2013-02-09 03:16:26,2013-03-02 05:25:40,6070
1018,10674,8575,20267,"21 days, 2:20:17",2013-02-09 03:05:23,2013-02-09 03:05:23,2013-03-02 05:25:40,9814
1734,7570,6795,16099,"21 days, 2:20:21",2013-02-09 03:05:19,2013-02-09 03:05:19,2013-03-02 05:25:40,7205
704,8646,6989,16339,"21 days, 2:20:48",2013-02-09 03:04:52,2013-02-09 03:04:52,2013-03-02 05:25:40,8020
1445,826,979,3250,"21 days, 2:43:31",2013-02-09 02:42:09,2013-02-09 02:42:09,2013-03-02 05:25:40,5843
1144,4894,6559,12597,"21 days, 2:54:58",2013-02-09 02:30:42,2013-02-09 02:30:42,2013-03-02 05:25:40,4218
1634,8233,5629,15496,"21 days, 3:40:20",2013-02-09 01:45:20,2013-02-09 01:45:20,2013-03-02 05:25:40,1806
753,7857,6195,14805,"21 days, 4:27:20",2013-02-09 00:58:20,2013-02-09 00:58:20,2013-03-02 05:25:40,4870
2310,3468,3447,9225,"21 days, 4:28:51",2013-02-09 00:56:49,2013-02-09 00:56:49,2013-03-02 05:25:40,2646
653,8795,8281,17729,"21 days, 4:36:19",2013-02-09 00:49:21,2013-02-09 00:49:21,2013-03-02 05:25:40,1981
2387,11046,9787,23220,"21 days, 5:01:05",2013-02-09 00:24:35,2013-02-09 00:24:35,2013-03-02 05:25:40,7826
1325,3749,7224,12298,"21 days, 5:10:54",2013-02-09 00:14:46,2013-02-09 00:14:46,2013-03-02 05:25:40,9473
408,1441,2208,4057,"21 days, 5:55:07",2013-02-15 05:27:01,2010-02-17 03:16:16,2010-03-10 09:11:23,4429
546,1992,2505,5043,"21 days, 14:21:59",2013-02-09 11:42:13,2010-02-01 10:32:08,2010-02-23 00:54:07,5925
454,2741,4333,7528,"21 days, 15:23:19",2013-02-18 07:27:40,2010-02-01 10:32:08,2010-02-23 01:55:27,1367
79,5290,4272,9641,"21 days, 16:26:05",2013-02-09 03:02:42,2010-02-01 10:32:08,2010-02-23 02:58:13,676
591,885,1401,2877,"21 days, 16:37:14",2013-02-09 02:12:31,2010-02-01 10:32:08,2010-02-23 03:09:22,6864
479,3676,3824,7979,"21 days, 17:27:30",2013-02-08 11:58:10,2013-02-08 11:58:10,2013-03-02 05:25:40,4821
821,875,973,2669,"21 days, 17:30:32",2013-02-08 11:55:08,2013-02-08 11:55:08,2013-03-02 05:25:40,8560
2058,5457,7345,14860,"21 days, 17:52:18",2013-02-08 11:33:22,2013-02-08 11:33:22,2013-03-02 05:25:40,9357
2083,5773,4276,12132,"21 days, 17:59:03",2013-02-08 11:26:37,2013-02-08 11:26:37,2013-03-02 05:25:40,713
2704,8969,7150,18823,"21 days, 18:11:37",2013-02-08 11:14:03,2013-02-08 11:14:03,2013-03-02 05:25:40,7601
1714,4209,6693,12616,"21 days, 18:25:10",2013-02-08 11:00:30,2013-02-08 11:00:30,2013-03-02 05:25:40,38
882,3752,2830,7464,"21 days, 18:32:47",2013-02-13 01:13:51,2010-02-01 10:32:08,2010-02-23 05:04:55,1724
728,3906,3605,8239,"21 days, 18:38:51",2013-02-08 10:46:49,2013-02-08 10:46:49,2013-03-02 05:25:40,5341
290,5701,4568,10559,"21 days, 19:08:37",2013-02-08 10:17:03,2013-02-08 10:17:03,2013-03-02 05:25:40,1555
377,5616,5855,11848,"21 days, 19:16:23",2013-02-08 10:09:17,2013-02-08 10:09:17,2013-03-02 05:25:40,6954
1341,6898,6758,14997,"21 days, 19:19:50",2013-02-08 10:05:50,2013-02-08 10:05:50,2013-03-02 05:25:40,2196
814,2839,5256,8909,"21 days, 19:20:04",2013-02-08 10:05:36,2013-02-08 10:05:36,2013-03-02 05:25:40,9375
599,6994,4778,12371,"21 days, 19:44:46",2013-02-08 09:40:54,2013-02-08 09:40:54,2013-03-02 05:25:40,219
127,4443,5641,10211,"21 days, 20:00:43",2013-02-08 09:24:57,2013-02-08 09:24:57,2013-03-02 05:25:40,6684
410,1209,2104,3723,"21 days, 20:04:07",2013-02-16 07:15:23,2010-02-01 10:32:08,2010-02-23 06:36:15,5787
473,1012,2004,3489,"21 days, 20:12:21",2013-02-08 10:03:30,2010-02-01 10:32:08,2010-02-23 06:44:29,9500
766,6540,7154,14460,"21 days, 20:24:36",2013-02-08 09:01:04,2013-02-08 09:01:04,2013-03-02 05:25:40,5296
261,1395,2192,3848,"21 days, 20:34:26",2013-02-08 08:51:14,2013-02-08 08:51:14,2013-03-02 05:25:40,1418
50,1803,2349,4202,"21 days, 20:46:53",2013-02-08 08:38:47,2013-02-08 08:38:47,2013-03-02 05:25:40,5695
923,9592,9523,20038,"21 days, 20:54:50",2013-02-08 08:30:50,2013-02-08 08:30:50,2013-03-02 05:25:40,8852
2341,4711,3875,10927,"21 days, 21:00:10",2013-02-09 04:59:56,2010-02-01 10:32:08,2010-02-23 07:32:18,6508
559,2597,2654,5810,"21 days, 21:05:03",2013-02-08 08:20:37,2013-02-08 08:20:37,2013-03-02 05:25:40,8001
2022,6313,7579,15914,"21 days, 21:12:34",2013-02-08 08:13:06,2013-02-08 08:13:06,2013-03-02 05:25:40,3241
249,1905,2953,5107,"21 days, 21:21:14",2013-02-09 11:59:04,2010-02-01 10:32:08,2010-02-23 07:53:22,794
139,4558,4504,9201,"21 days, 21:58:31",2013-02-08 07:27:09,2013-02-08 07:27:09,2013-03-02 05:25:40,7977
794,4206,4338,9338,"21 days, 22:00:54",2013-02-08 07:24:46,2013-02-08 07:24:46,2013-03-02 05:25:40,4264
377,4214,5866,10457,"21 days, 22:29:00",2013-02-08 06:56:40,2013-02-08 06:56:40,2013-03-02 05:25:40,9387
89,4625,4372,9086,"21 days, 22:32:57",2013-02-08 06:52:43,2013-02-08 06:52:43,2013-03-02 05:25:40,5592
1420,4193,5775,11388,"21 days, 22:42:28",2013-02-08 06:43:12,2013-02-08 06:43:12,2013-03-02 05:25:40,7507
1767,5607,3857,11231,"21 days, 22:43:52",2013-02-08 06:41:48,2013-02-08 06:41:48,2013-03-02 05:25:40,1923
641,2399,3041,6081,"21 days, 22:50:16",2013-02-08 06:35:24,2013-02-08 06:35:24,2013-03-02 05:25:40,379
1703,4403,4721,10827,"21 days, 22:52:05",2013-02-08 06:33:35,2013-02-08 06:33:35,2013-03-02 05:25:40,8285
1553,2676,4311,8540,"21 days, 22:54:27",2013-02-11 00:34:18,2010-02-05 04:32:22,2010-02-27 03:26:49,4966
316,3486,3945,7747,"21 days, 23:01:39",2013-02-08 06:24:01,2013-02-08 06:24:01,2013-03-02 05:25:40,4983
95,6524,7558,14177,"21 days, 23:06:19",2013-02-08 06:19:21,2013-02-08 06:19:21,2013-03-02 05:25:40,2681
351,1045,1441,2837,"21 days, 23:11:57",2013-02-08 06:13:43,2013-02-08 06:13:43,2013-03-02 05:25:40,6153
54,5370,6057,11481,"21 days, 23:13:53",2013-02-08 06:11:47,2013-02-08 06:11:47,2013-03-02 05:25:40,1064
225,7260,6081,13566,"21 days, 23:21:54",2013-02-08 06:03:46,2013-02-08 06:03:46,2013-03-02 05:25:40,100
956,3460,3852,8268,"21 days, 23:23:57",2013-02-08 06:01:43,2013-02-08 06:01:43,2013-03-02 05:25:40,6267
1119,666,1334,3119,"21 days, 23:35:25",2013-02-08 05:50:15,2013-02-08 05:50:15,2013-03-02 05:25:40,731
1405,6219,6058,13682,"21 days, 23:40:58",2013-02-08 11:07:24,2010-02-01 10:32:08,2010-02-23 10:13:06,7928
261,3845,5510,9616,"22 days, 0:00:51",2013-02-09 00:19:17,2010-02-01 10:32:08,2010-02-23 10:32:59,3274
515,1620,2447,4582,"22 days, 0:11:56",2013-02-08 05:13:44,2013-02-08 05:13:44,2013-03-02 05:25:40,7986
66,4130,4679,8875,"22 days, 0:13:06",2013-02-08 05:12:34,2013-02-08 05:12:34,2013-03-02 05:25:40,347
184,3708,5074,8966,"22 days, 0:20:38",2013-02-08 05:05:02,2013-02-08 05:05:02,2013-03-02 05:25:40,8898
1513,6405,5055,12973,"22 days, 0:24:01",2013-02-08 05:01:39,2013-02-08 05:01:39,2013-03-02 05:25:40,2256
450,7890,3856,12196,"22 days, 0:25:34",2013-02-08 05:00:06,2013-02-08 05:00:06,2013-03-02 05:25:40,4980
533,6916,8059,15508,"22 days, 0:29:15",2013-02-08 04:56:25,2013-02-08 04:56:25,2013-03-02 05:25:40,6331
3115,10311,7303,20729,"22 days, 0:30:58",2013-02-08 04:54:42,2013-02-08 04:54:42,2013-03-02 05:25:40,7867
917,5318,6403,12638,"22 days, 0:36:09",2013-02-15 02:55:12,2010-02-01 10:32:08,2010-02-23 11:08:17,8180
1141,6821,7960,15922,"22 days, 0:38:43",2013-02-08 04:46:57,2013-02-08 04:46:57,2013-03-02 05:25:40,5263
1427,3234,3283,7944,"22 days, 0:47:08",2013-02-11 01:07:25,2010-02-01 10:32:08,2010-02-23 11:19:16,1442
1398,7409,7091,15898,"22 days, 0:49:43",2013-02-08 04:35:57,2013-02-08 04:35:57,2013-03-02 05:25:40,1374
978,5285,6667,12930,"22 days, 1:03:50",2013-02-08 04:21:50,2013-02-08 04:21:50,2013-03-02 05:25:40,4686
64,5003,7604,12671,"22 days, 1:06:49",2013-02-08 04:18:51,2013-02-08 04:18:51,2013-03-02 05:25:40,2571
121,7541,9360,17022,"22 days, 1:08:08",2013-02-08 04:17:32,2013-02-08 04:17:32,2013-03-02 05:25:40,3520
109,5791,5536,11436,"22 days, 1:10:27",2013-02-08 04:15:13,2013-02-08 04:15:13,2013-03-02 05:25:40,6010
1028,6842,5881,13751,"22 days, 1:18:04",2013-02-08 04:07:36,2013-02-08 04:07:36,2013-03-02 05:25:40,7742
826,1346,1775,3947,"22 days, 1:18:37",2013-02-08 04:07:03,2013-02-08 04:07:03,2013-03-02 05:25:40,8517
125,5207,4934,10266,"22 days, 1:47:46",2013-02-15 08:20:28,2010-02-25 07:30:56,2010-03-19 09:18:42,1318
343,2431,3583,6357,"22 days, 1:48:23",2013-02-08 03:37:17,2013-02-08 03:37:17,2013-03-02 05:25:40,7424
406,9970,8303,18679,"22 days, 2:00:14",2013-02-08 03:25:26,2013-02-08 03:25:26,2013-03-02 05:25:40,5762
200,3889,4450,8539,"22 days, 2:01:07",2013-02-08 03:24:33,2013-02-08 03:24:33,2013-03-02 05:25:40,7265
536,5522,5507,11565,"22 days, 2:09:39",2013-02-08 03:16:01,2013-02-08 03:16:01,2013-03-02 05:25:40,4622
763,6149,6886,13798,"22 days, 2:25:26",2013-02-08 03:00:14,2013-02-08 03:00:14,2013-03-02 05:25:40,6780
1876,5657,6543,14076,"22 days, 2:40:20",2013-02-08 02:45:20,2013-02-08 02:45:20,2013-03-02 05:25:40,8207
1271,5105,6361,12737,"22 days, 2:40:23",2013-02-08 02:45:17,2013-02-08 02:45:17,2013-03-02 05:25:40,8993
130,7595,8252,15977,"22 days, 2:41:07",2013-02-08 02:44:33,2013-02-08 02:44:33,2013-03-02 05:25:40,9280
1556,5485,6478,13519,"22 days, 2:51:18",2013-02-08 02:34:22,2013-02-08 02:34:22,2013-03-02 05:25:40,5764
994,10433,7613,19040,"22 days, 3:04:04",2013-02-08 02:21:36,2013-02-08 02:21:36,2013-03-02 05:25:40,1697
338,4152,5172,9662,"22 days, 3:11:28",2013-02-08 02:14:12,2013-02-08 02:14:12,2013-03-02 05:25:40,951
363,6084,6735,13182,"22 days, 3:17:37",2013-02-08 02:08:03,2013-02-08 02:08:03,2013-03-02 05:25:40,2415
2141,2820,5138,10099,"22 days, 3:33:00",2013-02-08 01:52:40,2013-02-08 01:52:40,2013-03-02 05:25:40,1033
711,7621,7269,15601,"22 days, 3:35:05",2013-02-08 01:50:35,2013-02-08 01:50:35,2013-03-02 05:25:40,6969
806,1392,2471,4669,"22 days, 3:44:02",2013-02-08 01:41:38,2013-02-08 01:41:38,2013-03-02 05:25:40,5000
528,4703,5894,11125,"22 days, 3:56:11",2013-02-08 01:29:29,2013-02-08 01:29:29,2013-03-02 05:25:40,5396
1740,4521,7092,13353,"22 days, 4:00:38",2013-02-08 01:25:02,2013-02-08 01:25:02,2013-03-02 05:25:40,9237
316,4210,6248,10774,"22 days, 4:10:40",2013-02-08 01:15:00,2013-02-08 01:15:00,2013-03-02 05:25:40,6806
638,5512,7668,13818,"22 days, 4:24:32",2013-02-08 01:01:08,2013-02-08 01:01:08,2013-03-02 05:25:40,3368
189,1437,2632,4258,"22 days, 4:24:57",2013-02-08 01:00:43,2013-02-08 01:00:43,2013-03-02 05:25:40,4321
140,709,1354,2203,"22 days, 4:29:52",2013-02-08 00:55:48,2013-02-08 00:55:48,2013-03-02 05:25:40,3585
89,6447,4703,11239,"22 days, 4:36:27",2013-02-08 00:49:13,2013-02-08 00:49:13,2013-03-02 05:25:40,6424
685,2906,4575,8166,"22 days, 4:37:15",2013-02-08 00:48:25,2013-02-08 00:48:25,2013-03-02 05:25:40,2519
665,7477,8301,16443,"22 days, 4:37:59",2013-02-08 00:47:41,2013-02-08 00:47:41,2013-03-02 05:25:40,8368
1941,5324,8144,15409,"22 days, 4:48:05",2013-02-08 00:37:35,2013-02-08 00:37:35,2013-03-02 05:25:40,723
1611,2802,4131,8544,"22 days, 5:04:49",2013-02-08 00:20:51,2013-02-08 00:20:51,2013-03-02 05:25:40,8197
231,456,536,1223,"22 days, 5:07:51",2013-02-08 00:17:49,2013-02-08 00:17:49,2013-03-02 05:25:40,3942
519,5464,6299,12282,"22 days, 5:18:21",2013-02-08 00:07:19,2013-02-08 00:07:19,2013-03-02 05:25:40,3827
1288,3211,4930,9429,"22 days, 12:48:51",2013-02-10 09:41:46,2010-02-20 11:20:35,2010-03-15 00:09:26,4965
617,6493,7657,14767,"22 days, 13:44:10",2013-02-12 07:47:01,2010-02-01 10:32:08,2010-02-24 00:16:18,7342
3131,7807,8595,19533,"22 days, 16:16:40",2013-02-13 04:45:34,2010-02-01 10:32:08,2010-02-24 02:48:48,9995
1607,4053,4017,9677,"22 days, 17:03:29",2013-02-11 09:54:15,2010-02-01 10:32:08,2010-02-24 03:35:37,6256
668,9152,5240,15060,"22 days, 17:25:51",2013-02-07 11:59:49,2013-02-07 11:59:49,2013-03-02 05:25:40,1668
1844,6423,6395,14662,"22 days, 17:27:21",2013-02-07 11:58:19,2013-02-07 11:58:19,2013-03-02 05:25:40,6177
949,3936,3748,8633,"22 days, 17:27:55",2013-02-07 11:57:45,2013-02-07 11:57:45,2013-03-02 05:25:40,6271
1447,7458,7525,16430,"22 days, 17:30:09",2013-02-07 11:55:31,2013-02-07 11:55:31,2013-03-02 05:25:40,8040
1261,5659,8110,15030,"22 days, 17:30:25",2013-02-07 11:55:15,2013-02-07 11:55:15,2013-03-02 05:25:40,1055
699,4682,7349,12730,"22 days, 17:31:15",2013-02-07 11:54:25,2013-02-07 11:54:25,2013-03-02 05:25:40,3053
971,5127,6425,12523,"22 days, 17:31:24",2013-02-07 11:54:16,2013-02-07 11:54:16,2013-03-02 05:25:40,9281
517,792,1195,2504,"22 days, 17:32:48",2013-02-07 11:52:52,2013-02-07 11:52:52,2013-03-02 05:25:40,9612
981,3432,4097,8510,"22 days, 17:33:06",2013-02-07 11:52:34,2013-02-07 11:52:34,2013-03-02 05:25:40,2512
563,7849,10024,18436,"22 days, 17:33:35",2013-02-07 11:52:05,2013-02-07 11:52:05,2013-03-02 05:25:40,953
1192,4606,4884,10682,"22 days, 17:33:39",2013-02-07 11:52:01,2013-02-07 11:52:01,2013-03-02 05:25:40,1545
2339,5044,6669,14052,"22 days, 17:33:50",2013-02-07 11:51:50,2013-02-07 11:51:50,2013-03-02 05:25:40,4944
229,1204,1635,3068,"22 days, 17:35:19",2013-02-07 11:50:21,2013-02-07 11:50:21,2013-03-02 05:25:40,4374
678,1085,1710,3473,"22 days, 17:35:31",2013-02-07 11:50:09,2013-02-07 11:50:09,2013-03-02 05:25:40,7828
791,6964,8401,16156,"22 days, 17:35:43",2013-02-07 11:49:57,2013-02-07 11:49:57,2013-03-02 05:25:40,9433
249,2137,4675,7061,"22 days, 17:36:57",2013-02-07 11:48:43,2013-02-07 11:48:43,2013-03-02 05:25:40,3886
595,7914,9453,17962,"22 days, 17:37:02",2013-02-07 11:48:38,2013-02-07 11:48:38,2013-03-02 05:25:40,2395
38,910,1832,2780,"22 days, 17:37:13",2013-02-07 11:48:27,2013-02-07 11:48:27,2013-03-02 05:25:40,6142
2620,5815,7654,16089,"22 days, 17:37:18",2013-02-07 11:48:22,2013-02-07 11:48:22,2013-03-02 05:25:40,6750
230,2392,4551,7173,"22 days, 17:38:38",2013-02-12 04:02:50,2010-02-01 10:32:08,2010-02-24 04:10:46,9626
326,7133,8662,16121,"22 days, 17:39:05",2013-02-07 11:46:35,2013-02-07 11:46:35,2013-03-02 05:25:40,2046
86,5894,6136,12116,"22 days, 17:40:13",2013-02-07 11:45:27,2013-02-07 11:45:27,2013-03-02 05:25:40,1349
664,4460,6959,12083,"22 days, 17:41:02",2013-02-07 11:44:38,2013-02-07 11:44:38,2013-03-02 05:25:40,4209
516,4654,5798,10968,"22 days, 17:41:36",2013-02-07 11:44:04,2013-02-07 11:44:04,2013-03-02 05:25:40,427
450,4613,4037,9100,"22 days, 17:42:38",2013-02-07 11:43:02,2013-02-07 11:43:02,2013-03-02 05:25:40,6367
477,9498,7596,17571,"22 days, 17:43:16",2013-02-07 11:42:24,2013-02-07 11:42:24,2013-03-02 05:25:40,1953
540,7093,7572,15205,"22 days, 17:44:28",2013-02-07 11:41:12,2013-02-07 11:41:12,2013-03-02 05:25:40,7689
1441,125,317,1883,"22 days, 17:44:48",2013-02-07 11:40:52,2013-02-07 11:40:52,2013-03-02 05:25:40,9012
1127,2253,3103,6483,"22 days, 17:45:17",2013-02-07 11:40:23,2013-02-07 11:40:23,2013-03-02 05:25:40,4883
382,7937,7388,15707,"22 days, 17:45:20",2013-02-07 11:40:20,2013-02-07 11:40:20,2013-03-02 05:25:40,6100
1017,7292,7496,15805,"22 days, 17:46:47",2013-02-07 11:38:53,2013-02-07 11:38:53,2013-03-02 05:25:40,7142
1439,5984,7277,14700,"22 days, 17:48:14",2013-02-07 11:37:26,2013-02-07 11:37:26,2013-03-02 05:25:40,9380
41,4989,5382,10412,"22 days, 17:50:07",2013-02-07 11:35:33,2013-02-07 11:35:33,2013-03-02 05:25:40,6698
47,6491,7369,13907,"22 days, 17:50:16",2013-02-07 11:35:24,2013-02-07 11:35:24,2013-03-02 05:25:40,6152
776,1645,2713,5134,"22 days, 17:53:06",2013-02-07 11:32:34,2013-02-07 11:32:34,2013-03-02 05:25:40,3934
18,2318,2575,4911,"22 days, 17:53:07",2013-02-07 11:32:33,2013-02-07 11:32:33,2013-03-02 05:25:40,1604
161,645,1148,1954,"22 days, 17:53:27",2013-02-07 11:32:13,2013-02-07 11:32:13,2013-03-02 05:25:40,2361
276,5803,6124,12203,"22 days, 17:53:48",2013-02-07 11:31:52,2013-02-07 11:31:52,2013-03-02 05:25:40,6033
460,4926,5171,10557,"22 days, 17:55:08",2013-02-07 11:30:32,2013-02-07 11:30:32,2013-03-02 05:25:40,3220
432,6831,6116,13379,"22 days, 17:55:25",2013-02-07 11:30:15,2013-02-07 11:30:15,2013-03-02 05:25:40,1962
1005,1705,3248,5958,"22 days, 17:55:50",2013-02-07 11:29:50,2013-02-07 11:29:50,2013-03-02 05:25:40,2340
1163,6406,5751,13320,"22 days, 17:56:01",2013-02-07 11:29:39,2013-02-07 11:29:39,2013-03-02 05:25:40,2201
1090,5205,5216,11511,"22 days, 17:56:08",2013-02-07 11:29:32,2013-02-07 11:29:32,2013-03-02 05:25:40,367
1799,3769,5935,11503,"22 days, 17:57:14",2013-02-07 11:28:26,2013-02-07 11:28:26,2013-03-02 05:25:40,1474
1962,6746,6847,15555,"22 days, 17:57:18",2013-02-07 11:28:22,2013-02-07 11:28:22,2013-03-02 05:25:40,1082
484,1003,1830,3317,"22 days, 17:58:05",2013-02-07 11:27:35,2013-02-07 11:27:35,2013-03-02 05:25:40,9073
2488,8080,6943,17511,"22 days, 18:00:16",2013-02-07 11:25:24,2013-02-07 11:25:24,2013-03-02 05:25:40,8619
161,5982,7209,13352,"22 days, 18:00:22",2013-02-07 11:25:18,2013-02-07 11:25:18,2013-03-02 05:25:40,5535
1251,4123,6089,11463,"22 days, 18:02:08",2013-02-07 11:23:32,2013-02-07 11:23:32,2013-03-02 05:25:40,8950
1526,6675,9424,17625,"22 days, 18:02:59",2013-02-07 11:22:41,2013-02-07 11:22:41,2013-03-02 05:25:40,959
419,6324,6792,13535,"22 days, 18:06:36",2013-02-07 11:19:04,2013-02-07 11:19:04,2013-03-02 05:25:40,4692
288,4623,4978,9889,"22 days, 18:07:25",2013-02-07 11:18:15,2013-02-07 11:18:15,2013-03-02 05:25:40,6036
536,3309,4810,8655,"22 days, 18:07:27",2013-02-07 11:18:13,2013-02-07 11:18:13,2013-03-02 05:25:40,7256
888,2153,3722,6763,"22 days, 18:07:45",2013-02-07 11:17:55,2013-02-07 11:17:55,2013-03-02 05:25:40,9668
2128,7018,4854,14000,"22 days, 18:07:58",2013-02-07 11:17:42,2013-02-07 11:17:42,2013-03-02 05:25:40,5846
523,744,1497,2764,"22 days, 18:08:34",2013-02-07 11:17:06,2013-02-07 11:17:06,2013-03-02 05:25:40,2808
509,9435,9707,19651,"22 days, 18:10:04",2013-02-07 11:15:36,2013-02-07 11:15:36,2013-03-02 05:25:40,3799
1899,6729,7510,16138,"22 days, 18:10:58",2013-02-07 11:14:42,2013-02-07 11:14:42,2013-03-02 05:25:40,2121
1251,2739,3650,7640,"22 days, 18:11:10",2013-02-07 11:14:30,2013-02-07 11:14:30,2013-03-02 05:25:40,9051
248,1158,2050,3456,"22 days, 18:11:48",2013-02-07 11:13:52,2013-02-07 11:13:52,2013-03-02 05:25:40,5164
1466,6595,6924,14985,"22 days, 18:12:07",2013-02-07 11:13:33,2013-02-07 11:13:33,2013-03-02 05:25:40,3304
668,2977,2616,6261,"22 days, 18:12:28",2013-02-07 11:13:12,2013-02-07 11:13:12,2013-03-02 05:25:40,1017
171,1107,1558,2836,"22 days, 18:12:35",2013-02-07 11:13:05,2013-02-07 11:13:05,2013-03-02 05:25:40,4463
469,4130,5911,10510,"22 days, 18:13:19",2013-02-07 11:12:21,2013-02-07 11:12:21,2013-03-02 05:25:40,7813
610,2187,2504,5301,"22 days, 18:13:42",2013-02-07 11:11:58,2013-02-07 11:11:58,2013-03-02 05:25:40,5304
1934,6402,6857,15193,"22 days, 18:14:24",2013-02-07 11:11:16,2013-02-07 11:11:16,2013-03-02 05:25:40,2006
58,5510,6763,12331,"22 days, 18:14:29",2013-02-07 11:11:11,2013-02-07 11:11:11,2013-03-02 05:25:40,6225
503,3576,6850,10929,"22 days, 18:14:51",2013-02-07 11:10:49,2013-02-07 11:10:49,2013-03-02 05:25:40,6065
333,5368,6562,12263,"22 days, 18:15:17",2013-02-07 11:10:23,2013-02-07 11:10:23,2013-03-02 05:25:40,262
1090,5555,7553,14198,"22 days, 18:15:43",2013-02-07 11:09:57,2013-02-07 11:09:57,2013-03-02 05:25:40,7480
1771,5967,6012,13750,"22 days, 18:15:55",2013-02-07 11:09:45,2013-02-07 11:09:45,2013-03-02 05:25:40,5005
630,6289,6168,13087,"22 days, 18:16:51",2013-02-07 11:08:49,2013-02-07 11:08:49,2013-03-02 05:25:40,7422
226,9567,6793,16586,"22 days, 18:18:16",2013-02-07 11:07:24,2013-02-07 11:07:24,2013-03-02 05:25:40,5581
712,2008,5832,8552,"22 days, 18:18:50",2013-02-07 11:06:50,2013-02-07 11:06:50,2013-03-02 05:25:40,4285
913,4183,4750,9846,"22 days, 18:19:23",2013-02-07 11:06:17,2013-02-07 11:06:17,2013-03-02 05:25:40,7433
687,8476,9214,18377,"22 days, 18:20:51",2013-02-07 11:04:49,2013-02-07 11:04:49,2013-03-02 05:25:40,5818
88,5768,4729,10585,"22 days, 18:21:05",2013-02-07 11:04:35,2013-02-07 11:04:35,2013-03-02 05:25:40,5561
212,5363,5635,11210,"22 days, 18:21:23",2013-02-07 11:04:17,2013-02-07 11:04:17,2013-03-02 05:25:40,3408
674,1717,2982,5373,"22 days, 18:22:32",2013-02-07 11:03:08,2013-02-07 11:03:08,2013-03-02 05:25:40,36
605,4786,6741,12132,"22 days, 18:22:40",2013-02-07 11:03:00,2013-02-07 11:03:00,2013-03-02 05:25:40,512
1698,2394,4874,8966,"22 days, 18:22:50",2013-02-07 11:02:50,2013-02-07 11:02:50,2013-03-02 05:25:40,8327
395,6071,6977,13443,"22 days, 18:27:09",2013-02-07 10:58:31,2013-02-07 10:58:31,2013-03-02 05:25:40,5474
1623,5295,6575,13493,"22 days, 18:27:31",2013-02-07 10:58:09,2013-02-07 10:58:09,2013-03-02 05:25:40,4506
256,8181,6441,14878,"22 days, 18:29:25",2013-02-07 10:56:15,2013-02-07 10:56:15,2013-03-02 05:25:40,9509
1562,6618,6331,14511,"22 days, 18:30:15",2013-02-07 10:55:25,2013-02-07 10:55:25,2013-03-02 05:25:40,5563
1208,1238,1777,4223,"22 days, 18:30:29",2013-02-07 10:55:11,2013-02-07 10:55:11,2013-03-02 05:25:40,3400
639,5188,4695,10522,"22 days, 18:31:21",2013-02-07 10:54:19,2013-02-07 10:54:19,2013-03-02 05:25:40,548
275,8497,6872,15644,"22 days, 18:32:19",2013-02-07 10:53:21,2013-02-07 10:53:21,2013-03-02 05:25:40,1099
745,4194,7411,12350,"22 days, 18:32:38",2013-02-07 10:53:02,2013-02-07 10:53:02,2013-03-02 05:25:40,6876
357,1761,1882,4000,"22 days, 18:32:38",2013-02-07 10:53:02,2013-02-07 10:53:02,2013-03-02 05:25:40,334
313,634,1056,2003,"22 days, 18:32:46",2013-02-07 10:52:54,2013-02-07 10:52:54,2013-03-02 05:25:40,6433
108,660,1067,1835,"22 days, 18:33:03",2013-02-07 10:52:37,2013-02-07 10:52:37,2013-03-02 05:25:40,7308
175,3575,5706,9456,"22 days, 18:33:03",2013-02-07 10:52:37,2013-02-07 10:52:37,2013-03-02 05:25:40,2546
2714,7521,8572,18807,"22 days, 18:33:08",2013-02-07 10:52:32,2013-02-07 10:52:32,2013-03-02 05:25:40,7874
2407,2830,4524,9761,"22 days, 18:34:10",2013-02-07 10:51:30,2013-02-07 10:51:30,2013-03-02 05:25:40,7171
440,2322,3840,6602,"22 days, 18:34:20",2013-02-07 10:51:20,2013-02-07 10:51:20,2013-03-02 05:25:40,6201
123,4149,5239,9511,"22 days, 18:34:26",2013-02-07 10:51:14,2013-02-07 10:51:14,2013-03-02 05:25:40,3128
923,1646,2731,5300,"22 days, 18:34:28",2013-02-07 10:51:12,2013-02-07 10:51:12,2013-03-02 05:25:40,5621
1025,3213,3368,7606,"22 days, 18:34:58",2013-02-07 10:50:42,2013-02-07 10:50:42,2013-03-02 05:25:40,996
598,3884,5243,9725,"22 days, 18:35:51",2013-02-07 10:49:49,2013-02-07 10:49:49,2013-03-02 05:25:40,6762
87,4029,3572,7688,"22 days, 18:35:56",2013-02-07 10:49:44,2013-02-07 10:49:44,2013-03-02 05:25:40,2563
2596,10694,5828,19118,"22 days, 18:36:55",2013-02-07 10:48:45,2013-02-07 10:48:45,2013-03-02 05:25:40,4940
234,4531,5060,9825,"22 days, 18:37:04",2013-02-07 10:48:36,2013-02-07 10:48:36,2013-03-02 05:25:40,3817
436,4997,5070,10503,"22 days, 18:37:33",2013-02-07 10:48:07,2013-02-07 10:48:07,2013-03-02 05:25:40,752
378,6014,8120,14512,"22 days, 18:37:40",2013-02-07 10:48:00,2013-02-07 10:48:00,2013-03-02 05:25:40,7641
818,5627,4360,10805,"22 days, 18:39:32",2013-02-07 10:46:08,2013-02-07 10:46:08,2013-03-02 05:25:40,4924
482,5772,4887,11141,"22 days, 18:41:56",2013-02-07 10:43:44,2013-02-07 10:43:44,2013-03-02 05:25:40,8747
1513,3386,4955,9854,"22 days, 18:42:52",2013-02-07 10:42:48,2013-02-07 10:42:48,2013-03-02 05:25:40,9938
423,5735,7509,13667,"22 days, 18:43:30",2013-02-07 10:42:10,2013-02-07 10:42:10,2013-03-02 05:25:40,3844
1219,5854,6752,13825,"22 days, 18:46:38",2013-02-07 10:39:02,2013-02-07 10:39:02,2013-03-02 05:25:40,7622
501,1252,4120,5873,"22 days, 18:46:51",2013-02-07 10:38:49,2013-02-07 10:38:49,2013-03-02 05:25:40,4380
1348,6607,5744,13699,"22 days, 18:48:05",2013-02-07 10:37:35,2013-02-07 10:37:35,2013-03-02 05:25:40,6254
165,6070,6541,12776,"22 days, 18:49:11",2013-02-07 10:36:29,2013-02-07 10:36:29,2013-03-02 05:25:40,5447
71,1761,2614,4446,"22 days, 18:49:52",2013-02-07 10:35:48,2013-02-07 10:35:48,2013-03-02 05:25:40,8748
44,3252,3381,6677,"22 days, 18:50:09",2013-02-07 10:35:31,2013-02-07 10:35:31,2013-03-02 05:25:40,7962
2240,2837,4593,9670,"22 days, 18:50:43",2013-02-07 10:34:57,2013-02-07 10:34:57,2013-03-02 05:25:40,9968
1349,5052,5643,12044,"22 days, 18:51:21",2013-02-07 10:34:19,2013-02-07 10:34:19,2013-03-02 05:25:40,9816
123,7324,7427,14874,"22 days, 18:51:36",2013-02-07 10:34:04,2013-02-07 10:34:04,2013-03-02 05:25:40,728
990,5426,6373,12789,"22 days, 18:52:00",2013-02-07 10:33:40,2013-02-07 10:33:40,2013-03-02 05:25:40,8309
121,3875,4731,8727,"22 days, 18:52:17",2013-02-07 10:33:23,2013-02-07 10:33:23,2013-03-02 05:25:40,1274
1461,6291,6656,14408,"22 days, 18:52:38",2013-02-07 10:33:02,2013-02-07 10:33:02,2013-03-02 05:25:40,987
1353,7859,7933,17145,"22 days, 18:52:43",2013-02-07 10:32:57,2013-02-07 10:32:57,2013-03-02 05:25:40,8991
468,5767,5547,11782,"22 days, 18:53:12",2013-02-07 10:32:28,2013-02-07 10:32:28,2013-03-02 05:25:40,326
1228,5551,6475,13254,"22 days, 18:54:24",2013-02-07 10:31:16,2013-02-07 10:31:16,2013-03-02 05:25:40,2635
1818,7959,6156,15933,"22 days, 18:54:52",2013-02-07 10:30:48,2013-02-07 10:30:48,2013-03-02 05:25:40,1495
881,6047,7590,14518,"22 days, 18:56:18",2013-02-07 10:29:22,2013-02-07 10:29:22,2013-03-02 05:25:40,7354
93,3464,4073,7630,"22 days, 18:56:28",2013-02-07 10:29:12,2013-02-07 10:29:12,2013-03-02 05:25:40,8781
77,6001,8480,14558,"22 days, 18:57:37",2013-02-07 10:28:03,2013-02-07 10:28:03,2013-03-02 05:25:40,5863
408,3424,3686,7518,"22 days, 18:57:40",2013-02-07 10:28:00,2013-02-07 10:28:00,2013-03-02 05:25:40,6524
692,6769,6182,13643,"22 days, 18:59:24",2013-02-07 10:26:16,2013-02-07 10:26:16,2013-03-02 05:25:40,9512
1547,4603,6364,12514,"22 days, 19:00:32",2013-02-07 10:25:08,2013-02-07 10:25:08,2013-03-02 05:25:40,5784
980,1793,3005,5778,"22 days, 19:00:36",2013-02-07 10:47:06,2010-02-18 09:17:41,2010-03-13 04:18:17,1864
344,1567,2533,4444,"22 days, 19:01:19",2013-02-07 10:24:21,2013-02-07 10:24:21,2013-03-02 05:25:40,4802
808,7627,7465,15900,"22 days, 19:01:23",2013-02-07 10:24:17,2013-02-07 10:24:17,2013-03-02 05:25:40,6119
694,5301,5016,11011,"22 days, 19:02:02",2013-02-07 10:23:38,2013-02-07 10:23:38,2013-03-02 05:25:40,5811
55,6067,6293,12415,"22 days, 19:02:38",2013-02-07 10:23:02,2013-02-07 10:23:02,2013-03-02 05:25:40,1206
567,3225,4545,8337,"22 days, 19:02:41",2013-02-07 10:22:59,2013-02-07 10:22:59,2013-03-02 05:25:40,6549
1288,6707,8032,16027,"22 days, 19:02:52",2013-02-07 10:22:48,2013-02-07 10:22:48,2013-03-02 05:25:40,4578
154,3418,3398,6970,"22 days, 19:02:54",2013-02-07 10:22:46,2013-02-07 10:22:46,2013-03-02 05:25:40,6680
632,1775,3717,6124,"22 days, 19:04:25",2013-02-07 10:21:15,2013-02-07 10:21:15,2013-03-02 05:25:40,7600
161,4290,5704,10155,"22 days, 19:05:58",2013-02-07 10:19:42,2013-02-07 10:19:42,2013-03-02 05:25:40,2096
942,6587,6962,14491,"22 days, 19:06:27",2013-02-07 10:19:13,2013-02-07 10:19:13,2013-03-02 05:25:40,1453
3203,6538,7428,17169,"22 days, 19:08:02",2013-02-07 10:17:38,2013-02-07 10:17:38,2013-03-02 05:25:40,557
1170,7921,7674,16765,"22 days, 19:08:19",2013-02-07 10:55:21,2010-02-01 10:32:08,2010-02-24 05:40:27,842
403,799,1407,2609,"22 days, 19:09:12",2013-02-07 10:16:28,2013-02-07 10:16:28,2013-03-02 05:25:40,2195
60,6692,7405,14157,"22 days, 19:09:42",2013-02-07 10:15:58,2013-02-07 10:15:58,2013-03-02 05:25:40,3739
763,3082,7255,11100,"22 days, 19:10:59",2013-02-07 10:14:41,2013-02-07 10:14:41,2013-03-02 05:25:40,4360
243,848,2633,3724,"22 days, 19:12:30",2013-02-07 10:13:10,2013-02-07 10:13:10,2013-03-02 05:25:40,4343
54,2741,2973,5768,"22 days, 19:13:06",2013-02-07 10:12:34,2013-02-07 10:12:34,2013-03-02 05:25:40,4928
992,6468,5776,13236,"22 days, 19:13:51",2013-02-07 10:11:49,2013-02-07 10:11:49,2013-03-02 05:25:40,135
2421,6834,9421,18676,"22 days, 19:15:02",2013-02-07 10:10:38,2013-02-07 10:10:38,2013-03-02 05:25:40,3381
90,5538,5811,11439,"22 days, 19:15:10",2013-02-07 10:10:30,2013-02-07 10:10:30,2013-03-02 05:25:40,7711
210,6580,8405,15195,"22 days, 19:15:13",2013-02-07 10:10:27,2013-02-07 10:10:27,2013-03-02 05:25:40,5845
935,1287,2715,4937,"22 days, 19:18:27",2013-02-07 10:07:13,2013-02-07 10:07:13,2013-03-02 05:25:40,3079
1065,2386,2861,6312,"22 days, 19:20:35",2013-02-07 10:05:05,2013-02-07 10:05:05,2013-03-02 05:25:40,2387
425,6445,7678,14548,"22 days, 19:20:54",2013-02-07 10:04:46,2013-02-07 10:04:46,2013-03-02 05:25:40,6820
836,8871,9557,19264,"22 days, 19:21:39",2013-02-07 10:04:01,2013-02-07 10:04:01,2013-03-02 05:25:40,1734
392,1114,3585,5091,"22 days, 19:22:09",2013-02-07 10:03:31,2013-02-07 10:03:31,2013-03-02 05:25:40,8762
734,8069,8347,17150,"22 days, 19:22:59",2013-02-07 10:02:41,2013-02-07 10:02:41,2013-03-02 05:25:40,1780
656,731,1512,2899,"22 days, 19:25:00",2013-02-07 10:00:40,2013-02-07 10:00:40,2013-03-02 05:25:40,483
951,3070,4065,8086,"22 days, 19:25:06",2013-02-07 10:00:34,2013-02-07 10:00:34,2013-03-02 05:25:40,3997
925,6015,10213,17153,"22 days, 19:25:09",2013-02-07 10:00:31,2013-02-07 10:00:31,2013-03-02 05:25:40,4544
228,7246,8329,15803,"22 days, 19:25:13",2013-02-07 10:00:27,2013-02-07 10:00:27,2013-03-02 05:25:40,3898
1084,3946,4640,9670,"22 days, 19:27:29",2013-02-07 09:58:11,2013-02-07 09:58:11,2013-03-02 05:25:40,9277
122,2779,4577,7478,"22 days, 19:28:36",2013-02-07 10:26:17,2010-02-01 10:32:08,2010-02-24 06:00:44,976
503,7077,6630,14210,"22 days, 19:28:42",2013-02-07 09:56:58,2013-02-07 09:56:58,2013-03-02 05:25:40,6295
759,9771,6764,17294,"22 days, 19:29:11",2013-02-07 09:56:29,2013-02-07 09:56:29,2013-03-02 05:25:40,6233
197,9056,6373,15626,"22 days, 19:29:54",2013-02-07 09:55:46,2013-02-07 09:55:46,2013-03-02 05:25:40,366
172,5112,7546,12830,"22 days, 19:29:58",2013-02-07 09:55:42,2013-02-07 09:55:42,2013-03-02 05:25:40,7757
802,3685,2626,7113,"22 days, 19:30:00",2013-02-07 09:55:40,2013-02-07 09:55:40,2013-03-02 05:25:40,146
1042,5596,5712,12350,"22 days, 19:30:34",2013-02-07 09:55:06,2013-02-07 09:55:06,2013-03-02 05:25:40,6537
1433,4098,6844,12375,"22 days, 19:34:06",2013-02-07 09:51:34,2013-02-07 09:51:34,2013-03-02 05:25:40,9546
1361,6848,7243,15452,"22 days, 19:34:18",2013-02-07 09:51:22,2013-02-07 09:51:22,2013-03-02 05:25:40,7293
178,1304,2175,3657,"22 days, 19:34:22",2013-02-07 09:51:18,2013-02-07 09:51:18,2013-03-02 05:25:40,6434
313,6046,6660,13019,"22 days, 19:34:50",2013-02-07 09:50:50,2013-02-07 09:50:50,2013-03-02 05:25:40,541
208,6107,6242,12557,"22 days, 19:35:34",2013-02-07 09:50:06,2013-02-07 09:50:06,2013-03-02 05:25:40,9664
3007,10149,10805,23961,"22 days, 19:36:59",2013-02-07 09:48:41,2013-02-07 09:48:41,2013-03-02 05:25:40,5330
2195,7634,7248,17077,"22 days, 19:37:32",2013-02-07 09:48:08,2013-02-07 09:48:08,2013-03-02 05:25:40,8117
2092,9326,6261,17679,"22 days, 19:38:07",2013-02-07 09:47:33,2013-02-07 09:47:33,2013-03-02 05:25:40,6263
145,5054,6520,11719,"22 days, 19:38:36",2013-02-07 09:47:04,2013-02-07 09:47:04,2013-03-02 05:25:40,7875
1244,2853,3432,7529,"22 days, 19:39:40",2013-02-07 09:46:00,2013-02-07 09:46:00,2013-03-02 05:25:40,495
2292,3816,4373,10481,"22 days, 19:39:42",2013-02-07 09:45:58,2013-02-07 09:45:58,2013-03-02 05:25:40,1454
1655,7653,7719,17027,"22 days, 19:39:45",2013-02-07 09:45:55,2013-02-07 09:45:55,2013-03-02 05:25:40,434
27,840,1184,2051,"22 days, 19:40:14",2013-02-07 09:45:26,2013-02-07 09:45:26,2013-03-02 05:25:40,6430
156,2164,1945,4265,"22 days, 19:41:14",2013-02-07 09:44:26,2013-02-07 09:44:26,2013-03-02 05:25:40,3459
1317,5923,6644,13884,"22 days, 19:41:56",2013-02-08 10:15:21,2010-02-01 10:32:08,2010-02-24 06:14:04,7889
67,2488,3144,5699,"22 days, 19:43:14",2013-02-07 09:42:26,2013-02-07 09:42:26,2013-03-02 05:25:40,5345
147,1566,2060,3773,"22 days, 19:43:37",2013-02-07 09:42:03,2013-02-07 09:42:03,2013-03-02 05:25:40,4757
23,2573,3726,6322,"22 days, 19:44:25",2013-02-07 09:41:15,2013-02-07 09:41:15,2013-03-02 05:25:40,6855
683,3417,4414,8514,"22 days, 19:44:52",2013-02-07 09:40:48,2013-02-07 09:40:48,2013-03-02 05:25:40,1181
1089,3673,4800,9562,"22 days, 19:46:05",2013-02-07 09:39:35,2013-02-07 09:39:35,2013-03-02 05:25:40,712
1896,2145,3982,8023,"22 days, 19:46:23",2013-02-07 09:39:17,2013-02-07 09:39:17,2013-03-02 05:25:40,8734
1526,1643,2519,5688,"22 days, 19:46:29",2013-02-07 09:39:11,2013-02-07 09:39:11,2013-03-02 05:25:40,1254
577,5828,5655,12060,"22 days, 19:46:56",2013-02-07 09:38:44,2013-02-07 09:38:44,2013-03-02 05:25:40,2218
1092,2759,2845,6696,"22 days, 19:47:10",2013-02-07 09:38:30,2013-02-07 09:38:30,2013-03-02 05:25:40,6024
182,4637,4082,8901,"22 days, 19:47:43",2013-02-07 09:37:57,2013-02-07 09:37:57,2013-03-02 05:25:40,8839
843,3493,4992,9328,"22 days, 19:48:12",2013-02-07 09:37:28,2013-02-07 09:37:28,2013-03-02 05:25:40,5735
1470,8348,7552,17370,"22 days, 19:49:06",2013-02-07 09:36:34,2013-02-07 09:36:34,2013-03-02 05:25:40,6714
1107,2952,3091,7150,"22 days, 19:49:08",2013-02-07 09:36:32,2013-02-07 09:36:32,2013-03-02 05:25:40,5945
537,5873,5537,11947,"22 days, 19:50:14",2013-02-07 09:35:26,2013-02-07 09:35:26,2013-03-02 05:25:40,7156
2053,3967,4700,10720,"22 days, 19:51:53",2013-02-07 09:33:47,2013-02-07 09:33:47,2013-03-02 05:25:40,6359
299,6487,6639,13425,"22 days, 19:52:52",2013-02-07 09:32:48,2013-02-07 09:32:48,2013-03-02 05:25:40,9621
895,3792,3671,8358,"22 days, 19:52:55",2013-02-07 09:32:45,2013-02-07 09:32:45,2013-03-02 05:25:40,7146
1273,8552,8301,18126,"22 days, 19:53:39",2013-02-07 09:32:01,2013-02-07 09:32:01,2013-03-02 05:25:40,2150
1576,6265,4512,12353,"22 days, 19:53:44",2013-02-07 09:31:56,2013-02-07 09:31:56,2013-03-02 05:25:40,2401
396,3983,4226,8605,"22 days, 19:53:56",2013-02-07 09:31:44,2013-02-07 09:31:44,2013-03-02 05:25:40,8364
1400,4675,3994,10069,"22 days, 19:54:14",2013-02-17 03:43:14,2010-02-01 10:32:08,2010-02-24 06:26:22,6340
194,1738,2331,4263,"22 days, 19:55:03",2013-02-07 09:30:37,2013-02-07 09:30:37,2013-03-02 05:25:40,2970
797,2048,3086,5931,"22 days, 19:55:49",2013-02-07 09:29:51,2013-02-07 09:29:51,2013-03-02 05:25:40,3366
291,6180,6059,12530,"22 days, 19:56:12",2013-02-07 09:29:28,2013-02-07 09:29:28,2013-03-02 05:25:40,5666
621,1167,2352,4140,"22 days, 19:57:47",2013-02-07 09:27:53,2013-02-07 09:27:53,2013-03-02 05:25:40,8970
370,5602,5131,11103,"22 days, 19:58:44",2013-02-07 09:26:56,2013-02-07 09:26:56,2013-03-02 05:25:40,1297
1371,6828,7985,16184,"22 days, 19:59:41",2013-02-07 09:25:59,2013-02-07 09:25:59,2013-03-02 05:25:40,6249
2289,5697,7976,15962,"22 days, 19:59:59",2013-02-07 09:25:41,2013-02-07 09:25:41,2013-03-02 05:25:40,4532
653,6177,6650,13480,"22 days, 20:00:06",2013-02-07 09:25:34,2013-02-07 09:25:34,2013-03-02 05:25:40,8555
1381,6386,6899,14666,"22 days, 20:00:07",2013-02-07 09:25:33,2013-02-07 09:25:33,2013-03-02 05:25:40,633
1144,4811,5493,11448,"22 days, 20:00:30",2013-02-07 09:25:10,2013-02-07 09:25:10,2013-03-02 05:25:40,9557
85,4603,6144,10832,"22 days, 20:00:31",2013-02-07 09:25:09,2013-02-07 09:25:09,2013-03-02 05:25:40,1800
792,5830,5659,12281,"22 days, 20:00:43",2013-02-07 09:24:57,2013-02-07 09:24:57,2013-03-02 05:25:40,7323
13,12136,8589,20738,"22 days, 20:01:53",2013-02-07 09:23:47,2013-02-07 09:23:47,2013-03-02 05:25:40,9880
328,4867,3882,9077,"22 days, 20:03:05",2013-02-07 09:22:35,2013-02-07 09:22:35,2013-03-02 05:25:40,410
367,3727,4420,8514,"22 days, 20:04:40",2013-02-07 09:21:00,2013-02-07 09:21:00,2013-03-02 05:25:40,4769
1755,4261,5498,11514,"22 days, 20:05:17",2013-02-07 09:20:23,2013-02-07 09:20:23,2013-03-02 05:25:40,3761
409,1889,3056,5354,"22 days, 20:05:50",2013-02-07 09:19:50,2013-02-07 09:19:50,2013-03-02 05:25:40,9942
656,4649,5741,11046,"22 days, 20:06:03",2013-02-07 09:19:37,2013-02-07 09:19:37,2013-03-02 05:25:40,3214
809,8524,9217,18550,"22 days, 20:07:26",2013-02-07 09:18:14,2013-02-07 09:18:14,2013-03-02 05:25:40,4243
2353,9686,8101,20140,"22 days, 20:08:07",2013-02-07 09:17:33,2013-02-07 09:17:33,2013-03-02 05:25:40,23
1972,10849,8380,21201,"22 days, 20:08:16",2013-02-07 09:17:24,2013-02-07 09:17:24,2013-03-02 05:25:40,5121
327,7442,6467,14236,"22 days, 20:08:53",2013-02-07 09:16:47,2013-02-07 09:16:47,2013-03-02 05:25:40,4394
990,1773,3440,6203,"22 days, 20:09:02",2013-02-07 09:16:38,2013-02-07 09:16:38,2013-03-02 05:25:40,798
263,4039,5427,9729,"22 days, 20:09:37",2013-02-07 09:16:03,2013-02-07 09:16:03,2013-03-02 05:25:40,3297
1085,2009,3839,6933,"22 days, 20:09:39",2013-02-07 09:16:01,2013-02-07 09:16:01,2013-03-02 05:25:40,4254
392,3770,6574,10736,"22 days, 20:09:56",2013-02-07 09:15:44,2013-02-07 09:15:44,2013-03-02 05:25:40,4564
2196,6450,8656,17302,"22 days, 20:11:51",2013-02-07 09:13:49,2013-02-07 09:13:49,2013-03-02 05:25:40,7931
164,8542,8130,16836,"22 days, 20:12:31",2013-02-07 09:13:09,2013-02-07 09:13:09,2013-03-02 05:25:40,3777
941,8914,6422,16277,"22 days, 20:12:43",2013-02-07 09:12:57,2013-02-07 09:12:57,2013-03-02 05:25:40,4738
352,3446,4019,7817,"22 days, 20:12:55",2013-02-07 09:12:45,2013-02-07 09:12:45,2013-03-02 05:25:40,4710
962,8668,5806,15436,"22 days, 20:13:04",2013-02-07 09:12:36,2013-02-07 09:12:36,2013-03-02 05:25:40,8605
274,6904,7733,14911,"22 days, 20:13:41",2013-02-07 09:11:59,2013-02-07 09:11:59,2013-03-02 05:25:40,1142
494,7304,5324,13122,"22 days, 20:14:53",2013-02-07 09:10:47,2013-02-07 09:10:47,2013-03-02 05:25:40,9064
550,3261,4516,8327,"22 days, 20:15:05",2013-02-07 09:10:35,2013-02-07 09:10:35,2013-03-02 05:25:40,6350
806,1353,1614,3773,"22 days, 20:15:24",2013-02-07 09:10:16,2013-02-07 09:10:16,2013-03-02 05:25:40,7230
719,1891,2451,5061,"22 days, 20:15:41",2013-02-07 09:09:59,2013-02-07 09:09:59,2013-03-02 05:25:40,5517
302,6511,6555,13368,"22 days, 20:16:58",2013-02-07 09:08:42,2013-02-07 09:08:42,2013-03-02 05:25:40,8485
39,3636,3645,7320,"22 days, 20:17:43",2013-02-07 09:07:57,2013-02-07 09:07:57,2013-03-02 05:25:40,9873
1326,962,1417,3705,"22 days, 20:18:05",2013-02-07 09:07:35,2013-02-07 09:07:35,2013-03-02 05:25:40,3329
517,3462,3250,7229,"22 days, 20:18:06",2013-02-07 09:07:34,2013-02-07 09:07:34,2013-03-02 05:25:40,9359
130,2955,2652,5737,"22 days, 20:18:33",2013-02-07 09:07:07,2013-02-07 09:07:07,2013-03-02 05:25:40,9606
64,3165,3517,6746,"22 days, 20:18:35",2013-02-07 09:07:05,2013-02-07 09:07:05,2013-03-02 05:25:40,2797
432,2640,2823,5895,"22 days, 20:18:59",2013-02-07 09:06:41,2013-02-07 09:06:41,2013-03-02 05:25:40,7678
2716,7635,6595,16946,"22 days, 20:19:06",2013-02-07 09:06:34,2013-02-07 09:06:34,2013-03-02 05:25:40,6844
1318,4390,6367,12075,"22 days, 20:20:05",2013-02-07 09:05:35,2013-02-07 09:05:35,2013-03-02 05:25:40,1249
1921,4493,6539,12953,"22 days, 20:20:22",2013-02-07 09:05:18,2013-02-07 09:05:18,2013-03-02 05:25:40,986
1524,3854,5977,11355,"22 days, 20:21:03",2013-02-07 09:04:37,2013-02-07 09:04:37,2013-03-02 05:25:40,3070
2161,3257,3319,8737,"22 days, 20:21:14",2013-02-07 09:04:26,2013-02-07 09:04:26,2013-03-02 05:25:40,1298
513,3908,5023,9444,"22 days, 20:21:47",2013-02-07 09:03:53,2013-02-07 09:03:53,2013-03-02 05:25:40,8850
178,1249,1908,3335,"22 days, 20:21:49",2013-02-07 09:03:51,2013-02-07 09:03:51,2013-03-02 05:25:40,3819
516,6197,7048,13761,"22 days, 20:22:21",2013-02-07 09:03:19,2013-02-07 09:03:19,2013-03-02 05:25:40,647
681,1324,3318,5323,"22 days, 20:24:14",2013-02-07 09:01:26,2013-02-07 09:01:26,2013-03-02 05:25:40,4655
1185,2136,6453,9774,"22 days, 20:24:21",2013-02-07 09:01:19,2013-02-07 09:01:19,2013-03-02 05:25:40,4457
1449,2700,4575,8724,"22 days, 20:25:47",2013-02-07 10:03:52,2010-02-01 10:32:08,2010-02-24 06:57:55,4359
159,2115,2699,4973,"22 days, 20:26:40",2013-02-07 08:59:00,2013-02-07 08:59:00,2013-03-02 05:25:40,3666
1225,8276,5647,15148,"22 days, 20:26:40",2013-02-07 08:59:00,2013-02-07 08:59:00,2013-03-02 05:25:40,773
1678,8046,8931,18655,"22 days, 20:27:36",2013-02-07 08:58:04,2013-02-07 08:58:04,2013-03-02 05:25:40,2372
821,5351,5385,11557,"22 days, 20:28:25",2013-02-07 08:57:15,2013-02-07 08:57:15,2013-03-02 05:25:40,1866
52,7866,8390,16308,"22 days, 20:29:05",2013-02-07 08:56:35,2013-02-07 08:56:35,2013-03-02 05:25:40,9096
651,7143,6318,14112,"22 days, 20:31:43",2013-02-07 08:53:57,2013-02-07 08:53:57,2013-03-02 05:25:40,9926
3,1145,2242,3390,"22 days, 20:33:30",2013-02-07 08:52:10,2013-02-07 08:52:10,2013-03-02 05:25:40,9266
63,4029,7093,11185,"22 days, 20:34:32",2013-02-07 08:51:08,2013-02-07 08:51:08,2013-03-02 05:25:40,626
649,1773,2087,4509,"22 days, 20:34:48",2013-02-07 08:50:52,2013-02-07 08:50:52,2013-03-02 05:25:40,65
156,5556,4845,10557,"22 days, 20:35:56",2013-02-07 08:49:44,2013-02-07 08:49:44,2013-03-02 05:25:40,9103
1027,7334,9588,17949,"22 days, 20:37:15",2013-02-07 08:48:25,2013-02-07 08:48:25,2013-03-02 05:25:40,9162
174,5141,4598,9913,"22 days, 20:38:08",2013-02-07 08:47:32,2013-02-07 08:47:32,2013-03-02 05:25:40,406
278,2297,1805,4380,"22 days, 20:38:20",2013-02-07 08:47:20,2013-02-07 08:47:20,2013-03-02 05:25:40,7048
859,5524,8545,14928,"22 days, 20:39:11",2013-02-07 08:46:29,2013-02-07 08:46:29,2013-03-02 05:25:40,4189
396,6083,3793,10272,"22 days, 20:39:22",2013-02-07 08:46:18,2013-02-07 08:46:18,2013-03-02 05:25:40,735
789,4328,3248,8365,"22 days, 20:40:43",2013-02-07 08:44:57,2013-02-07 08:44:57,2013-03-02 05:25:40,6081
209,6127,5050,11386,"22 days, 20:41:16",2013-02-07 08:44:24,2013-02-07 08:44:24,2013-03-02 05:25:40,8072
1002,5753,6532,13287,"22 days, 20:41:30",2013-02-07 08:44:10,2013-02-07 08:44:10,2013-03-02 05:25:40,8607
1657,8150,6609,16416,"22 days, 20:41:58",2013-02-07 08:43:42,2013-02-07 08:43:42,2013-03-02 05:25:40,246
303,1528,2536,4367,"22 days, 20:42:06",2013-02-07 08:43:34,2013-02-07 08:43:34,2013-03-02 05:25:40,4605
94,2540,2640,5274,"22 days, 20:42:10",2013-02-07 08:43:30,2013-02-07 08:43:30,2013-03-02 05:25:40,3700
255,4058,4673,8986,"22 days, 20:42:20",2013-02-07 08:43:20,2013-02-07 08:43:20,2013-03-02 05:25:40,480
1239,5559,7488,14286,"22 days, 20:42:37",2013-02-07 08:43:03,2013-02-07 08:43:03,2013-03-02 05:25:40,7059
277,5766,5928,11971,"22 days, 20:43:18",2013-02-07 08:42:22,2013-02-07 08:42:22,2013-03-02 05:25:40,8662
1266,1307,3133,5706,"22 days, 20:43:43",2013-02-07 08:41:57,2013-02-07 08:41:57,2013-03-02 05:25:40,4656
1192,3961,4459,9612,"22 days, 20:44:53",2013-02-07 08:40:47,2013-02-07 08:40:47,2013-03-02 05:25:40,6933
1084,7412,7628,16124,"22 days, 20:45:04",2013-02-07 08:40:36,2013-02-07 08:40:36,2013-03-02 05:25:40,9227
267,8332,8874,17473,"22 days, 20:49:13",2013-02-07 08:36:27,2013-02-07 08:36:27,2013-03-02 05:25:40,6002
78,3046,3766,6890,"22 days, 20:49:53",2013-02-07 08:35:47,2013-02-07 08:35:47,2013-03-02 05:25:40,92
709,4229,5566,10504,"22 days, 20:50:09",2013-02-07 08:35:31,2013-02-07 08:35:31,2013-03-02 05:25:40,3335
1757,3582,4341,9680,"22 days, 20:50:39",2013-02-07 08:35:01,2013-02-07 08:35:01,2013-03-02 05:25:40,5809
182,1697,3578,5457,"22 days, 20:51:02",2013-02-07 08:34:38,2013-02-07 08:34:38,2013-03-02 05:25:40,5156
850,9194,7166,17210,"22 days, 20:51:47",2013-02-07 08:33:53,2013-02-07 08:33:53,2013-03-02 05:25:40,3504
1882,3036,4256,9174,"22 days, 20:52:43",2013-02-07 08:32:57,2013-02-07 08:32:57,2013-03-02 05:25:40,8853
2688,8267,7729,18684,"22 days, 20:53:01",2013-02-07 08:32:39,2013-02-07 08:32:39,2013-03-02 05:25:40,8577
506,5109,4401,10016,"22 days, 20:53:14",2013-02-07 08:32:26,2013-02-07 08:32:26,2013-03-02 05:25:40,344
46,3977,6291,10314,"22 days, 20:53:14",2013-02-07 08:32:26,2013-02-07 08:32:26,2013-03-02 05:25:40,667
566,5795,7671,14032,"22 days, 20:54:05",2013-02-07 08:31:35,2013-02-07 08:31:35,2013-03-02 05:25:40,8834
811,5754,6115,12680,"22 days, 20:55:26",2013-02-07 08:30:14,2013-02-07 08:30:14,2013-03-02 05:25:40,2574
1950,6061,5068,13079,"22 days, 20:55:40",2013-02-07 08:30:00,2013-02-07 08:30:00,2013-03-02 05:25:40,2269
215,8083,7844,16142,"22 days, 20:56:26",2013-02-07 08:29:14,2013-02-07 08:29:14,2013-03-02 05:25:40,2887
1383,6583,7633,15599,"22 days, 20:57:14",2013-02-07 08:28:26,2013-02-07 08:28:26,2013-03-02 05:25:40,6678
918,4419,4010,9347,"22 days, 20:57:34",2013-02-07 08:28:06,2013-02-07 08:28:06,2013-03-02 05:25:40,5927
198,8364,8656,17218,"22 days, 20:57:51",2013-02-07 08:27:49,2013-02-07 08:27:49,2013-03-02 05:25:40,3863
1928,5274,5084,12286,"22 days, 20:58:05",2013-02-07 08:27:35,2013-02-07 08:27:35,2013-03-02 05:25:40,5450
1275,7679,8043,16997,"22 days, 20:58:26",2013-02-07 08:27:14,2013-02-07 08:27:14,2013-03-02 05:25:40,2740
1265,8010,7606,16881,"22 days, 20:58:49",2013-02-07 08:26:51,2013-02-07 08:26:51,2013-03-02 05:25:40,9843
982,9996,8960,19938,"22 days, 20:58:58",2013-02-07 08:26:42,2013-02-07 08:26:42,2013-03-02 05:25:40,675
935,1144,1891,3970,"22 days, 20:59:00",2013-02-07 08:26:40,2013-02-07 08:26:40,2013-03-02 05:25:40,389
606,3495,4295,8396,"22 days, 20:59:29",2013-02-07 08:26:11,2013-02-07 08:26:11,2013-03-02 05:25:40,9710
442,4658,6067,11167,"22 days, 20:59:45",2013-02-07 08:25:55,2013-02-07 08:25:55,2013-03-02 05:25:40,63
935,495,936,2366,"22 days, 20:59:52",2013-02-07 08:25:48,2013-02-07 08:25:48,2013-03-02 05:25:40,7299
1243,810,1020,3073,"22 days, 21:01:25",2013-02-07 08:24:15,2013-02-07 08:24:15,2013-03-02 05:25:40,3751
258,1597,3222,5077,"22 days, 21:01:26",2013-02-07 08:24:14,2013-02-07 08:24:14,2013-03-02 05:25:40,8482
693,8599,7253,16545,"22 days, 21:03:42",2013-02-07 08:21:58,2013-02-07 08:21:58,2013-03-02 05:25:40,983
1663,2210,4098,7971,"22 days, 21:03:48",2013-02-07 08:21:52,2013-02-07 08:21:52,2013-03-02 05:25:40,352
829,6453,6299,13581,"22 days, 21:04:05",2013-02-07 08:21:35,2013-02-07 08:21:35,2013-03-02 05:25:40,1300
865,538,587,1990,"22 days, 21:04:05",2013-02-07 08:21:35,2013-02-07 08:21:35,2013-03-02 05:25:40,4779
462,3821,4391,8674,"22 days, 21:04:29",2013-02-07 08:21:11,2013-02-07 08:21:11,2013-03-02 05:25:40,4942
3883,8242,7913,20038,"22 days, 21:06:28",2013-02-07 08:19:12,2013-02-07 08:19:12,2013-03-02 05:25:40,4863
525,4391,7925,12841,"22 days, 21:06:46",2013-02-07 08:18:54,2013-02-07 08:18:54,2013-03-02 05:25:40,592
1382,1460,2540,5382,"22 days, 21:07:49",2013-02-07 08:17:51,2013-02-07 08:17:51,2013-03-02 05:25:40,899
1032,9594,8056,18682,"22 days, 21:07:58",2013-02-07 08:17:42,2013-02-07 08:17:42,2013-03-02 05:25:40,7377
1181,7662,6393,15236,"22 days, 21:08:41",2013-02-07 08:16:59,2013-02-07 08:16:59,2013-03-02 05:25:40,280
1589,261,760,2610,"22 days, 21:09:07",2013-02-07 08:16:33,2013-02-07 08:16:33,2013-03-02 05:25:40,1279
132,1246,2587,3965,"22 days, 21:09:22",2013-02-07 08:16:18,2013-02-07 08:16:18,2013-03-02 05:25:40,4613
440,5538,5248,11226,"22 days, 21:10:35",2013-02-07 08:15:05,2013-02-07 08:15:05,2013-03-02 05:25:40,6713
690,4588,4979,10257,"22 days, 21:11:05",2013-02-07 08:14:35,2013-02-07 08:14:35,2013-03-02 05:25:40,5358
1831,4260,4226,10317,"22 days, 21:11:06",2013-02-07 08:14:34,2013-02-07 08:14:34,2013-03-02 05:25:40,8241
1522,2979,4047,8548,"22 days, 21:11:37",2013-02-07 08:14:03,2013-02-07 08:14:03,2013-03-02 05:25:40,7646
466,8156,7657,16279,"22 days, 21:13:11",2013-02-07 08:12:29,2013-02-07 08:12:29,2013-03-02 05:25:40,2012
233,2945,4048,7226,"22 days, 21:13:20",2013-02-07 08:34:54,2010-02-01 10:32:08,2010-02-24 07:45:28,5617
1954,5898,5923,13775,"22 days, 21:14:23",2013-02-07 08:11:17,2013-02-07 08:11:17,2013-03-02 05:25:40,8075
201,6843,7421,14465,"22 days, 21:14:55",2013-02-07 08:10:45,2013-02-07 08:10:45,2013-03-02 05:25:40,7235
49,6088,6048,12185,"22 days, 21:16:01",2013-02-07 08:09:39,2013-02-07 08:09:39,2013-03-02 05:25:40,8789
898,1258,4028,6184,"22 days, 21:17:36",2013-02-07 08:08:04,2013-02-07 08:08:04,2013-03-02 05:25:40,4419
660,5051,6923,12634,"22 days, 21:18:22",2013-02-07 08:07:18,2013-02-07 08:07:18,2013-03-02 05:25:40,4807
910,8071,7441,16422,"22 days, 21:18:43",2013-02-07 08:06:57,2013-02-07 08:06:57,2013-03-02 05:25:40,2908
457,4247,4526,9230,"22 days, 21:19:15",2013-02-07 08:06:25,2013-02-07 08:06:25,2013-03-02 05:25:40,8049
470,5691,5620,11781,"22 days, 21:19:20",2013-02-07 08:06:20,2013-02-07 08:06:20,2013-03-02 05:25:40,9676
1916,7347,9762,19025,"22 days, 21:19:34",2013-02-07 08:06:06,2013-02-07 08:06:06,2013-03-02 05:25:40,8320
246,2753,5815,8814,"22 days, 21:19:38",2013-02-07 08:06:02,2013-02-07 08:06:02,2013-03-02 05:25:40,4469
550,3471,4664,8685,"22 days, 21:19:57",2013-02-07 08:05:43,2013-02-07 08:05:43,2013-03-02 05:25:40,4909
199,3045,2357,5601,"22 days, 21:23:12",2013-02-07 08:02:28,2013-02-07 08:02:28,2013-03-02 05:25:40,1562
38,2882,3238,6158,"22 days, 21:23:45",2013-02-07 08:01:55,2013-02-07 08:01:55,2013-03-02 05:25:40,6547
722,6712,9337,16771,"22 days, 21:25:15",2013-02-07 08:00:25,2013-02-07 08:00:25,2013-03-02 05:25:40,4045
386,1472,2821,4679,"22 days, 21:25:55",2013-02-07 07:59:45,2013-02-07 07:59:45,2013-03-02 05:25:40,9667
817,9932,8882,19631,"22 days, 21:25:56",2013-02-07 07:59:44,2013-02-07 07:59:44,2013-03-02 05:25:40,2957
170,1843,3228,5241,"22 days, 21:26:00",2013-02-07 07:59:40,2013-02-07 07:59:40,2013-03-02 05:25:40,9824
148,1017,1306,2471,"22 days, 21:26:07",2013-02-07 07:59:33,2013-02-07 07:59:33,2013-03-02 05:25:40,7399
1781,6810,9594,18185,"22 days, 21:27:09",2013-02-07 07:58:31,2013-02-07 07:58:31,2013-03-02 05:25:40,7566
603,9823,8072,18498,"22 days, 21:28:46",2013-02-07 07:56:54,2013-02-07 07:56:54,2013-03-02 05:25:40,4971
570,2774,3648,6992,"22 days, 21:28:52",2013-02-07 07:56:48,2013-02-07 07:56:48,2013-03-02 05:25:40,3290
769,3092,3255,7116,"22 days, 21:29:14",2013-02-07 07:56:26,2013-02-07 07:56:26,2013-03-02 05:25:40,5975
395,2818,3817,7030,"22 days, 21:29:14",2013-02-16 05:21:06,2010-02-01 10:32:08,2010-02-24 08:01:22,4623
100,683,905,1688,"22 days, 21:30:02",2013-02-07 07:55:38,2013-02-07 07:55:38,2013-03-02 05:25:40,858
512,2676,4635,7823,"22 days, 21:30:07",2013-02-07 07:55:33,2013-02-07 07:55:33,2013-03-02 05:25:40,7030
116,4195,5171,9482,"22 days, 21:30:21",2013-02-07 07:55:19,2013-02-07 07:55:19,2013-03-02 05:25:40,5791
755,5696,4566,11017,"22 days, 21:30:25",2013-02-07 07:55:15,2013-02-07 07:55:15,2013-03-02 05:25:40,9989
805,2150,3691,6646,"22 days, 21:30:33",2013-02-07 07:55:07,2013-02-07 07:55:07,2013-03-02 05:25:40,3905
102,6664,4727,11493,"22 days, 21:30:57",2013-02-07 07:54:43,2013-02-07 07:54:43,2013-03-02 05:25:40,1397
959,434,1217,2610,"22 days, 21:32:33",2013-02-07 07:53:07,2013-02-07 07:53:07,2013-03-02 05:25:40,9057
1476,1913,3047,6436,"22 days, 21:33:01",2013-02-07 07:52:39,2013-02-07 07:52:39,2013-03-02 05:25:40,7610
796,8391,6599,15786,"22 days, 21:33:28",2013-02-07 07:52:12,2013-02-07 07:52:12,2013-03-02 05:25:40,2923
259,7508,8451,16218,"22 days, 21:33:32",2013-02-07 07:52:08,2013-02-07 07:52:08,2013-03-02 05:25:40,7619
310,7197,6995,14502,"22 days, 21:33:33",2013-02-07 07:52:07,2013-02-07 07:52:07,2013-03-02 05:25:40,7561
1756,8164,7045,16965,"22 days, 21:33:57",2013-02-07 07:51:43,2013-02-07 07:51:43,2013-03-02 05:25:40,7999
377,4701,4048,9126,"22 days, 21:34:27",2013-02-07 07:51:13,2013-02-07 07:51:13,2013-03-02 05:25:40,2047
1273,2581,3368,7222,"22 days, 21:35:39",2013-02-07 07:50:01,2013-02-07 07:50:01,2013-03-02 05:25:40,1531
209,6743,5736,12688,"22 days, 21:37:02",2013-02-07 07:48:38,2013-02-07 07:48:38,2013-03-02 05:25:40,131
486,2550,4866,7902,"22 days, 21:37:29",2013-02-07 07:48:11,2013-02-07 07:48:11,2013-03-02 05:25:40,2245
1578,3812,4565,9955,"22 days, 21:37:33",2013-02-07 07:48:07,2013-02-07 07:48:07,2013-03-02 05:25:40,9244
1523,5092,7629,14244,"22 days, 21:37:39",2013-02-07 07:48:01,2013-02-07 07:48:01,2013-03-02 05:25:40,3484
363,7973,6432,14768,"22 days, 21:39:27",2013-02-07 07:46:13,2013-02-07 07:46:13,2013-03-02 05:25:40,5070
117,970,1739,2826,"22 days, 21:40:41",2013-02-07 07:44:59,2013-02-07 07:44:59,2013-03-02 05:25:40,3005
1302,5257,5188,11747,"22 days, 21:40:53",2013-02-07 07:44:47,2013-02-07 07:44:47,2013-03-02 05:25:40,505
1371,3123,3483,7977,"22 days, 21:41:05",2013-02-07 07:44:35,2013-02-07 07:44:35,2013-03-02 05:25:40,1592
681,2363,2665,5709,"22 days, 21:41:45",2013-02-07 07:43:55,2013-02-07 07:43:55,2013-03-02 05:25:40,6114
1020,3188,5522,9730,"22 days, 21:43:47",2013-02-07 07:41:53,2013-02-07 07:41:53,2013-03-02 05:25:40,2225
1030,6043,6904,13977,"22 days, 21:44:07",2013-02-07 07:41:33,2013-02-07 07:41:33,2013-03-02 05:25:40,2856
857,1849,3111,5817,"22 days, 21:44:25",2013-02-07 07:41:15,2013-02-07 07:41:15,2013-03-02 05:25:40,2190
918,5062,6064,12044,"22 days, 21:44:59",2013-02-07 07:40:41,2013-02-07 07:40:41,2013-03-02 05:25:40,1644
103,1648,3453,5204,"22 days, 21:46:01",2013-02-07 07:39:39,2013-02-07 07:39:39,2013-03-02 05:25:40,9542
2353,10382,8379,21114,"22 days, 21:46:14",2013-02-07 07:39:26,2013-02-07 07:39:26,2013-03-02 05:25:40,6336
247,779,1416,2442,"22 days, 21:47:27",2013-02-07 07:38:13,2013-02-07 07:38:13,2013-03-02 05:25:40,3599
48,6935,5920,12903,"22 days, 21:47:31",2013-02-07 07:38:09,2013-02-07 07:38:09,2013-03-02 05:25:40,5583
711,3913,5083,9707,"22 days, 21:48:06",2013-02-07 07:37:34,2013-02-07 07:37:34,2013-03-02 05:25:40,8882
892,3881,4015,8788,"22 days, 21:48:12",2013-02-07 07:37:28,2013-02-07 07:37:28,2013-03-02 05:25:40,6908
462,5092,8457,14011,"22 days, 21:48:30",2013-02-07 07:37:10,2013-02-07 07:37:10,2013-03-02 05:25:40,5626
2474,5803,5708,13985,"22 days, 21:49:43",2013-02-07 07:35:57,2013-02-07 07:35:57,2013-03-02 05:25:40,6099
3032,8430,5637,17099,"22 days, 21:50:31",2013-02-07 07:35:09,2013-02-07 07:35:09,2013-03-02 05:25:40,4865
1745,4146,6378,12269,"22 days, 21:51:08",2013-02-07 07:34:32,2013-02-07 07:34:32,2013-03-02 05:25:40,9765
405,1229,1513,3147,"22 days, 21:51:15",2013-02-07 07:34:25,2013-02-07 07:34:25,2013-03-02 05:25:40,9190
1189,7006,6812,15007,"22 days, 21:51:22",2013-02-07 07:34:18,2013-02-07 07:34:18,2013-03-02 05:25:40,5155
181,1641,1942,3764,"22 days, 21:52:34",2013-02-07 07:33:06,2013-02-07 07:33:06,2013-03-02 05:25:40,3958
497,2864,4053,7414,"22 days, 21:53:01",2013-02-07 07:32:39,2013-02-07 07:32:39,2013-03-02 05:25:40,9670
165,4296,4787,9248,"22 days, 21:53:08",2013-02-07 07:32:32,2013-02-07 07:32:32,2013-03-02 05:25:40,3170
1304,4701,6861,12866,"22 days, 21:54:13",2013-02-07 07:31:27,2013-02-07 07:31:27,2013-03-02 05:25:40,8654
397,1291,1985,3673,"22 days, 21:55:15",2013-02-07 07:30:25,2013-02-07 07:30:25,2013-03-02 05:25:40,8996
466,4128,3929,8523,"22 days, 21:56:00",2013-02-07 07:29:40,2013-02-07 07:29:40,2013-03-02 05:25:40,6533
543,4847,7343,12733,"22 days, 21:56:06",2013-02-07 07:29:34,2013-02-07 07:29:34,2013-03-02 05:25:40,7635
1238,3451,4378,9067,"22 days, 21:57:33",2013-02-07 07:28:07,2013-02-07 07:28:07,2013-03-02 05:25:40,5808
863,3642,5717,10222,"22 days, 21:57:57",2013-02-07 07:27:43,2013-02-07 07:27:43,2013-03-02 05:25:40,3434
1672,3757,4565,9994,"22 days, 21:58:39",2013-02-07 07:27:01,2013-02-07 07:27:01,2013-03-02 05:25:40,6507
1032,3492,4432,8956,"22 days, 21:58:42",2013-02-07 07:26:58,2013-02-07 07:26:58,2013-03-02 05:25:40,4288
430,3456,4353,8239,"22 days, 21:58:56",2013-02-07 07:26:44,2013-02-07 07:26:44,2013-03-02 05:25:40,6363
2897,5179,4131,12207,"22 days, 21:59:06",2013-02-07 07:26:34,2013-02-07 07:26:34,2013-03-02 05:25:40,834
765,5075,4388,10228,"22 days, 21:59:27",2013-02-07 07:26:13,2013-02-07 07:26:13,2013-03-02 05:25:40,3096
1380,8026,7206,16612,"22 days, 22:00:01",2013-02-07 07:25:39,2013-02-07 07:25:39,2013-03-02 05:25:40,1344
2726,6455,6703,15884,"22 days, 22:02:55",2013-02-07 07:22:45,2013-02-07 07:22:45,2013-03-02 05:25:40,4932
2502,9291,6339,18132,"22 days, 22:03:15",2013-02-07 07:22:25,2013-02-07 07:22:25,2013-03-02 05:25:40,3659
896,2280,4485,7661,"22 days, 22:03:50",2013-02-07 07:21:50,2013-02-07 07:21:50,2013-03-02 05:25:40,4293
27,542,1083,1652,"22 days, 22:04:29",2013-02-07 07:21:11,2013-02-07 07:21:11,2013-03-02 05:25:40,9745
592,3570,4950,9112,"22 days, 22:05:09",2013-02-07 07:20:31,2013-02-07 07:20:31,2013-03-02 05:25:40,6498
253,2421,3708,6382,"22 days, 22:05:26",2013-02-07 07:20:14,2013-02-07 07:20:14,2013-03-02 05:25:40,9480
1569,9893,10199,21661,"22 days, 22:06:29",2013-02-07 07:19:11,2013-02-07 07:19:11,2013-03-02 05:25:40,4991
45,3616,4945,8606,"22 days, 22:06:57",2013-02-07 07:18:43,2013-02-07 07:18:43,2013-03-02 05:25:40,4468
3,3211,3949,7163,"22 days, 22:08:35",2013-02-07 07:17:05,2013-02-07 07:17:05,2013-03-02 05:25:40,7393
654,9453,7181,17288,"22 days, 22:08:38",2013-02-07 07:17:02,2013-02-07 07:17:02,2013-03-02 05:25:40,2045
1018,825,2313,4156,"22 days, 22:08:57",2013-02-07 07:16:43,2013-02-07 07:16:43,2013-03-02 05:25:40,5006
67,6125,7530,13722,"22 days, 22:09:16",2013-02-07 07:16:24,2013-02-07 07:16:24,2013-03-02 05:25:40,2449
249,1278,1876,3403,"22 days, 22:10:12",2013-02-07 07:15:28,2013-02-07 07:15:28,2013-03-02 05:25:40,6968
144,8477,8388,17009,"22 days, 22:10:25",2013-02-07 07:15:15,2013-02-07 07:15:15,2013-03-02 05:25:40,4597
776,3894,4937,9607,"22 days, 22:10:45",2013-02-07 07:14:55,2013-02-07 07:14:55,2013-03-02 05:25:40,4186
126,3807,5816,9749,"22 days, 22:10:49",2013-02-07 07:14:51,2013-02-07 07:14:51,2013-03-02 05:25:40,7659
1804,5609,3970,11383,"22 days, 22:12:07",2013-02-07 07:13:33,2013-02-07 07:13:33,2013-03-02 05:25:40,8857
256,4920,4661,9837,"22 days, 22:12:23",2013-02-07 07:13:17,2013-02-07 07:13:17,2013-03-02 05:25:40,8798
819,5042,7000,12861,"22 days, 22:12:31",2013-02-07 07:13:09,2013-02-07 07:13:09,2013-03-02 05:25:40,2087
702,6535,5541,12778,"22 days, 22:12:50",2013-02-07 07:12:50,2013-02-07 07:12:50,2013-03-02 05:25:40,7660
430,1750,2424,4604,"22 days, 22:14:17",2013-02-07 07:11:23,2013-02-07 07:11:23,2013-03-02 05:25:40,8910
225,2460,2866,5551,"22 days, 22:14:24",2013-02-07 07:11:16,2013-02-07 07:11:16,2013-03-02 05:25:40,9949
1896,4436,5538,11870,"22 days, 22:14:39",2013-02-07 07:11:01,2013-02-07 07:11:01,2013-03-02 05:25:40,361
1302,5400,6087,12789,"22 days, 22:15:14",2013-02-07 07:10:26,2013-02-07 07:10:26,2013-03-02 05:25:40,2123
1001,1170,1841,4012,"22 days, 22:15:32",2013-02-07 07:10:08,2013-02-07 07:10:08,2013-03-02 05:25:40,8579
1300,7949,7080,16329,"22 days, 22:16:11",2013-02-07 07:09:29,2013-02-07 07:09:29,2013-03-02 05:25:40,3851
1003,3326,4050,8379,"22 days, 22:16:53",2013-02-07 07:08:47,2013-02-07 07:08:47,2013-03-02 05:25:40,8202
419,4383,4425,9227,"22 days, 22:18:31",2013-02-07 07:07:09,2013-02-07 07:07:09,2013-03-02 05:25:40,3158
2136,5676,6264,14076,"22 days, 22:18:38",2013-02-07 07:07:02,2013-02-07 07:07:02,2013-03-02 05:25:40,4761
602,976,2008,3586,"22 days, 22:18:51",2013-02-07 07:06:49,2013-02-07 07:06:49,2013-03-02 05:25:40,6649
526,4950,4136,9612,"22 days, 22:19:26",2013-02-07 07:06:14,2013-02-07 07:06:14,2013-03-02 05:25:40,8841
1270,6322,8464,16056,"22 days, 22:19:31",2013-02-07 07:06:09,2013-02-07 07:06:09,2013-03-02 05:25:40,8999
243,3475,4786,8504,"22 days, 22:20:15",2013-02-07 07:05:25,2013-02-07 07:05:25,2013-03-02 05:25:40,409
1104,7813,7776,16693,"22 days, 22:21:53",2013-02-07 07:03:47,2013-02-07 07:03:47,2013-03-02 05:25:40,3102
643,5618,6821,13082,"22 days, 22:22:34",2013-02-07 07:03:06,2013-02-07 07:03:06,2013-03-02 05:25:40,459
113,3532,4575,8220,"22 days, 22:22:38",2013-02-07 07:03:02,2013-02-07 07:03:02,2013-03-02 05:25:40,3410
1434,978,2391,4803,"22 days, 22:26:28",2013-02-07 06:59:12,2013-02-07 06:59:12,2013-03-02 05:25:40,8697
175,3762,6027,9964,"22 days, 22:26:30",2013-02-07 06:59:10,2013-02-07 06:59:10,2013-03-02 05:25:40,7474
298,1361,2288,3947,"22 days, 22:26:49",2013-02-07 06:58:51,2013-02-07 06:58:51,2013-03-02 05:25:40,8833
2351,6660,6389,15400,"22 days, 22:27:16",2013-02-07 06:58:24,2013-02-07 06:58:24,2013-03-02 05:25:40,4411
168,3519,3866,7553,"22 days, 22:27:36",2013-02-07 06:58:04,2013-02-07 06:58:04,2013-03-02 05:25:40,7042
1007,4089,4585,9681,"22 days, 22:27:37",2013-02-07 06:58:03,2013-02-07 06:58:03,2013-03-02 05:25:40,984
149,3288,3239,6676,"22 days, 22:28:04",2013-02-07 06:57:36,2013-02-07 06:57:36,2013-03-02 05:25:40,7665
381,4603,4900,9884,"22 days, 22:28:14",2013-02-07 06:57:26,2013-02-07 06:57:26,2013-03-02 05:25:40,186
125,798,1630,2553,"22 days, 22:28:19",2013-02-07 06:57:21,2013-02-07 06:57:21,2013-03-02 05:25:40,1245
54,2991,3535,6580,"22 days, 22:28:54",2013-02-07 06:56:46,2013-02-07 06:56:46,2013-03-02 05:25:40,4184
969,5595,5130,11694,"22 days, 22:29:10",2013-02-07 06:56:30,2013-02-07 06:56:30,2013-03-02 05:25:40,5659
19,4902,6037,10958,"22 days, 22:29:15",2013-02-07 06:56:25,2013-02-07 06:56:25,2013-03-02 05:25:40,3204
1137,5925,7236,14298,"22 days, 22:30:35",2013-02-07 06:55:05,2013-02-07 06:55:05,2013-03-02 05:25:40,7210
1092,2536,3013,6641,"22 days, 22:30:40",2013-02-07 06:55:00,2013-02-07 06:55:00,2013-03-02 05:25:40,2036
1195,1284,2572,5051,"22 days, 22:30:44",2013-02-07 06:54:56,2013-02-07 06:54:56,2013-03-02 05:25:40,229
834,2768,3425,7027,"22 days, 22:31:28",2013-02-07 06:54:12,2013-02-07 06:54:12,2013-03-02 05:25:40,1625
1235,6610,5343,13188,"22 days, 22:32:12",2013-02-07 06:53:28,2013-02-07 06:53:28,2013-03-02 05:25:40,3230
1440,4475,5237,11152,"22 days, 22:32:19",2013-02-07 06:53:21,2013-02-07 06:53:21,2013-03-02 05:25:40,7090
222,1130,1685,3037,"22 days, 22:32:48",2013-02-07 06:52:52,2013-02-07 06:52:52,2013-03-02 05:25:40,7529
919,2569,4064,7552,"22 days, 22:33:03",2013-02-07 06:52:37,2013-02-07 06:52:37,2013-03-02 05:25:40,9313
575,8081,7546,16202,"22 days, 22:34:28",2013-02-07 06:51:12,2013-02-07 06:51:12,2013-03-02 05:25:40,2254
379,3706,4133,8218,"22 days, 22:35:39",2013-02-07 06:50:01,2013-02-07 06:50:01,2013-03-02 05:25:40,5619
1389,5420,7126,13935,"22 days, 22:35:56",2013-02-07 06:49:44,2013-02-07 06:49:44,2013-03-02 05:25:40,522
309,1587,3043,4939,"22 days, 22:36:32",2013-02-07 06:49:08,2013-02-07 06:49:08,2013-03-02 05:25:40,5908
650,4805,8111,13566,"22 days, 22:36:50",2013-02-07 06:48:50,2013-02-07 06:48:50,2013-03-02 05:25:40,6172
591,1039,1977,3607,"22 days, 22:37:25",2013-02-07 06:48:15,2013-02-07 06:48:15,2013-03-02 05:25:40,5729
163,915,930,2008,"22 days, 22:39:52",2013-02-07 06:45:48,2013-02-07 06:45:48,2013-03-02 05:25:40,3714
1115,1576,2978,5669,"22 days, 22:40:12",2013-02-07 06:45:28,2013-02-07 06:45:28,2013-03-02 05:25:40,5538
303,1627,2088,4018,"22 days, 22:40:50",2013-02-07 06:44:50,2013-02-07 06:44:50,2013-03-02 05:25:40,3490
449,6359,7288,14096,"22 days, 22:41:45",2013-02-07 06:43:55,2013-02-07 06:43:55,2013-03-02 05:25:40,8572
144,7668,8540,16352,"22 days, 22:41:59",2013-02-07 06:43:41,2013-02-07 06:43:41,2013-03-02 05:25:40,2398
1047,6930,7421,15398,"22 days, 22:42:08",2013-02-07 06:43:32,2013-02-07 06:43:32,2013-03-02 05:25:40,7381
363,6158,6632,13153,"22 days, 22:42:19",2013-02-07 06:43:21,2013-02-07 06:43:21,2013-03-02 05:25:40,3142
614,7615,6899,15128,"22 days, 22:43:08",2013-02-07 06:42:32,2013-02-07 06:42:32,2013-03-02 05:25:40,3389
470,4247,3656,8373,"22 days, 22:43:24",2013-02-07 06:42:16,2013-02-07 06:42:16,2013-03-02 05:25:40,3901
641,6315,7775,14731,"22 days, 22:43:36",2013-02-07 06:42:04,2013-02-07 06:42:04,2013-03-02 05:25:40,2696
70,1996,2349,4415,"22 days, 22:44:06",2013-02-07 06:41:34,2013-02-07 06:41:34,2013-03-02 05:25:40,3617
62,3361,6797,10220,"22 days, 22:44:40",2013-02-07 06:41:00,2013-02-07 06:41:00,2013-03-02 05:25:40,2469
1788,5907,6494,14189,"22 days, 22:45:27",2013-02-07 06:40:13,2013-02-07 06:40:13,2013-03-02 05:25:40,6291
51,5060,4187,9298,"22 days, 22:47:35",2013-02-07 06:38:05,2013-02-07 06:38:05,2013-03-02 05:25:40,5339
183,8311,7211,15705,"22 days, 22:47:40",2013-02-07 06:38:00,2013-02-07 06:38:00,2013-03-02 05:25:40,4494
734,7834,6652,15220,"22 days, 22:47:41",2013-02-07 06:37:59,2013-02-07 06:37:59,2013-03-02 05:25:40,5361
121,3474,3559,7154,"22 days, 22:49:24",2013-02-07 06:36:16,2013-02-07 06:36:16,2013-03-02 05:25:40,41
829,1506,2193,4528,"22 days, 22:50:14",2013-02-07 06:35:26,2013-02-07 06:35:26,2013-03-02 05:25:40,5883
312,6136,9825,16273,"22 days, 22:50:48",2013-02-07 07:52:09,2010-02-01 10:32:08,2010-02-24 09:22:56,6811
16,661,884,1561,"22 days, 22:55:47",2013-02-07 06:29:53,2013-02-07 06:29:53,2013-03-02 05:25:40,4334
1974,7957,8924,18855,"22 days, 22:55:52",2013-02-07 06:29:48,2013-02-07 06:29:48,2013-03-02 05:25:40,3273
1613,5728,6610,13951,"22 days, 22:56:00",2013-02-07 06:29:40,2013-02-07 06:29:40,2013-03-02 05:25:40,9324
1261,5947,7814,15022,"22 days, 22:57:01",2013-02-07 06:28:39,2013-02-07 06:28:39,2013-03-02 05:25:40,9329
56,3440,4312,7808,"22 days, 22:57:03",2013-02-07 06:28:37,2013-02-07 06:28:37,2013-03-02 05:25:40,8338
927,3439,6004,10370,"22 days, 22:57:23",2013-02-07 06:28:17,2013-02-07 06:28:17,2013-03-02 05:25:40,6971
102,1881,2208,4191,"22 days, 22:57:45",2013-02-07 06:27:55,2013-02-07 06:27:55,2013-03-02 05:25:40,3979
1537,10286,7604,19427,"22 days, 22:58:01",2013-02-07 06:27:39,2013-02-07 06:27:39,2013-03-02 05:25:40,2674
621,5359,6629,12609,"22 days, 22:58:40",2013-02-07 06:27:00,2013-02-07 06:27:00,2013-03-02 05:25:40,5275
665,2361,3131,6157,"22 days, 22:59:39",2013-02-07 06:26:01,2013-02-07 06:26:01,2013-03-02 05:25:40,1831
844,6940,7295,15079,"22 days, 23:00:25",2013-02-07 06:25:15,2013-02-07 06:25:15,2013-03-02 05:25:40,1948
166,3829,3884,7879,"22 days, 23:01:41",2013-02-07 06:23:59,2013-02-07 06:23:59,2013-03-02 05:25:40,5365
89,6897,8453,15439,"22 days, 23:01:43",2013-02-07 06:23:57,2013-02-07 06:23:57,2013-03-02 05:25:40,377
2001,3518,4246,9765,"22 days, 23:02:11",2013-02-07 06:23:29,2013-02-07 06:23:29,2013-03-02 05:25:40,1375
1176,5116,7085,13377,"22 days, 23:02:27",2013-02-07 06:23:13,2013-02-07 06:23:13,2013-03-02 05:25:40,9371
168,894,1723,2785,"22 days, 23:02:50",2013-02-07 06:22:50,2013-02-07 06:22:50,2013-03-02 05:25:40,461
1080,4181,6937,12198,"22 days, 23:03:23",2013-02-07 06:22:17,2013-02-07 06:22:17,2013-03-02 05:25:40,6148
2242,6555,7815,16612,"22 days, 23:03:47",2013-02-07 06:21:53,2013-02-07 06:21:53,2013-03-02 05:25:40,5026
472,6141,8320,14933,"22 days, 23:03:56",2013-02-07 06:21:44,2013-02-07 06:21:44,2013-03-02 05:25:40,9905
253,2462,4067,6782,"22 days, 23:04:37",2013-02-07 06:21:03,2013-02-07 06:21:03,2013-03-02 05:25:40,1959
49,1894,3215,5158,"22 days, 23:04:48",2013-02-07 06:20:52,2013-02-07 06:20:52,2013-03-02 05:25:40,3216
2849,8423,8333,19605,"22 days, 23:05:54",2013-02-07 06:19:46,2013-02-07 06:19:46,2013-03-02 05:25:40,9210
3235,8922,7291,19448,"22 days, 23:06:01",2013-02-07 06:19:39,2013-02-07 06:19:39,2013-03-02 05:25:40,5004
989,2453,5620,9062,"22 days, 23:07:01",2013-02-07 06:18:39,2013-02-07 06:18:39,2013-03-02 05:25:40,1688
1039,9350,9351,19740,"22 days, 23:07:02",2013-02-07 06:18:38,2013-02-07 06:18:38,2013-03-02 05:25:40,8800
68,2033,3107,5208,"22 days, 23:07:19",2013-02-07 06:18:21,2013-02-07 06:18:21,2013-03-02 05:25:40,3643
271,7479,7335,15085,"22 days, 23:09:03",2013-02-07 06:16:37,2013-02-07 06:16:37,2013-03-02 05:25:40,9205
57,2658,1940,4655,"22 days, 23:09:09",2013-02-07 06:16:31,2013-02-07 06:16:31,2013-03-02 05:25:40,9568
175,2072,3302,5549,"22 days, 23:10:18",2013-02-07 06:15:22,2013-02-07 06:15:22,2013-03-02 05:25:40,4819
664,7330,9641,17635,"22 days, 23:12:37",2013-02-08 02:54:18,2010-02-01 10:32:08,2010-02-24 09:44:45,7919
1152,2172,3426,6750,"22 days, 23:14:29",2013-02-07 06:11:11,2013-02-07 06:11:11,2013-03-02 05:25:40,488
1981,7662,8181,17824,"22 days, 23:14:49",2013-02-07 06:10:51,2013-02-07 06:10:51,2013-03-02 05:25:40,5079
422,3169,2457,6048,"22 days, 23:15:46",2013-02-07 06:09:54,2013-02-07 06:09:54,2013-03-02 05:25:40,9506
408,6711,7467,14586,"22 days, 23:15:47",2013-02-07 06:09:53,2013-02-07 06:09:53,2013-03-02 05:25:40,2652
602,4040,4397,9039,"22 days, 23:16:23",2013-02-07 06:09:17,2013-02-07 06:09:17,2013-03-02 05:25:40,7767
561,2018,2141,4720,"22 days, 23:16:30",2013-02-07 06:09:10,2013-02-07 06:09:10,2013-03-02 05:25:40,629
734,2060,3736,6530,"22 days, 23:17:07",2013-02-07 06:08:33,2013-02-07 06:08:33,2013-03-02 05:25:40,3479
279,4554,4658,9491,"22 days, 23:18:43",2013-02-07 06:06:57,2013-02-07 06:06:57,2013-03-02 05:25:40,7107
1054,3912,4950,9916,"22 days, 23:19:01",2013-02-07 06:06:39,2013-02-07 06:06:39,2013-03-02 05:25:40,7237
8,2292,4958,7258,"22 days, 23:19:09",2013-02-07 06:06:31,2013-02-07 06:06:31,2013-03-02 05:25:40,910
176,5731,6776,12683,"22 days, 23:19:29",2013-02-07 06:06:11,2013-02-07 06:06:11,2013-03-02 05:25:40,3823
929,6590,7078,14597,"22 days, 23:19:49",2013-02-07 06:05:51,2013-02-07 06:05:51,2013-03-02 05:25:40,6178
14,6405,7787,14206,"22 days, 23:20:27",2013-02-07 06:05:13,2013-02-07 06:05:13,2013-03-02 05:25:40,8608
570,360,712,1642,"22 days, 23:21:08",2013-02-07 06:04:32,2013-02-07 06:04:32,2013-03-02 05:25:40,9355
464,2889,3638,6991,"22 days, 23:21:45",2013-02-07 06:03:55,2013-02-07 06:03:55,2013-03-02 05:25:40,8672
694,4707,4047,9448,"22 days, 23:21:50",2013-02-07 06:03:50,2013-02-07 06:03:50,2013-03-02 05:25:40,2229
461,5564,5749,11774,"22 days, 23:22:09",2013-02-07 06:03:31,2013-02-07 06:03:31,2013-03-02 05:25:40,1736
1508,10356,8382,20246,"22 days, 23:22:18",2013-02-07 06:03:22,2013-02-07 06:03:22,2013-03-02 05:25:40,385
53,1528,3257,4838,"22 days, 23:22:54",2013-02-07 07:16:42,2010-03-17 06:41:36,2010-04-09 06:04:30,9111
438,618,1351,2407,"22 days, 23:23:28",2013-02-07 06:02:12,2013-02-07 06:02:12,2013-03-02 05:25:40,1252
264,9201,6779,16244,"22 days, 23:23:33",2013-02-07 06:02:07,2013-02-07 06:02:07,2013-03-02 05:25:40,7043
2528,8664,6117,17309,"22 days, 23:23:57",2013-02-07 06:01:43,2013-02-07 06:01:43,2013-03-02 05:25:40,2604
421,6508,5797,12726,"22 days, 23:25:50",2013-02-07 05:59:50,2013-02-07 05:59:50,2013-03-02 05:25:40,3745
1659,8695,6125,16479,"22 days, 23:25:56",2013-02-07 05:59:44,2013-02-07 05:59:44,2013-03-02 05:25:40,9222
618,7405,6525,14548,"22 days, 23:25:56",2013-02-07 05:59:44,2013-02-07 05:59:44,2013-03-02 05:25:40,1261
987,5144,8399,14530,"22 days, 23:26:23",2013-02-07 05:59:17,2013-02-07 05:59:17,2013-03-02 05:25:40,6598
518,5210,7421,13149,"22 days, 23:26:29",2013-02-07 05:59:11,2013-02-07 05:59:11,2013-03-02 05:25:40,2794
835,5427,6035,12297,"22 days, 23:26:53",2013-02-07 05:58:47,2013-02-07 05:58:47,2013-03-02 05:25:40,1827
191,2411,3642,6244,"22 days, 23:28:31",2013-02-07 05:57:09,2013-02-07 05:57:09,2013-03-02 05:25:40,9477
69,3634,3572,7275,"22 days, 23:28:41",2013-02-07 05:56:59,2013-02-07 05:56:59,2013-03-02 05:25:40,7414
769,1902,2549,5220,"22 days, 23:29:21",2013-02-07 05:56:19,2013-02-07 05:56:19,2013-03-02 05:25:40,3755
1362,6887,9040,17289,"22 days, 23:29:30",2013-02-07 05:56:10,2013-02-07 05:56:10,2013-03-02 05:25:40,2529
370,3957,5281,9608,"22 days, 23:29:31",2013-02-07 05:56:09,2013-02-07 05:56:09,2013-03-02 05:25:40,4052
914,2821,3129,6864,"22 days, 23:29:41",2013-02-07 05:55:59,2013-02-07 05:55:59,2013-03-02 05:25:40,6300
632,8196,7775,16603,"22 days, 23:30:52",2013-02-07 05:54:48,2013-02-07 05:54:48,2013-03-02 05:25:40,5292
2598,6070,6307,14975,"22 days, 23:31:17",2013-02-07 05:54:23,2013-02-07 05:54:23,2013-03-02 05:25:40,4836
494,4772,5280,10546,"22 days, 23:31:57",2013-02-07 05:53:43,2013-02-07 05:53:43,2013-03-02 05:25:40,778
458,5444,5387,11289,"22 days, 23:32:00",2013-02-07 05:53:40,2013-02-07 05:53:40,2013-03-02 05:25:40,7250
164,2905,3619,6688,"22 days, 23:32:04",2013-02-07 05:53:36,2013-02-07 05:53:36,2013-03-02 05:25:40,9470
74,5892,6220,12186,"22 days, 23:32:09",2013-02-07 05:53:31,2013-02-07 05:53:31,2013-03-02 05:25:40,7144
957,4844,4673,10474,"22 days, 23:32:27",2013-02-07 05:53:13,2013-02-07 05:53:13,2013-03-02 05:25:40,9962
2088,4960,5434,12482,"22 days, 23:32:33",2013-02-07 05:53:07,2013-02-07 05:53:07,2013-03-02 05:25:40,4364
402,3018,3157,6577,"22 days, 23:32:43",2013-02-07 05:52:57,2013-02-07 05:52:57,2013-03-02 05:25:40,678
710,5157,7021,12888,"22 days, 23:32:45",2013-02-07 05:52:55,2013-02-07 05:52:55,2013-03-02 05:25:40,6082
1208,7264,9325,17797,"22 days, 23:32:50",2013-02-07 05:52:50,2013-02-07 05:52:50,2013-03-02 05:25:40,2017
888,1257,2151,4296,"22 days, 23:33:12",2013-02-07 05:52:28,2013-02-07 05:52:28,2013-03-02 05:25:40,6585
1948,2393,4640,8981,"22 days, 23:33:13",2013-02-07 05:52:27,2013-02-07 05:52:27,2013-03-02 05:25:40,4043
312,2067,2897,5276,"22 days, 23:35:14",2013-02-07 05:50:26,2013-02-07 05:50:26,2013-03-02 05:25:40,2357
106,3241,3688,7035,"22 days, 23:35:56",2013-02-07 05:49:44,2013-02-07 05:49:44,2013-03-02 05:25:40,5604
1199,1777,2751,5727,"22 days, 23:37:11",2013-02-07 05:48:29,2013-02-07 05:48:29,2013-03-02 05:25:40,5576
203,6177,6014,12394,"22 days, 23:37:16",2013-02-07 05:48:24,2013-02-07 05:48:24,2013-03-02 05:25:40,3407
883,2510,4178,7571,"22 days, 23:37:23",2013-02-07 05:48:17,2013-02-07 05:48:17,2013-03-02 05:25:40,8466
361,4967,8287,13615,"22 days, 23:37:27",2013-02-07 05:48:13,2013-02-07 05:48:13,2013-03-02 05:25:40,2031
1313,2116,3944,7373,"22 days, 23:37:47",2013-02-07 05:47:53,2013-02-07 05:47:53,2013-03-02 05:25:40,871
955,3372,3267,7594,"22 days, 23:38:42",2013-02-07 05:46:58,2013-02-07 05:46:58,2013-03-02 05:25:40,9424
600,1152,1461,3213,"22 days, 23:40:09",2013-02-07 05:45:31,2013-02-07 05:45:31,2013-03-02 05:25:40,6841
314,4035,5151,9500,"22 days, 23:42:10",2013-02-07 05:43:30,2013-02-07 05:43:30,2013-03-02 05:25:40,5197
172,3983,4605,8760,"22 days, 23:43:15",2013-02-07 05:42:25,2013-02-07 05:42:25,2013-03-02 05:25:40,625
736,3886,4401,9023,"22 days, 23:43:30",2013-02-07 05:42:10,2013-02-07 05:42:10,2013-03-02 05:25:40,2853
538,3056,3260,6854,"22 days, 23:44:09",2013-02-08 04:38:53,2010-02-01 10:32:08,2010-02-24 10:16:17,2933
83,3220,4684,7987,"22 days, 23:45:02",2013-02-07 05:40:38,2013-02-07 05:40:38,2013-03-02 05:25:40,3277
2958,6254,6980,16192,"22 days, 23:45:03",2013-02-07 05:40:37,2013-02-07 05:40:37,2013-03-02 05:25:40,9220
396,1074,1645,3115,"22 days, 23:47:36",2013-02-07 05:38:04,2013-02-07 05:38:04,2013-03-02 05:25:40,6154
1768,2940,4257,8965,"22 days, 23:48:00",2013-02-07 05:37:40,2013-02-07 05:37:40,2013-03-02 05:25:40,7530
705,8250,8453,17408,"22 days, 23:48:29",2013-02-07 05:37:11,2013-02-07 05:37:11,2013-03-02 05:25:40,1026
262,1627,3025,4914,"22 days, 23:48:55",2013-02-07 05:36:45,2013-02-07 05:36:45,2013-03-02 05:25:40,5913
192,4068,5535,9795,"22 days, 23:50:29",2013-02-07 05:35:11,2013-02-07 05:35:11,2013-03-02 05:25:40,8873
926,299,906,2131,"22 days, 23:53:17",2013-02-07 05:32:23,2013-02-07 05:32:23,2013-03-02 05:25:40,1691
152,2422,6028,8602,"22 days, 23:54:29",2013-02-07 05:31:11,2013-02-07 05:31:11,2013-03-02 05:25:40,4358
183,3283,4000,7466,"22 days, 23:54:46",2013-02-07 05:30:54,2013-02-07 05:30:54,2013-03-02 05:25:40,3522
1626,2936,4526,9088,"22 days, 23:54:54",2013-02-07 05:30:46,2013-02-07 05:30:46,2013-03-02 05:25:40,9504
34,2571,3724,6329,"22 days, 23:55:50",2013-02-07 05:29:50,2013-02-07 05:29:50,2013-03-02 05:25:40,3487
1263,4000,4337,9600,"22 days, 23:56:09",2013-02-07 05:29:31,2013-02-07 05:29:31,2013-03-02 05:25:40,7437
2512,9040,7129,18681,"22 days, 23:56:16",2013-02-07 05:29:24,2013-02-07 05:29:24,2013-03-02 05:25:40,4910
1611,3833,5877,11321,"22 days, 23:56:51",2013-02-07 05:28:49,2013-02-07 05:28:49,2013-03-02 05:25:40,5647
215,7211,7905,15331,"22 days, 23:57:25",2013-02-07 05:28:15,2013-02-07 05:28:15,2013-03-02 05:25:40,814
1119,2576,3107,6802,"22 days, 23:57:46",2013-02-07 05:27:54,2013-02-07 05:27:54,2013-03-02 05:25:40,9907
633,2194,3063,5890,"22 days, 23:59:46",2013-02-07 05:25:54,2013-02-07 05:25:54,2013-03-02 05:25:40,3914
561,1916,2579,5056,"23 days, 0:00:30",2013-02-07 05:25:10,2013-02-07 05:25:10,2013-03-02 05:25:40,891
2633,8408,6925,17966,"23 days, 0:01:38",2013-02-07 05:24:02,2013-02-07 05:24:02,2013-03-02 05:25:40,294
103,4164,3406,7673,"23 days, 0:02:09",2013-02-07 05:23:31,2013-02-07 05:23:31,2013-03-02 05:25:40,2561
2409,2584,3165,8158,"23 days, 0:05:09",2013-02-07 05:20:31,2013-02-07 05:20:31,2013-03-02 05:25:40,9236
86,3770,5073,8929,"23 days, 0:06:23",2013-02-07 05:19:17,2013-02-07 05:19:17,2013-03-02 05:25:40,797
2487,8407,6367,17261,"23 days, 0:06:51",2013-02-07 05:18:49,2013-02-07 05:18:49,2013-03-02 05:25:40,5387
1245,3351,4500,9096,"23 days, 0:07:20",2013-02-07 05:18:20,2013-02-07 05:18:20,2013-03-02 05:25:40,4133
839,8148,6105,15092,"23 days, 0:08:44",2013-02-07 05:16:56,2013-02-07 05:16:56,2013-03-02 05:25:40,9979
99,4100,3225,7424,"23 days, 0:09:36",2013-02-07 05:16:04,2013-02-07 05:16:04,2013-03-02 05:25:40,3645
2709,9357,7999,20065,"23 days, 0:10:41",2013-02-07 05:14:59,2013-02-07 05:14:59,2013-03-02 05:25:40,4931
354,4501,3832,8687,"23 days, 0:11:14",2013-02-07 05:14:26,2013-02-07 05:14:26,2013-03-02 05:25:40,524
752,4624,4670,10046,"23 days, 0:13:29",2013-02-07 05:12:11,2013-02-07 05:12:11,2013-03-02 05:25:40,8546
114,5239,5306,10659,"23 days, 0:14:12",2013-02-07 05:11:28,2013-02-07 05:11:28,2013-03-02 05:25:40,6957
1186,4317,5508,11011,"23 days, 0:15:11",2013-02-07 05:10:29,2013-02-07 05:10:29,2013-03-02 05:25:40,2475
274,5170,5206,10650,"23 days, 0:17:46",2013-02-07 05:07:54,2013-02-07 05:07:54,2013-03-02 05:25:40,9347
2113,6615,7034,15762,"23 days, 0:19:49",2013-02-12 11:37:46,2010-02-14 03:12:39,2010-03-09 03:32:28,2542
506,1773,3550,5829,"23 days, 0:20:33",2013-02-07 05:05:07,2013-02-07 05:05:07,2013-03-02 05:25:40,648
179,3783,6114,10076,"23 days, 0:22:12",2013-02-07 05:03:28,2013-02-07 05:03:28,2013-03-02 05:25:40,8737
1295,4477,7334,13106,"23 days, 0:22:37",2013-02-07 05:03:03,2013-02-07 05:03:03,2013-03-02 05:25:40,8917
987,3841,3786,8614,"23 days, 0:22:48",2013-02-07 05:02:52,2013-02-07 05:02:52,2013-03-02 05:25:40,3891
304,6395,7390,14089,"23 days, 0:22:58",2013-02-07 05:02:42,2013-02-07 05:02:42,2013-03-02 05:25:40,3797
290,1433,2249,3972,"23 days, 0:23:17",2013-02-07 05:02:23,2013-02-07 05:02:23,2013-03-02 05:25:40,7840
2992,2966,4533,10491,"23 days, 0:23:27",2013-02-07 05:02:13,2013-02-07 05:02:13,2013-03-02 05:25:40,9585
638,5175,5818,11631,"23 days, 0:24:19",2013-02-07 05:01:21,2013-02-07 05:01:21,2013-03-02 05:25:40,6826
298,3821,5105,9224,"23 days, 0:25:26",2013-02-07 05:00:14,2013-02-07 05:00:14,2013-03-02 05:25:40,3223
442,1931,2538,4911,"23 days, 0:25:42",2013-02-07 04:59:58,2013-02-07 04:59:58,2013-03-02 05:25:40,4791
1360,6641,4841,12842,"23 days, 0:27:04",2013-02-07 04:58:36,2013-02-07 04:58:36,2013-03-02 05:25:40,8140
915,8655,10706,20276,"23 days, 0:27:15",2013-02-07 04:58:25,2013-02-07 04:58:25,2013-03-02 05:25:40,8230
541,804,2048,3393,"23 days, 0:27:50",2013-02-07 04:57:50,2013-02-07 04:57:50,2013-03-02 05:25:40,9260
981,7785,7438,16204,"23 days, 0:28:30",2013-02-07 04:57:10,2013-02-07 04:57:10,2013-03-02 05:25:40,7872
2366,7972,6480,16818,"23 days, 0:29:59",2013-02-07 04:55:41,2013-02-07 04:55:41,2013-03-02 05:25:40,530
708,354,789,1851,"23 days, 0:30:13",2013-02-07 07:31:08,2010-11-26 05:44:32,2010-12-19 06:14:45,8599
823,2825,3493,7141,"23 days, 0:30:17",2013-02-07 04:55:23,2013-02-07 04:55:23,2013-03-02 05:25:40,6243
374,5824,8073,14271,"23 days, 0:31:12",2013-02-07 04:54:28,2013-02-07 04:54:28,2013-03-02 05:25:40,878
38,3751,5306,9095,"23 days, 0:31:48",2013-02-07 04:53:52,2013-02-07 04:53:52,2013-03-02 05:25:40,5512
1877,2514,4171,8562,"23 days, 0:32:11",2013-02-07 09:45:09,2010-02-01 10:32:08,2010-02-24 11:04:19,7410
142,6454,4887,11483,"23 days, 0:32:31",2013-02-07 04:53:09,2013-02-07 04:53:09,2013-03-02 05:25:40,8700
568,4372,4322,9262,"23 days, 0:32:43",2013-02-07 04:52:57,2013-02-07 04:52:57,2013-03-02 05:25:40,8369
1001,7407,8788,17196,"23 days, 0:33:02",2013-02-07 04:52:38,2013-02-07 04:52:38,2013-03-02 05:25:40,2427
380,1867,2884,5131,"23 days, 0:33:50",2013-02-07 04:51:50,2013-02-07 04:51:50,2013-03-02 05:25:40,4444
120,4012,5567,9699,"23 days, 0:34:02",2013-02-07 04:51:38,2013-02-07 04:51:38,2013-03-02 05:25:40,3630
61,4866,5353,10280,"23 days, 0:34:05",2013-02-07 04:51:35,2013-02-07 04:51:35,2013-03-02 05:25:40,5202
1721,3325,4010,9056,"23 days, 0:34:32",2013-02-07 04:51:08,2013-02-07 04:51:08,2013-03-02 05:25:40,4591
575,7959,7873,16407,"23 days, 0:35:33",2013-02-07 04:50:07,2013-02-07 04:50:07,2013-03-02 05:25:40,323
336,7578,7447,15361,"23 days, 0:35:42",2013-02-07 04:49:58,2013-02-07 04:49:58,2013-03-02 05:25:40,8892
310,1901,1600,3811,"23 days, 0:37:03",2013-02-07 04:48:37,2013-02-07 04:48:37,2013-03-02 05:25:40,5112
2837,5959,7191,15987,"23 days, 0:37:15",2013-02-07 04:48:25,2013-02-07 04:48:25,2013-03-02 05:25:40,5428
763,5335,7378,13476,"23 days, 0:37:25",2013-02-07 04:48:15,2013-02-07 04:48:15,2013-03-02 05:25:40,6562
727,1690,1657,4074,"23 days, 0:38:12",2013-02-07 04:47:28,2013-02-07 04:47:28,2013-03-02 05:25:40,9756
782,4186,4516,9484,"23 days, 0:38:16",2013-02-07 04:47:24,2013-02-07 04:47:24,2013-03-02 05:25:40,4770
2130,2696,3323,8149,"23 days, 0:38:21",2013-02-07 04:47:19,2013-02-07 04:47:19,2013-03-02 05:25:40,4912
551,2174,2565,5290,"23 days, 0:38:21",2013-02-07 04:47:19,2013-02-07 04:47:19,2013-03-02 05:25:40,7187
87,6453,10436,16976,"23 days, 0:39:19",2013-02-07 04:46:21,2013-02-07 04:46:21,2013-03-02 05:25:40,2249
1322,7188,9502,18012,"23 days, 0:39:54",2013-02-07 04:45:46,2013-02-07 04:45:46,2013-03-02 05:25:40,7352
253,2255,2884,5392,"23 days, 0:42:09",2013-02-07 04:43:31,2013-02-07 04:43:31,2013-03-02 05:25:40,8405
1086,2907,4931,8924,"23 days, 0:43:11",2013-02-07 04:42:29,2013-02-07 04:42:29,2013-03-02 05:25:40,1404
929,3305,5230,9464,"23 days, 0:44:52",2013-02-07 04:40:48,2013-02-07 04:40:48,2013-03-02 05:25:40,2106
869,1133,2247,4249,"23 days, 0:45:19",2013-02-07 04:40:21,2013-02-07 04:40:21,2013-03-02 05:25:40,767
909,847,1586,3342,"23 days, 0:45:24",2013-02-07 04:40:16,2013-02-07 04:40:16,2013-03-02 05:25:40,3056
10,1014,1232,2256,"23 days, 0:45:32",2013-02-07 04:40:08,2013-02-07 04:40:08,2013-03-02 05:25:40,5891
2053,4809,5528,12390,"23 days, 0:45:47",2013-02-07 04:39:53,2013-02-07 04:39:53,2013-03-02 05:25:40,5915
489,939,1445,2873,"23 days, 0:46:56",2013-02-07 04:38:44,2013-02-07 04:38:44,2013-03-02 05:25:40,356
350,6877,9106,16333,"23 days, 0:47:38",2013-02-07 04:38:02,2013-02-07 04:38:02,2013-03-02 05:25:40,6056
935,3137,3821,7893,"23 days, 0:47:58",2013-02-07 04:37:42,2013-02-07 04:37:42,2013-03-02 05:25:40,9132
630,3314,4075,8019,"23 days, 0:48:53",2013-02-07 07:35:18,2010-02-01 10:32:08,2010-02-24 11:21:01,2501
201,4012,5084,9297,"23 days, 0:49:03",2013-02-07 04:36:37,2013-02-07 04:36:37,2013-03-02 05:25:40,1141
1015,341,440,1796,"23 days, 0:49:21",2013-02-07 04:36:19,2013-02-07 04:36:19,2013-03-02 05:25:40,8483
1878,5075,5144,12097,"23 days, 0:52:23",2013-02-07 04:33:17,2013-02-07 04:33:17,2013-03-02 05:25:40,998
479,3457,3914,7850,"23 days, 0:53:05",2013-02-07 04:32:35,2013-02-07 04:32:35,2013-03-02 05:25:40,1455
1844,3983,5262,11089,"23 days, 0:53:37",2013-02-07 04:32:03,2013-02-07 04:32:03,2013-03-02 05:25:40,6961
1085,3762,4751,9598,"23 days, 0:54:27",2013-02-07 04:31:13,2013-02-07 04:31:13,2013-03-02 05:25:40,5518
802,3728,4794,9324,"23 days, 0:54:29",2013-02-07 04:31:11,2013-02-07 04:31:11,2013-03-02 05:25:40,9911
2491,3886,6147,12524,"23 days, 0:54:37",2013-02-07 04:31:03,2013-02-07 04:31:03,2013-03-02 05:25:40,4442
1645,3677,3987,9309,"23 days, 0:54:54",2013-02-07 06:52:12,2010-02-01 10:32:08,2010-02-24 11:27:02,4236
1241,3193,4454,8888,"23 days, 0:55:38",2013-02-07 04:30:02,2013-02-07 04:30:02,2013-03-02 05:25:40,2135
25,880,1154,2059,"23 days, 0:55:41",2013-02-07 04:59:11,2010-02-01 10:32:08,2010-02-24 11:27:49,4347
16,4831,5481,10328,"23 days, 0:55:50",2013-02-07 04:29:50,2013-02-07 04:29:50,2013-03-02 05:25:40,6893
482,3334,2778,6594,"23 days, 0:56:02",2013-02-07 04:29:38,2013-02-07 04:29:38,2013-03-02 05:25:40,7430
114,4112,6486,10712,"23 days, 0:56:46",2013-02-07 04:28:54,2013-02-07 04:28:54,2013-03-02 05:25:40,2755
104,853,1265,2222,"23 days, 0:57:33",2013-02-07 04:28:07,2013-02-07 04:28:07,2013-03-02 05:25:40,9415
795,3215,5287,9297,"23 days, 0:58:27",2013-02-11 00:22:06,2010-02-01 10:32:08,2010-02-24 11:30:35,9518
194,1310,1480,2984,"23 days, 0:59:53",2013-02-07 04:25:47,2013-02-07 04:25:47,2013-03-02 05:25:40,5820
2161,5082,7100,14343,"23 days, 1:00:14",2013-02-07 04:25:26,2013-02-07 04:25:26,2013-03-02 05:25:40,3633
45,2463,3026,5534,"23 days, 1:02:17",2013-02-07 04:23:23,2013-02-07 04:23:23,2013-03-02 05:25:40,4594
690,1020,1856,3566,"23 days, 1:04:15",2013-02-07 04:21:25,2013-02-07 04:21:25,2013-03-02 05:25:40,2891
2809,4272,4917,11998,"23 days, 1:04:28",2013-02-07 04:21:12,2013-02-07 04:21:12,2013-03-02 05:25:40,6125
307,2498,3775,6580,"23 days, 1:04:47",2013-02-07 04:20:53,2013-02-07 04:20:53,2013-03-02 05:25:40,8179
2268,6859,5856,14983,"23 days, 1:05:56",2013-02-07 04:19:44,2013-02-07 04:19:44,2013-03-02 05:25:40,5537
446,3076,5532,9054,"23 days, 1:06:33",2013-02-07 04:19:07,2013-02-07 04:19:07,2013-03-02 05:25:40,2116
945,1416,2117,4478,"23 days, 1:06:33",2013-02-07 04:19:07,2013-02-07 04:19:07,2013-03-02 05:25:40,2654
105,5134,6193,11432,"23 days, 1:07:16",2013-02-07 04:18:24,2013-02-07 04:18:24,2013-03-02 05:25:40,4489
582,2264,2710,5556,"23 days, 1:07:38",2013-02-07 04:18:02,2013-02-07 04:18:02,2013-03-02 05:25:40,4723
1098,2268,3079,6445,"23 days, 1:08:43",2013-02-07 04:16:57,2013-02-07 04:16:57,2013-03-02 05:25:40,5135
177,8697,9194,18068,"23 days, 1:08:49",2013-02-07 04:16:51,2013-02-07 04:16:51,2013-03-02 05:25:40,8519
2060,5498,6192,13750,"23 days, 1:10:09",2013-02-07 04:15:31,2013-02-07 04:15:31,2013-03-02 05:25:40,5103
433,1746,2931,5110,"23 days, 1:10:10",2013-02-07 04:15:30,2013-02-07 04:15:30,2013-03-02 05:25:40,7365
319,4010,3191,7520,"23 days, 1:10:19",2013-02-07 04:15:21,2013-02-07 04:15:21,2013-03-02 05:25:40,5692
688,4508,4858,10054,"23 days, 1:10:34",2013-02-07 04:15:06,2013-02-07 04:15:06,2013-03-02 05:25:40,8164
53,314,786,1153,"23 days, 1:10:34",2013-02-07 04:15:06,2013-02-07 04:15:06,2013-03-02 05:25:40,2095
74,6844,7096,14014,"23 days, 1:10:53",2013-02-07 04:14:47,2013-02-07 04:14:47,2013-03-02 05:25:40,8414
330,5796,6436,12562,"23 days, 1:12:16",2013-02-07 04:13:24,2013-02-07 04:13:24,2013-03-02 05:25:40,180
1953,1824,3190,6967,"23 days, 1:12:33",2013-02-07 04:13:07,2013-02-07 04:13:07,2013-03-02 05:25:40,2770
1300,7571,6452,15323,"23 days, 1:12:54",2013-02-07 04:12:46,2013-02-07 04:12:46,2013-03-02 05:25:40,7164
127,7970,8188,16285,"23 days, 1:13:11",2013-02-07 04:12:29,2013-02-07 04:12:29,2013-03-02 05:25:40,3291
594,9380,7553,17527,"23 days, 1:14:17",2013-02-07 04:11:23,2013-02-07 04:11:23,2013-03-02 05:25:40,5138
114,4162,4119,8395,"23 days, 1:14:24",2013-02-07 04:11:16,2013-02-07 04:11:16,2013-03-02 05:25:40,4106
1056,6093,6846,13995,"23 days, 1:14:46",2013-02-07 04:10:54,2013-02-07 04:10:54,2013-03-02 05:25:40,1232
1185,5962,5934,13081,"23 days, 1:16:16",2013-02-07 04:09:24,2013-02-07 04:09:24,2013-03-02 05:25:40,8496
596,421,877,1894,"23 days, 1:16:19",2013-02-08 03:55:13,2010-02-01 10:32:08,2010-02-24 11:48:27,4323
649,4262,3520,8431,"23 days, 1:16:33",2013-02-07 04:09:07,2013-02-07 04:09:07,2013-03-02 05:25:40,9028
382,2129,2822,5333,"23 days, 1:17:35",2013-02-07 04:08:05,2013-02-07 04:08:05,2013-03-02 05:25:40,353
158,2780,4580,7518,"23 days, 1:18:04",2013-02-07 04:07:36,2013-02-07 04:07:36,2013-03-02 05:25:40,6025
496,7609,7767,15872,"23 days, 1:19:39",2013-02-07 04:06:01,2013-02-07 04:06:01,2013-03-02 05:25:40,4848
1319,1742,2672,5733,"23 days, 1:19:41",2013-02-07 04:05:59,2013-02-07 04:05:59,2013-03-02 05:25:40,277
204,6630,6025,12859,"23 days, 1:21:09",2013-02-07 04:04:31,2013-02-07 04:04:31,2013-03-02 05:25:40,8426
251,4675,5055,9981,"23 days, 1:22:47",2013-02-07 04:02:53,2013-02-07 04:02:53,2013-03-02 05:25:40,3855
155,5111,6518,11784,"23 days, 1:23:13",2013-02-07 04:02:27,2013-02-07 04:02:27,2013-03-02 05:25:40,5591
196,6666,5482,12344,"23 days, 1:24:05",2013-02-07 04:01:35,2013-02-07 04:01:35,2013-03-02 05:25:40,4046
205,2274,2465,4944,"23 days, 1:24:41",2013-02-07 04:00:59,2013-02-07 04:00:59,2013-03-02 05:25:40,7208
487,6214,5482,12183,"23 days, 1:24:54",2013-02-07 04:00:46,2013-02-07 04:00:46,2013-03-02 05:25:40,6760
357,4125,5999,10481,"23 days, 1:25:04",2013-02-07 04:00:36,2013-02-07 04:00:36,2013-03-02 05:25:40,1893
1193,5844,5917,12954,"23 days, 1:26:23",2013-02-07 03:59:17,2013-02-07 03:59:17,2013-03-02 05:25:40,2223
2368,7210,6606,16184,"23 days, 1:26:57",2013-02-07 03:58:43,2013-02-07 03:58:43,2013-03-02 05:25:40,4729
259,2058,2798,5115,"23 days, 1:27:25",2013-02-07 03:58:15,2013-02-07 03:58:15,2013-03-02 05:25:40,7785
1662,1174,2528,5364,"23 days, 1:28:43",2013-02-07 03:56:57,2013-02-07 03:56:57,2013-03-02 05:25:40,6763
2025,5631,4516,12172,"23 days, 1:29:42",2013-02-07 03:55:58,2013-02-07 03:55:58,2013-03-02 05:25:40,6640
1058,8400,8663,18121,"23 days, 1:29:51",2013-02-07 03:55:49,2013-02-07 03:55:49,2013-03-02 05:25:40,5212
2155,5931,6146,14232,"23 days, 1:30:24",2013-02-07 03:55:16,2013-02-07 03:55:16,2013-03-02 05:25:40,9515
760,5118,8243,14121,"23 days, 1:30:58",2013-02-07 03:54:42,2013-02-07 03:54:42,2013-03-02 05:25:40,424
1507,5000,6407,12914,"23 days, 1:32:14",2013-02-07 03:53:26,2013-02-07 03:53:26,2013-03-02 05:25:40,3975
902,7622,8131,16655,"23 days, 1:32:57",2013-02-07 03:52:43,2013-02-07 03:52:43,2013-03-02 05:25:40,9476
654,7835,7018,15507,"23 days, 1:35:18",2013-02-07 03:50:22,2013-02-07 03:50:22,2013-03-02 05:25:40,141
16,310,443,769,"23 days, 1:35:52",2013-02-07 03:49:48,2013-02-07 03:49:48,2013-03-02 05:25:40,5607
751,5823,5692,12266,"23 days, 1:35:52",2013-02-07 03:49:48,2013-02-07 03:49:48,2013-03-02 05:25:40,2140
1933,7646,7319,16898,"23 days, 1:36:10",2013-02-07 03:49:30,2013-02-07 03:49:30,2013-03-02 05:25:40,4753
1297,2591,4188,8076,"23 days, 1:37:19",2013-02-07 03:48:21,2013-02-07 03:48:21,2013-03-02 05:25:40,9877
157,2044,3424,5625,"23 days, 1:38:02",2013-02-07 03:47:38,2013-02-07 03:47:38,2013-03-02 05:25:40,525
177,6481,6648,13306,"23 days, 1:39:13",2013-02-07 03:46:27,2013-02-07 03:46:27,2013-03-02 05:25:40,6275
1328,4035,5228,10591,"23 days, 1:39:24",2013-02-07 03:46:16,2013-02-07 03:46:16,2013-03-02 05:25:40,4171
437,2492,4596,7525,"23 days, 1:40:15",2013-02-07 03:45:25,2013-02-07 03:45:25,2013-03-02 05:25:40,1043
190,3085,3186,6461,"23 days, 1:41:17",2013-02-07 03:44:23,2013-02-07 03:44:23,2013-03-02 05:25:40,7335
737,3221,4307,8265,"23 days, 1:46:18",2013-02-07 03:39:22,2013-02-07 03:39:22,2013-03-02 05:25:40,3875
2021,4456,5080,11557,"23 days, 1:48:37",2013-02-07 03:37:03,2013-02-07 03:37:03,2013-03-02 05:25:40,5832
1707,4010,4068,9785,"23 days, 1:48:58",2013-02-07 03:36:42,2013-02-07 03:36:42,2013-03-02 05:25:40,5716
675,1679,2749,5103,"23 days, 1:49:08",2013-02-07 03:36:32,2013-02-07 03:36:32,2013-03-02 05:25:40,4658
959,4035,4657,9651,"23 days, 1:50:46",2013-02-07 03:34:54,2013-02-07 03:34:54,2013-03-02 05:25:40,6751
1449,2228,3059,6736,"23 days, 1:51:08",2013-02-07 03:34:32,2013-02-07 03:34:32,2013-03-02 05:25:40,8460
149,3610,5492,9251,"23 days, 1:51:58",2013-02-07 03:33:42,2013-02-07 03:33:42,2013-03-02 05:25:40,9910
2161,6203,5965,14329,"23 days, 1:53:56",2013-02-07 03:31:44,2013-02-07 03:31:44,2013-03-02 05:25:40,2877
328,2556,3284,6168,"23 days, 1:54:12",2013-02-07 03:31:28,2013-02-07 03:31:28,2013-03-02 05:25:40,1460
1410,592,1466,3468,"23 days, 1:54:20",2013-02-07 03:31:20,2013-02-07 03:31:20,2013-03-02 05:25:40,9146
1499,2831,4131,8461,"23 days, 1:54:23",2013-02-07 03:31:17,2013-02-07 03:31:17,2013-03-02 05:25:40,9635
1531,6642,6242,14415,"23 days, 1:55:39",2013-02-07 03:30:01,2013-02-07 03:30:01,2013-03-02 05:25:40,1391
347,2308,4485,7140,"23 days, 1:56:22",2013-02-07 03:29:18,2013-02-07 03:29:18,2013-03-02 05:25:40,9035
412,2990,3241,6643,"23 days, 1:57:09",2013-02-07 03:28:31,2013-02-07 03:28:31,2013-03-02 05:25:40,3508
614,6136,5047,11797,"23 days, 1:57:51",2013-02-07 03:27:49,2013-02-07 03:27:49,2013-03-02 05:25:40,5150
739,420,621,1780,"23 days, 1:58:55",2013-02-10 11:28:24,2010-04-05 03:43:56,2010-04-28 05:42:51,4935
312,3481,5037,8830,"23 days, 1:59:43",2013-02-07 03:25:57,2013-02-07 03:25:57,2013-03-02 05:25:40,4462
366,4581,4358,9305,"23 days, 2:00:49",2013-02-07 03:24:51,2013-02-07 03:24:51,2013-03-02 05:25:40,1402
761,3559,4954,9274,"23 days, 2:01:17",2013-02-07 03:24:23,2013-02-07 03:24:23,2013-03-02 05:25:40,1926
301,5004,3557,8862,"23 days, 2:02:10",2013-02-07 03:23:30,2013-02-07 03:23:30,2013-03-02 05:25:40,5752
896,6794,5594,13284,"23 days, 2:03:17",2013-02-07 03:22:23,2013-02-07 03:22:23,2013-03-02 05:25:40,6646
76,5557,4724,10357,"23 days, 2:04:54",2013-02-07 03:20:46,2013-02-07 03:20:46,2013-03-02 05:25:40,1480
6,5220,7213,12439,"23 days, 2:06:44",2013-02-07 03:18:56,2013-02-07 03:18:56,2013-03-02 05:25:40,7402
875,5304,5590,11769,"23 days, 2:06:47",2013-02-07 03:18:53,2013-02-07 03:18:53,2013-03-02 05:25:40,5704
1303,5123,5012,11438,"23 days, 2:07:19",2013-02-07 03:18:21,2013-02-07 03:18:21,2013-03-02 05:25:40,1774
139,10212,6609,16960,"23 days, 2:07:38",2013-02-07 03:18:02,2013-02-07 03:18:02,2013-03-02 05:25:40,2594
935,1386,4592,6913,"23 days, 2:08:31",2013-02-07 03:17:09,2013-02-07 03:17:09,2013-03-02 05:25:40,4401
1395,1209,2349,4953,"23 days, 2:09:21",2013-02-07 03:16:19,2013-02-07 03:16:19,2013-03-02 05:25:40,421
1031,3468,4547,9046,"23 days, 2:09:31",2013-02-07 03:16:09,2013-02-07 03:16:09,2013-03-02 05:25:40,7332
1415,1641,2323,5379,"23 days, 2:09:50",2013-02-07 03:15:50,2013-02-07 03:15:50,2013-03-02 05:25:40,4492
956,10747,8683,20386,"23 days, 2:11:19",2013-02-07 03:14:21,2013-02-07 03:14:21,2013-03-02 05:25:40,9221
1328,4281,6717,12326,"23 days, 2:11:25",2013-02-07 03:14:15,2013-02-07 03:14:15,2013-03-02 05:25:40,7625
1423,8589,6873,16885,"23 days, 2:12:35",2013-02-07 03:13:05,2013-02-07 03:13:05,2013-03-02 05:25:40,510
70,4708,5961,10739,"23 days, 2:12:47",2013-02-07 03:12:53,2013-02-07 03:12:53,2013-03-02 05:25:40,6477
1148,707,2169,4024,"23 days, 2:13:38",2013-02-07 03:12:02,2013-02-07 03:12:02,2013-03-02 05:25:40,4654
31,5551,5271,10853,"23 days, 2:14:14",2013-02-07 03:11:26,2013-02-07 03:11:26,2013-03-02 05:25:40,2007
320,4808,6864,11992,"23 days, 2:14:14",2013-02-07 03:11:26,2013-02-07 03:11:26,2013-03-02 05:25:40,3294
1253,818,1407,3478,"23 days, 2:15:01",2013-02-07 03:10:39,2013-02-07 03:10:39,2013-03-02 05:25:40,3661
729,7047,8139,15915,"23 days, 2:15:05",2013-02-07 03:10:35,2013-02-07 03:10:35,2013-03-02 05:25:40,9939
710,2828,3605,7143,"23 days, 2:16:23",2013-02-07 03:09:17,2013-02-07 03:09:17,2013-03-02 05:25:40,4893
208,2771,3375,6354,"23 days, 2:17:10",2013-02-07 03:08:30,2013-02-07 03:08:30,2013-03-02 05:25:40,8982
378,1165,2601,4144,"23 days, 2:17:36",2013-02-07 03:08:04,2013-02-07 03:08:04,2013-03-02 05:25:40,3646
746,1765,2668,5179,"23 days, 2:18:02",2013-02-07 03:07:38,2013-02-07 03:07:38,2013-03-02 05:25:40,9389
529,8227,7609,16365,"23 days, 2:18:31",2013-02-07 03:07:09,2013-02-07 03:07:09,2013-03-02 05:25:40,7475
1119,3248,6294,10661,"23 days, 2:19:56",2013-02-07 03:05:44,2013-02-07 03:05:44,2013-03-02 05:25:40,8196
1424,4908,7018,13350,"23 days, 2:20:05",2013-02-07 03:05:35,2013-02-07 03:05:35,2013-03-02 05:25:40,6639
94,651,911,1656,"23 days, 2:21:00",2013-02-07 03:04:40,2013-02-07 03:04:40,2013-03-02 05:25:40,569
1101,4916,5871,11888,"23 days, 2:21:16",2013-02-07 03:04:24,2013-02-07 03:04:24,2013-03-02 05:25:40,692
70,3716,4411,8197,"23 days, 2:21:55",2013-02-07 03:03:45,2013-02-07 03:03:45,2013-03-02 05:25:40,7654
1491,1249,2485,5225,"23 days, 2:22:14",2013-02-07 03:03:26,2013-02-07 03:03:26,2013-03-02 05:25:40,1615
642,3172,3301,7115,"23 days, 2:22:46",2013-02-07 03:02:54,2013-02-07 03:02:54,2013-03-02 05:25:40,5075
1769,7722,6814,16305,"23 days, 2:23:20",2013-02-07 03:02:20,2013-02-07 03:02:20,2013-03-02 05:25:40,8380
475,5515,6425,12415,"23 days, 2:23:25",2013-02-07 03:02:15,2013-02-07 03:02:15,2013-03-02 05:25:40,8583
451,3226,3453,7130,"23 days, 2:23:51",2013-02-07 03:01:49,2013-02-07 03:01:49,2013-03-02 05:25:40,2042
1584,5212,5700,12496,"23 days, 2:24:22",2013-02-07 03:01:18,2013-02-07 03:01:18,2013-03-02 05:25:40,1438
117,5560,5543,11220,"23 days, 2:24:46",2013-02-07 03:00:54,2013-02-07 03:00:54,2013-03-02 05:25:40,793
44,4564,5139,9747,"23 days, 2:25:05",2013-02-07 03:00:35,2013-02-07 03:00:35,2013-03-02 05:25:40,3194
701,6463,7125,14289,"23 days, 2:27:01",2013-02-07 02:58:39,2013-02-07 02:58:39,2013-03-02 05:25:40,9536
1028,6686,7396,15110,"23 days, 2:27:04",2013-02-07 02:58:36,2013-02-07 02:58:36,2013-03-02 05:25:40,6520
1637,2109,3395,7141,"23 days, 2:27:07",2013-02-07 02:58:33,2013-02-07 02:58:33,2013-03-02 05:25:40,2102
199,6581,8317,15097,"23 days, 2:27:12",2013-02-20 00:42:09,2010-02-08 05:14:44,2010-03-03 07:41:56,2964
135,2189,3870,6194,"23 days, 2:27:22",2013-02-07 02:58:18,2013-02-07 02:58:18,2013-03-02 05:25:40,4963
650,3571,6005,10226,"23 days, 2:27:59",2013-02-07 02:57:41,2013-02-07 02:57:41,2013-03-02 05:25:40,4192
950,2939,3315,7204,"23 days, 2:28:13",2013-02-07 02:57:27,2013-02-07 02:57:27,2013-03-02 05:25:40,6777
110,1668,2420,4198,"23 days, 2:28:23",2013-02-07 02:57:17,2013-02-07 02:57:17,2013-03-02 05:25:40,5017
904,2557,3322,6783,"23 days, 2:28:33",2013-02-07 02:57:07,2013-02-07 02:57:07,2013-03-02 05:25:40,6047
1408,5655,8432,15495,"23 days, 2:28:50",2013-02-07 02:56:50,2013-02-07 02:56:50,2013-03-02 05:25:40,9310
1252,3500,5087,9839,"23 days, 2:29:15",2013-02-07 02:56:25,2013-02-07 02:56:25,2013-03-02 05:25:40,895
399,3352,4184,7935,"23 days, 2:30:21",2013-02-07 02:55:19,2013-02-07 02:55:19,2013-03-02 05:25:40,5368
1233,6586,9259,17078,"23 days, 2:30:28",2013-02-07 02:55:12,2013-02-07 02:55:12,2013-03-02 05:25:40,7597
2107,1591,2378,6076,"23 days, 2:31:10",2013-02-07 02:54:30,2013-02-07 02:54:30,2013-03-02 05:25:40,2384
171,7318,5526,13015,"23 days, 2:31:48",2013-02-07 02:53:52,2013-02-07 02:53:52,2013-03-02 05:25:40,4598
72,3224,4479,7775,"23 days, 2:33:56",2013-02-07 02:51:44,2013-02-07 02:51:44,2013-03-02 05:25:40,5097
1059,5840,6999,13898,"23 days, 2:34:18",2013-02-07 02:51:22,2013-02-07 02:51:22,2013-03-02 05:25:40,5289
757,9079,6483,16319,"23 days, 2:35:42",2013-02-07 02:49:58,2013-02-07 02:49:58,2013-03-02 05:25:40,6621
1354,5285,5540,12179,"23 days, 2:36:52",2013-02-07 02:48:48,2013-02-07 02:48:48,2013-03-02 05:25:40,7148
1745,8263,7191,17199,"23 days, 2:38:09",2013-02-07 02:47:31,2013-02-07 02:47:31,2013-03-02 05:25:40,3708
290,2187,4022,6499,"23 days, 2:39:44",2013-02-07 02:45:56,2013-02-07 02:45:56,2013-03-02 05:25:40,7111
912,3455,3605,7972,"23 days, 2:40:47",2013-02-07 02:44:53,2013-02-07 02:44:53,2013-03-02 05:25:40,5246
103,3120,3974,7197,"23 days, 2:40:57",2013-02-07 02:44:43,2013-02-07 02:44:43,2013-03-02 05:25:40,4339
132,1636,1718,3486,"23 days, 2:41:21",2013-02-07 02:44:19,2013-02-07 02:44:19,2013-03-02 05:25:40,5254
2145,9773,7986,19904,"23 days, 2:42:07",2013-02-07 02:43:33,2013-02-07 02:43:33,2013-03-02 05:25:40,5183
526,2172,3774,6472,"23 days, 2:42:43",2013-02-07 02:42:57,2013-02-07 02:42:57,2013-03-02 05:25:40,2139
54,5394,5896,11344,"23 days, 2:43:09",2013-02-07 02:42:31,2013-02-07 02:42:31,2013-03-02 05:25:40,7756
901,1701,3094,5696,"23 days, 2:43:17",2013-02-07 02:42:23,2013-02-07 02:42:23,2013-03-02 05:25:40,6392
436,1215,2098,3749,"23 days, 2:44:05",2013-02-07 02:41:35,2013-02-07 02:41:35,2013-03-02 05:25:40,7268
145,987,1273,2405,"23 days, 2:44:14",2013-02-07 02:41:26,2013-02-07 02:41:26,2013-03-02 05:25:40,3850
610,3282,4055,7947,"23 days, 2:44:48",2013-02-07 02:40:52,2013-02-07 02:40:52,2013-03-02 05:25:40,3571
591,2019,3194,5804,"23 days, 2:46:43",2013-02-07 02:38:57,2013-02-07 02:38:57,2013-03-02 05:25:40,4937
261,5073,6515,11849,"23 days, 2:47:32",2013-02-07 02:38:08,2013-02-07 02:38:08,2013-03-02 05:25:40,1403
520,5638,7755,13913,"23 days, 2:48:06",2013-02-07 02:37:34,2013-02-07 02:37:34,2013-03-02 05:25:40,4402
57,3807,3308,7172,"23 days, 2:48:31",2013-02-07 02:37:09,2013-02-07 02:37:09,2013-03-02 05:25:40,6976
1112,7059,7117,15288,"23 days, 2:49:30",2013-02-07 02:36:10,2013-02-07 02:36:10,2013-03-02 05:25:40,9426
76,6708,7662,14446,"23 days, 2:49:34",2013-02-07 02:36:06,2013-02-07 02:36:06,2013-03-02 05:25:40,109
165,8627,7920,16712,"23 days, 2:49:58",2013-02-07 02:35:42,2013-02-07 02:35:42,2013-03-02 05:25:40,6904
1130,3658,6918,11706,"23 days, 2:50:37",2013-02-07 02:35:03,2013-02-07 02:35:03,2013-03-02 05:25:40,3496
749,5352,8464,14565,"23 days, 2:50:47",2013-02-07 02:34:53,2013-02-07 02:34:53,2013-03-02 05:25:40,162
153,2871,3663,6687,"23 days, 2:52:33",2013-02-07 02:33:07,2013-02-07 02:33:07,2013-03-02 05:25:40,5241
261,5043,4372,9676,"23 days, 2:52:46",2013-02-07 02:32:54,2013-02-07 02:32:54,2013-03-02 05:25:40,8813
1408,5381,5650,12439,"23 days, 2:52:56",2013-02-07 02:32:44,2013-02-07 02:32:44,2013-03-02 05:25:40,6901
522,331,512,1365,"23 days, 2:53:06",2013-02-07 02:32:34,2013-02-07 02:32:34,2013-03-02 05:25:40,3548
617,8794,8270,17681,"23 days, 2:53:11",2013-02-07 02:32:29,2013-02-07 02:32:29,2013-03-02 05:25:40,5169
1224,617,970,2811,"23 days, 2:56:08",2013-02-07 02:29:32,2013-02-07 02:29:32,2013-03-02 05:25:40,9494
333,1802,2595,4730,"23 days, 2:56:27",2013-02-07 02:29:13,2013-02-07 02:29:13,2013-03-02 05:25:40,5976
200,2251,4469,6920,"23 days, 2:58:08",2013-02-07 02:27:32,2013-02-07 02:27:32,2013-03-02 05:25:40,4832
999,8126,7836,16961,"23 days, 2:59:52",2013-02-07 02:25:48,2013-02-07 02:25:48,2013-03-02 05:25:40,9554
1068,444,1237,2749,"23 days, 3:00:17",2013-02-07 02:25:23,2013-02-07 02:25:23,2013-03-02 05:25:40,1940
2590,2936,3444,8970,"23 days, 3:01:36",2013-02-07 02:24:04,2013-02-07 02:24:04,2013-03-02 05:25:40,1594
875,851,1013,2739,"23 days, 3:01:52",2013-02-07 02:23:48,2013-02-07 02:23:48,2013-03-02 05:25:40,1518
1489,7562,6147,15198,"23 days, 3:02:39",2013-02-07 02:23:01,2013-02-07 02:23:01,2013-03-02 05:25:40,8728
444,6909,6694,14047,"23 days, 3:02:55",2013-02-07 02:22:45,2013-02-07 02:22:45,2013-03-02 05:25:40,5009
307,3371,3611,7289,"23 days, 3:03:19",2013-02-07 02:22:21,2013-02-07 02:22:21,2013-03-02 05:25:40,9288
3278,5074,5846,14198,"23 days, 3:03:20",2013-02-07 02:22:20,2013-02-07 02:22:20,2013-03-02 05:25:40,3976
197,6171,7193,13561,"23 days, 3:04:26",2013-02-07 02:21:14,2013-02-07 02:21:14,2013-03-02 05:25:40,5460
633,2978,3787,7398,"23 days, 3:04:45",2013-02-07 02:20:55,2013-02-07 02:20:55,2013-03-02 05:25:40,6997
129,6496,7226,13851,"23 days, 3:05:01",2013-02-07 02:20:39,2013-02-07 02:20:39,2013-03-02 05:25:40,1174
38,2229,2543,4810,"23 days, 3:05:04",2013-02-07 02:20:36,2013-02-07 02:20:36,2013-03-02 05:25:40,5372
10,1497,2937,4444,"23 days, 3:05:16",2013-02-07 02:20:24,2013-02-07 02:20:24,2013-03-02 05:25:40,5795
816,6452,6366,13634,"23 days, 3:05:36",2013-02-07 02:20:04,2013-02-07 02:20:04,2013-03-02 05:25:40,7356
1049,3013,3459,7521,"23 days, 3:05:41",2013-02-07 02:19:59,2013-02-07 02:19:59,2013-03-02 05:25:40,5890
1312,990,2723,5025,"23 days, 3:06:01",2013-02-07 02:19:39,2013-02-07 02:19:39,2013-03-02 05:25:40,1672
67,1661,3091,4819,"23 days, 3:06:33",2013-02-07 02:19:07,2013-02-07 02:19:07,2013-03-02 05:25:40,157
2131,6317,7142,15590,"23 days, 3:07:00",2013-02-07 02:18:40,2013-02-07 02:18:40,2013-03-02 05:25:40,5215
1918,3957,5320,11195,"23 days, 3:07:02",2013-02-07 02:18:38,2013-02-07 02:18:38,2013-03-02 05:25:40,1773
1281,996,1660,3937,"23 days, 3:09:33",2013-02-07 02:16:07,2013-02-07 02:16:07,2013-03-02 05:25:40,6668
2538,4717,6348,13603,"23 days, 3:10:05",2013-02-07 02:15:35,2013-02-07 02:15:35,2013-03-02 05:25:40,8345
534,8358,9417,18309,"23 days, 3:10:11",2013-02-07 02:15:29,2013-02-07 02:15:29,2013-03-02 05:25:40,8575
400,5623,4924,10947,"23 days, 3:10:54",2013-02-07 02:14:46,2013-02-07 02:14:46,2013-03-02 05:25:40,3594
1087,5325,4725,11137,"23 days, 3:11:19",2013-02-07 02:14:21,2013-02-07 02:14:21,2013-03-02 05:25:40,9562
393,6318,8421,15132,"23 days, 3:11:39",2013-02-07 02:14:01,2013-02-07 02:14:01,2013-03-02 05:25:40,6083
115,1257,2516,3888,"23 days, 3:12:12",2013-02-07 02:13:28,2013-02-07 02:13:28,2013-03-02 05:25:40,3309
2366,3237,3392,8995,"23 days, 3:12:34",2013-02-07 02:13:06,2013-02-07 02:13:06,2013-03-02 05:25:40,1669
220,1288,1813,3321,"23 days, 3:13:35",2013-02-07 02:12:05,2013-02-07 02:12:05,2013-03-02 05:25:40,251
1575,5480,7461,14516,"23 days, 3:13:51",2013-02-07 02:11:49,2013-02-07 02:11:49,2013-03-02 05:25:40,9556
504,3415,4195,8114,"23 days, 3:14:28",2013-02-07 02:11:12,2013-02-07 02:11:12,2013-03-02 05:25:40,2537
1137,655,1082,2874,"23 days, 3:15:29",2013-02-07 02:10:11,2013-02-07 02:10:11,2013-03-02 05:25:40,7157
430,3917,5733,10080,"23 days, 3:16:05",2013-02-07 02:09:35,2013-02-07 02:09:35,2013-03-02 05:25:40,7110
714,2060,2484,5258,"23 days, 3:17:12",2013-02-07 02:08:28,2013-02-07 02:08:28,2013-03-02 05:25:40,5245
617,5703,5028,11348,"23 days, 3:19:25",2013-02-07 02:06:15,2013-02-07 02:06:15,2013-03-02 05:25:40,660
314,6051,7177,13542,"23 days, 3:21:00",2013-02-07 02:04:40,2013-02-07 02:04:40,2013-03-02 05:25:40,8799
7,2940,4184,7131,"23 days, 3:21:17",2013-02-07 02:04:23,2013-02-07 02:04:23,2013-03-02 05:25:40,9563
53,1671,2719,4443,"23 days, 3:21:37",2013-02-07 02:04:03,2013-02-07 02:04:03,2013-03-02 05:25:40,1244
1375,2889,3996,8260,"23 days, 3:23:16",2013-02-07 02:02:24,2013-02-07 02:02:24,2013-03-02 05:25:40,6816
2128,3794,4837,10759,"23 days, 3:23:21",2013-02-07 02:02:19,2013-02-07 02:02:19,2013-03-02 05:25:40,407
89,8662,7584,16335,"23 days, 3:23:49",2013-02-07 02:01:51,2013-02-07 02:01:51,2013-03-02 05:25:40,8107
481,5890,6039,12410,"23 days, 3:23:57",2013-02-07 02:01:43,2013-02-07 02:01:43,2013-03-02 05:25:40,2669
259,1395,2322,3976,"23 days, 3:24:23",2013-02-07 02:01:17,2013-02-07 02:01:17,2013-03-02 05:25:40,7392
832,5452,5645,11929,"23 days, 3:25:46",2013-02-07 01:59:54,2013-02-07 01:59:54,2013-03-02 05:25:40,9869
2685,6592,6379,15656,"23 days, 3:25:58",2013-02-07 01:59:42,2013-02-07 01:59:42,2013-03-02 05:25:40,2079
1481,3871,3527,8879,"23 days, 3:26:40",2013-02-07 01:59:00,2013-02-07 01:59:00,2013-03-02 05:25:40,5856
367,2542,3831,6740,"23 days, 3:26:44",2013-02-07 01:58:56,2013-02-07 01:58:56,2013-03-02 05:25:40,8341
140,5402,6486,12028,"23 days, 3:26:45",2013-02-07 01:58:55,2013-02-07 01:58:55,2013-03-02 05:25:40,194
1406,4761,8271,14438,"23 days, 3:28:24",2013-02-07 01:57:16,2013-02-07 01:57:16,2013-03-02 05:25:40,565
679,6185,6532,13396,"23 days, 3:30:21",2013-02-07 01:55:19,2013-02-07 01:55:19,2013-03-02 05:25:40,8396
1164,4513,5726,11403,"23 days, 3:31:05",2013-02-07 01:54:35,2013-02-07 01:54:35,2013-03-02 05:25:40,6925
8,909,1610,2527,"23 days, 3:32:04",2013-02-07 01:53:36,2013-02-07 01:53:36,2013-03-02 05:25:40,4206
39,278,720,1037,"23 days, 3:32:29",2013-02-07 01:53:11,2013-02-07 01:53:11,2013-03-02 05:25:40,9761
641,4869,6848,12358,"23 days, 3:32:30",2013-02-07 01:53:10,2013-02-07 01:53:10,2013-03-02 05:25:40,5911
460,3821,3535,7816,"23 days, 3:32:41",2013-02-07 01:52:59,2013-02-07 01:52:59,2013-03-02 05:25:40,9782
568,4200,4944,9712,"23 days, 3:32:47",2013-02-07 01:52:53,2013-02-07 01:52:53,2013-03-02 05:25:40,7939
582,3595,3369,7546,"23 days, 3:32:52",2013-02-07 01:52:48,2013-02-07 01:52:48,2013-03-02 05:25:40,9870
243,1846,2174,4263,"23 days, 3:33:25",2013-02-07 01:52:15,2013-02-07 01:52:15,2013-03-02 05:25:40,958
189,1566,2636,4391,"23 days, 3:33:41",2013-02-07 01:51:59,2013-02-07 01:51:59,2013-03-02 05:25:40,8774
952,2026,4896,7874,"23 days, 3:35:58",2013-02-07 01:49:42,2013-02-07 01:49:42,2013-03-02 05:25:40,7577
200,2808,3355,6363,"23 days, 3:36:19",2013-02-07 01:49:21,2013-02-07 01:49:21,2013-03-02 05:25:40,7178
236,8027,6843,15106,"23 days, 3:36:48",2013-02-07 01:48:52,2013-02-07 01:48:52,2013-03-02 05:25:40,3498
1096,4569,5876,11541,"23 days, 3:36:57",2013-02-07 01:48:43,2013-02-07 01:48:43,2013-03-02 05:25:40,260
1446,6686,7175,15307,"23 days, 3:37:14",2013-02-07 01:48:26,2013-02-07 01:48:26,2013-03-02 05:25:40,7382
118,8999,7813,16930,"23 days, 3:37:36",2013-02-07 01:48:04,2013-02-07 01:48:04,2013-03-02 05:25:40,1387
1856,5544,6840,14240,"23 days, 3:38:47",2013-02-07 01:46:53,2013-02-07 01:46:53,2013-03-02 05:25:40,922
751,2955,3858,7564,"23 days, 3:39:10",2013-02-07 01:46:30,2013-02-07 01:46:30,2013-03-02 05:25:40,4352
380,5394,5304,11078,"23 days, 3:39:48",2013-02-07 01:45:52,2013-02-07 01:45:52,2013-03-02 05:25:40,6368
1413,9035,8259,18707,"23 days, 3:39:57",2013-02-07 01:45:43,2013-02-07 01:45:43,2013-03-02 05:25:40,165
2173,5802,5765,13740,"23 days, 3:40:19",2013-02-07 01:45:21,2013-02-07 01:45:21,2013-03-02 05:25:40,3244
255,5663,6650,12568,"23 days, 3:40:35",2013-02-07 01:45:05,2013-02-07 01:45:05,2013-03-02 05:25:40,3041
348,3519,4362,8229,"23 days, 3:43:41",2013-02-07 01:41:59,2013-02-07 01:41:59,2013-03-02 05:25:40,2618
2087,7864,5181,15132,"23 days, 3:43:51",2013-02-07 01:41:49,2013-02-07 01:41:49,2013-03-02 05:25:40,338
123,1683,2617,4423,"23 days, 3:44:30",2013-02-07 01:41:10,2013-02-07 01:41:10,2013-03-02 05:25:40,295
316,7951,6309,14576,"23 days, 3:44:33",2013-02-07 01:41:07,2013-02-07 01:41:07,2013-03-02 05:25:40,4876
724,1685,2115,4524,"23 days, 3:45:26",2013-02-07 01:40:14,2013-02-07 01:40:14,2013-03-02 05:25:40,8506
221,6173,6541,12935,"23 days, 3:46:02",2013-02-07 01:39:38,2013-02-07 01:39:38,2013-03-02 05:25:40,7409
82,4683,5214,9979,"23 days, 3:47:22",2013-02-07 01:38:18,2013-02-07 01:38:18,2013-03-02 05:25:40,2030
1190,6490,7268,14948,"23 days, 3:47:47",2013-02-07 01:37:53,2013-02-07 01:37:53,2013-03-02 05:25:40,4115
15,4552,3306,7873,"23 days, 3:47:48",2013-02-07 01:37:52,2013-02-07 01:37:52,2013-03-02 05:25:40,8161
1434,1063,1660,4157,"23 days, 3:48:25",2013-02-07 01:37:15,2013-02-07 01:37:15,2013-03-02 05:25:40,5247
1351,3501,3193,8045,"23 days, 3:49:05",2013-02-07 01:36:35,2013-02-07 01:36:35,2013-03-02 05:25:40,9829
955,2737,2083,5775,"23 days, 3:50:27",2013-02-07 01:35:13,2013-02-07 01:35:13,2013-03-02 05:25:40,8128
1040,3692,5489,10221,"23 days, 3:50:34",2013-02-07 01:35:06,2013-02-07 01:35:06,2013-03-02 05:25:40,8198
1288,4186,6502,11976,"23 days, 3:50:56",2013-02-07 01:34:44,2013-02-07 01:34:44,2013-03-02 05:25:40,9246
1545,4411,4748,10704,"23 days, 3:51:12",2013-02-07 01:34:28,2013-02-07 01:34:28,2013-03-02 05:25:40,3034
1062,3167,4409,8638,"23 days, 3:51:55",2013-02-07 01:33:45,2013-02-07 01:33:45,2013-03-02 05:25:40,5502
587,1836,3153,5576,"23 days, 3:52:18",2013-02-07 01:33:22,2013-02-07 01:33:22,2013-03-02 05:25:40,6964
875,7505,6528,14908,"23 days, 3:53:07",2013-02-07 08:06:08,2010-02-19 04:54:14,2010-03-14 08:47:21,8881
1064,9033,8053,18150,"23 days, 3:53:10",2013-02-07 01:32:30,2013-02-07 01:32:30,2013-03-02 05:25:40,6332
315,5219,6186,11720,"23 days, 3:55:44",2013-02-07 01:29:56,2013-02-07 01:29:56,2013-03-02 05:25:40,1911
1053,9430,9290,19773,"23 days, 3:55:55",2013-02-07 01:29:45,2013-02-07 01:29:45,2013-03-02 05:25:40,5631
828,3438,4880,9146,"23 days, 3:56:04",2013-02-07 01:29:36,2013-02-07 01:29:36,2013-03-02 05:25:40,6618
914,3914,4349,9177,"23 days, 3:56:06",2013-02-07 01:29:34,2013-02-07 01:29:34,2013-03-02 05:25:40,4131
786,3406,3727,7919,"23 days, 3:56:21",2013-02-07 01:29:19,2013-02-07 01:29:19,2013-03-02 05:25:40,7961
1620,8547,6697,16864,"23 days, 3:56:27",2013-02-07 01:29:13,2013-02-07 01:29:13,2013-03-02 05:25:40,4879
388,1965,3006,5359,"23 days, 3:56:44",2013-02-07 01:28:56,2013-02-07 01:28:56,2013-03-02 05:25:40,6825
1384,2477,4114,7975,"23 days, 3:56:49",2013-02-07 01:28:51,2013-02-07 01:28:51,2013-03-02 05:25:40,9278
1405,3792,9083,14280,"23 days, 3:57:04",2013-02-07 01:28:36,2013-02-07 01:28:36,2013-03-02 05:25:40,4476
455,1234,1591,3280,"23 days, 3:58:33",2013-02-07 01:27:07,2013-02-07 01:27:07,2013-03-02 05:25:40,5519
253,6957,6418,13628,"23 days, 3:59:10",2013-02-07 01:26:30,2013-02-07 01:26:30,2013-03-02 05:25:40,7686
1933,2233,3875,8041,"23 days, 4:01:00",2013-02-07 01:24:40,2013-02-07 01:24:40,2013-03-02 05:25:40,181
383,4752,7779,12914,"23 days, 4:01:33",2013-02-07 01:24:07,2013-02-07 01:24:07,2013-03-02 05:25:40,4665
1212,2845,4247,8304,"23 days, 4:03:00",2013-02-07 01:22:40,2013-02-07 01:22:40,2013-03-02 05:25:40,4139
3071,4131,4884,12086,"23 days, 4:04:42",2013-02-07 01:20:58,2013-02-07 01:20:58,2013-03-02 05:25:40,3773
1147,1239,2128,4514,"23 days, 4:04:44",2013-02-07 01:20:56,2013-02-07 01:20:56,2013-03-02 05:25:40,37
43,926,1761,2730,"23 days, 4:04:45",2013-02-07 01:20:55,2013-02-07 01:20:55,2013-03-02 05:25:40,2720
448,2407,4098,6953,"23 days, 4:05:14",2013-02-07 01:20:26,2013-02-07 01:20:26,2013-03-02 05:25:40,2094
1736,5982,6333,14051,"23 days, 4:05:41",2013-02-07 01:19:59,2013-02-07 01:19:59,2013-03-02 05:25:40,3577
59,2104,3746,5909,"23 days, 4:06:51",2013-02-07 01:18:49,2013-02-07 01:18:49,2013-03-02 05:25:40,3168
146,7097,9291,16534,"23 days, 4:09:52",2013-02-07 01:15:48,2013-02-07 01:15:48,2013-03-02 05:25:40,5099
558,1041,3174,4773,"23 days, 4:10:11",2013-02-07 01:15:29,2013-02-07 01:15:29,2013-03-02 05:25:40,5949
87,1891,2048,4026,"23 days, 4:10:16",2013-02-07 01:15:24,2013-02-07 01:15:24,2013-03-02 05:25:40,2243
3239,7132,5681,16052,"23 days, 4:11:02",2013-02-07 01:14:38,2013-02-07 01:14:38,2013-03-02 05:25:40,1664
910,9397,8676,18983,"23 days, 4:11:25",2013-02-07 01:14:15,2013-02-07 01:14:15,2013-03-02 05:25:40,8902
3761,6120,7418,17299,"23 days, 4:11:35",2013-02-07 01:14:05,2013-02-07 01:14:05,2013-03-02 05:25:40,5487
1306,947,1717,3970,"23 days, 4:12:39",2013-02-07 01:13:01,2013-02-07 01:13:01,2013-03-02 05:25:40,4657
66,4088,3688,7842,"23 days, 4:12:55",2013-02-07 01:12:45,2013-02-07 01:12:45,2013-03-02 05:25:40,1921
1852,2620,4874,9346,"23 days, 4:13:53",2013-02-07 01:11:47,2013-02-07 01:11:47,2013-03-02 05:25:40,4905
1214,4792,7330,13336,"23 days, 4:13:54",2013-02-07 01:11:46,2013-02-07 01:11:46,2013-03-02 05:25:40,3784
583,4440,3995,9018,"23 days, 4:14:01",2013-02-07 01:11:39,2013-02-07 01:11:39,2013-03-02 05:25:40,6923
765,1998,3465,6228,"23 days, 4:14:28",2013-02-07 01:11:12,2013-02-07 01:11:12,2013-03-02 05:25:40,2695
1482,4573,5270,11325,"23 days, 4:15:30",2013-02-07 01:10:10,2013-02-07 01:10:10,2013-03-02 05:25:40,4641
634,613,1055,2302,"23 days, 4:15:59",2013-02-07 01:09:41,2013-02-07 01:09:41,2013-03-02 05:25:40,4984
68,7810,7485,15363,"23 days, 4:16:54",2013-02-07 01:08:46,2013-02-07 01:08:46,2013-03-02 05:25:40,3816
135,3724,3432,7291,"23 days, 4:17:52",2013-02-07 01:07:48,2013-02-07 01:07:48,2013-03-02 05:25:40,3842
982,4236,7423,12641,"23 days, 4:18:49",2013-02-07 01:06:51,2013-02-07 01:06:51,2013-03-02 05:25:40,6617
1276,6277,8163,15716,"23 days, 4:19:09",2013-02-07 01:06:31,2013-02-07 01:06:31,2013-03-02 05:25:40,6190
139,3511,4009,7659,"23 days, 4:19:37",2013-02-07 01:06:03,2013-02-07 01:06:03,2013-03-02 05:25:40,7457
302,895,1799,2996,"23 days, 4:22:04",2013-02-07 01:03:36,2013-02-07 01:03:36,2013-03-02 05:25:40,4557
85,7837,6107,14029,"23 days, 4:22:31",2013-02-07 01:03:09,2013-02-07 01:03:09,2013-03-02 05:25:40,7802
128,4945,5017,10090,"23 days, 4:22:51",2013-02-07 01:02:49,2013-02-07 01:02:49,2013-03-02 05:25:40,4979
634,4656,5845,11135,"23 days, 4:23:08",2013-02-07 01:02:32,2013-02-07 01:02:32,2013-03-02 05:25:40,8551
1227,2493,2930,6650,"23 days, 4:23:28",2013-02-07 01:02:12,2013-02-07 01:02:12,2013-03-02 05:25:40,6754
20,904,1307,2231,"23 days, 4:24:51",2013-02-07 01:00:49,2013-02-07 01:00:49,2013-03-02 05:25:40,2625
36,4493,6471,11000,"23 days, 4:25:10",2013-02-07 01:00:30,2013-02-07 01:00:30,2013-03-02 05:25:40,4671
449,1698,2138,4285,"23 days, 4:26:04",2013-02-07 00:59:36,2013-02-07 00:59:36,2013-03-02 05:25:40,9734
595,6063,5146,11804,"23 days, 4:26:40",2013-02-07 00:59:00,2013-02-07 00:59:00,2013-03-02 05:25:40,7466
375,2804,4840,8019,"23 days, 4:26:47",2013-02-07 00:58:53,2013-02-07 00:58:53,2013-03-02 05:25:40,4274
696,5114,5856,11666,"23 days, 4:26:52",2013-02-07 00:58:48,2013-02-07 00:58:48,2013-03-02 05:25:40,8590
1823,6905,5989,14717,"23 days, 4:27:25",2013-02-07 00:58:15,2013-02-07 00:58:15,2013-03-02 05:25:40,4833
2353,7933,7501,17787,"23 days, 4:27:52",2013-02-07 00:57:48,2013-02-07 00:57:48,2013-03-02 05:25:40,8562
956,6612,5516,13084,"23 days, 4:28:44",2013-02-07 00:56:56,2013-02-07 00:56:56,2013-03-02 05:25:40,1869
299,1296,1999,3594,"23 days, 4:28:44",2013-02-07 00:56:56,2013-02-07 00:56:56,2013-03-02 05:25:40,4781
2312,7279,6255,15846,"23 days, 4:29:56",2013-02-07 00:55:44,2013-02-07 00:55:44,2013-03-02 05:25:40,3524
589,6686,5341,12616,"23 days, 4:30:48",2013-02-07 00:54:52,2013-02-07 00:54:52,2013-03-02 05:25:40,4800
1111,2632,2912,6655,"23 days, 4:31:16",2013-02-07 00:54:24,2013-02-07 00:54:24,2013-03-02 05:25:40,5778
511,333,379,1223,"23 days, 4:31:40",2013-02-07 00:54:00,2013-02-07 00:54:00,2013-03-02 05:25:40,5107
1349,3085,4478,8912,"23 days, 4:32:05",2013-02-07 00:53:35,2013-02-07 00:53:35,2013-03-02 05:25:40,6407
760,4434,4728,9922,"23 days, 4:35:07",2013-02-07 00:50:33,2013-02-07 00:50:33,2013-03-02 05:25:40,5449
176,1546,4489,6211,"23 days, 4:35:49",2013-02-07 00:49:51,2013-02-07 00:49:51,2013-03-02 05:25:40,875
935,1166,1734,3835,"23 days, 4:36:52",2013-02-07 00:48:48,2013-02-07 00:48:48,2013-03-02 05:25:40,9953
447,2893,3687,7027,"23 days, 4:36:56",2013-02-07 00:48:44,2013-02-07 00:48:44,2013-03-02 05:25:40,4284
284,7298,6303,13885,"23 days, 4:37:51",2013-02-07 00:47:49,2013-02-07 00:47:49,2013-03-02 05:25:40,107
1377,5755,4880,12012,"23 days, 4:38:33",2013-02-07 00:47:07,2013-02-07 00:47:07,2013-03-02 05:25:40,942
725,6033,6781,13539,"23 days, 4:38:37",2013-02-07 00:47:03,2013-02-07 00:47:03,2013-03-02 05:25:40,7788
39,1281,2398,3718,"23 days, 4:39:06",2013-02-07 00:46:34,2013-02-07 00:46:34,2013-03-02 05:25:40,4959
1131,3008,3839,7978,"23 days, 4:40:33",2013-02-07 00:45:07,2013-02-07 00:45:07,2013-03-02 05:25:40,8804
1332,1595,1996,4923,"23 days, 4:41:10",2013-02-07 00:44:30,2013-02-07 00:44:30,2013-03-02 05:25:40,447
702,5193,5173,11068,"23 days, 4:41:56",2013-02-07 00:43:44,2013-02-07 00:43:44,2013-03-02 05:25:40,3110
314,5734,4418,10466,"23 days, 4:43:49",2013-02-07 00:41:51,2013-02-07 00:41:51,2013-03-02 05:25:40,8463
961,1785,2575,5321,"23 days, 4:44:00",2013-02-07 00:41:40,2013-02-07 00:41:40,2013-03-02 05:25:40,9242
1062,1927,2717,5706,"23 days, 4:44:31",2013-02-07 00:41:09,2013-02-07 00:41:09,2013-03-02 05:25:40,4395
2401,8085,6999,17485,"23 days, 4:45:14",2013-02-07 00:40:26,2013-02-07 00:40:26,2013-03-02 05:25:40,1603
892,2092,2484,5468,"23 days, 4:45:42",2013-02-07 00:39:58,2013-02-07 00:39:58,2013-03-02 05:25:40,2073
260,5290,5077,10627,"23 days, 4:46:14",2013-02-07 00:39:26,2013-02-07 00:39:26,2013-03-02 05:25:40,1775
204,996,1221,2421,"23 days, 4:46:29",2013-02-07 00:39:11,2013-02-07 00:39:11,2013-03-02 05:25:40,9707
737,1540,2239,4516,"23 days, 4:46:42",2013-02-07 00:38:58,2013-02-07 00:38:58,2013-03-02 05:25:40,570
523,1583,3150,5256,"23 days, 4:47:01",2013-02-07 00:38:39,2013-02-07 00:38:39,2013-03-02 05:25:40,4614
155,595,889,1639,"23 days, 4:47:10",2013-02-07 00:38:30,2013-02-07 00:38:30,2013-03-02 05:25:40,3640
2117,7709,10026,19852,"23 days, 4:47:42",2013-02-07 00:37:58,2013-02-07 00:37:58,2013-03-02 05:25:40,9896
204,4348,4304,8856,"23 days, 4:48:40",2013-02-07 00:37:00,2013-02-07 00:37:00,2013-03-02 05:25:40,5893
1411,5083,3557,10051,"23 days, 4:48:58",2013-02-07 00:36:42,2013-02-07 00:36:42,2013-03-02 05:25:40,463
1832,5571,6706,14109,"23 days, 4:49:08",2013-02-07 00:36:32,2013-02-07 00:36:32,2013-03-02 05:25:40,6028
142,1894,3710,5746,"23 days, 4:49:34",2013-02-07 00:36:06,2013-02-07 00:36:06,2013-03-02 05:25:40,8391
1546,826,1093,3465,"23 days, 4:49:41",2013-02-07 00:35:59,2013-02-07 00:35:59,2013-03-02 05:25:40,6464
609,2146,2928,5683,"23 days, 4:49:44",2013-02-07 00:35:56,2013-02-07 00:35:56,2013-03-02 05:25:40,5440
1230,1108,1710,4048,"23 days, 4:49:57",2013-02-07 00:35:43,2013-02-07 00:35:43,2013-03-02 05:25:40,795
212,2041,4659,6912,"23 days, 4:50:09",2013-02-07 00:35:31,2013-02-07 00:35:31,2013-03-02 05:25:40,6701
97,1405,2374,3876,"23 days, 4:50:11",2013-02-07 00:35:29,2013-02-07 00:35:29,2013-03-02 05:25:40,6084
826,4856,5310,10992,"23 days, 4:50:20",2013-02-07 00:35:20,2013-02-07 00:35:20,2013-03-02 05:25:40,7852
899,5761,4620,11280,"23 days, 4:55:38",2013-02-07 00:30:02,2013-02-07 00:30:02,2013-03-02 05:25:40,8081
677,5760,6895,13332,"23 days, 4:56:43",2013-02-07 00:28:57,2013-02-07 00:28:57,2013-03-02 05:25:40,2968
234,492,535,1261,"23 days, 4:57:14",2013-02-07 00:28:26,2013-02-07 00:28:26,2013-03-02 05:25:40,7611
85,1690,2415,4190,"23 days, 4:57:52",2013-02-07 00:27:48,2013-02-07 00:27:48,2013-03-02 05:25:40,2662
479,2634,2767,5880,"23 days, 5:00:38",2013-02-07 00:25:02,2013-02-07 00:25:02,2013-03-02 05:25:40,3892
1106,7377,8511,16994,"23 days, 5:02:01",2013-02-07 00:23:39,2013-02-07 00:23:39,2013-03-02 05:25:40,8453
546,7019,6964,14529,"23 days, 5:02:29",2013-02-07 00:23:11,2013-02-07 00:23:11,2013-03-02 05:25:40,1832
239,807,1595,2641,"23 days, 5:02:56",2013-02-07 00:22:44,2013-02-07 00:22:44,2013-03-02 05:25:40,477
24,9407,7616,17047,"23 days, 5:02:57",2013-02-07 00:22:43,2013-02-07 00:22:43,2013-03-02 05:25:40,5781
513,2687,4722,7922,"23 days, 5:04:45",2013-02-07 00:20:55,2013-02-07 00:20:55,2013-03-02 05:25:40,4842
94,4873,5183,10150,"23 days, 5:04:58",2013-02-07 00:20:42,2013-02-07 00:20:42,2013-03-02 05:25:40,3648
1301,8906,8786,18993,"23 days, 5:07:18",2013-02-07 00:18:22,2013-02-07 00:18:22,2013-03-02 05:25:40,8658
309,6429,8294,15032,"23 days, 5:07:26",2013-02-07 00:18:14,2013-02-07 00:18:14,2013-03-02 05:25:40,2181
595,6339,4265,11199,"23 days, 5:07:38",2013-02-07 00:18:02,2013-02-07 00:18:02,2013-03-02 05:25:40,9311
2416,5531,6514,14461,"23 days, 5:08:55",2013-02-07 00:16:45,2013-02-07 00:16:45,2013-03-02 05:25:40,1794
976,3780,4556,9312,"23 days, 5:09:01",2013-02-07 00:16:39,2013-02-07 00:16:39,2013-03-02 05:25:40,9397
772,1168,1446,3386,"23 days, 5:11:38",2013-02-07 00:14:02,2013-02-07 00:14:02,2013-03-02 05:25:40,6558
310,4604,4247,9161,"23 days, 5:11:56",2013-02-07 00:13:44,2013-02-07 00:13:44,2013-03-02 05:25:40,5761
1098,2341,3071,6510,"23 days, 5:12:00",2013-02-07 00:13:40,2013-02-07 00:13:40,2013-03-02 05:25:40,2558
109,4113,5110,9332,"23 days, 5:12:09",2013-02-07 00:13:31,2013-02-07 00:13:31,2013-03-02 05:25:40,1567
492,3722,4441,8655,"23 days, 5:12:13",2013-02-07 00:13:27,2013-02-07 00:13:27,2013-03-02 05:25:40,3969
465,1390,2171,4026,"23 days, 5:12:32",2013-02-07 00:13:08,2013-02-07 00:13:08,2013-03-02 05:25:40,8089
264,8894,6562,15720,"23 days, 5:13:27",2013-02-07 00:12:13,2013-02-07 00:12:13,2013-03-02 05:25:40,4059
1728,1974,2625,6327,"23 days, 5:13:54",2013-02-07 00:11:46,2013-02-07 00:11:46,2013-03-02 05:25:40,7320
1076,3391,5067,9534,"23 days, 5:14:19",2013-02-07 00:11:21,2013-02-07 00:11:21,2013-03-02 05:25:40,4720
1125,5352,6675,13152,"23 days, 5:14:20",2013-02-07 00:11:20,2013-02-07 00:11:20,2013-03-02 05:25:40,4828
839,2360,2858,6057,"23 days, 5:16:39",2013-02-07 00:09:01,2013-02-07 00:09:01,2013-03-02 05:25:40,2789
577,4011,6131,10719,"23 days, 5:16:42",2013-02-07 00:08:58,2013-02-07 00:08:58,2013-03-02 05:25:40,9852
288,2520,3695,6503,"23 days, 5:17:10",2013-02-07 00:08:30,2013-02-07 00:08:30,2013-03-02 05:25:40,2776
52,2677,3665,6394,"23 days, 5:17:43",2013-02-07 00:07:57,2013-02-07 00:07:57,2013-03-02 05:25:40,4413
402,2700,2742,5844,"23 days, 5:18:23",2013-02-07 00:07:17,2013-02-07 00:07:17,2013-03-02 05:25:40,350
1073,2600,3241,6914,"23 days, 5:18:45",2013-02-07 00:06:55,2013-02-07 00:06:55,2013-03-02 05:25:40,4518
2062,6642,6254,14958,"23 days, 5:19:40",2013-02-07 00:06:00,2013-02-07 00:06:00,2013-03-02 05:25:40,2471
2222,2951,4366,9539,"23 days, 5:20:17",2013-02-07 00:05:23,2013-02-07 00:05:23,2013-03-02 05:25:40,7374
2184,2806,4397,9387,"23 days, 5:21:06",2013-02-07 00:04:34,2013-02-07 00:04:34,2013-03-02 05:25:40,5598
958,7942,7291,16191,"23 days, 5:21:32",2013-02-07 00:04:08,2013-02-07 00:04:08,2013-03-02 05:25:40,8954
2006,6782,8404,17192,"23 days, 5:21:52",2013-02-07 00:03:48,2013-02-07 00:03:48,2013-03-02 05:25:40,8541
90,4698,5756,10544,"23 days, 5:22:05",2013-02-07 00:03:35,2013-02-07 00:03:35,2013-03-02 05:25:40,4974
755,3218,3579,7552,"23 days, 5:22:11",2013-02-07 00:03:29,2013-02-07 00:03:29,2013-03-02 05:25:40,9160
826,3194,7437,11457,"23 days, 5:22:25",2013-02-07 00:03:15,2013-02-07 00:03:15,2013-03-02 05:25:40,4341
807,1741,1763,4311,"23 days, 5:23:05",2013-02-07 00:02:35,2013-02-07 00:02:35,2013-03-02 05:25:40,3917
2109,7515,6481,16105,"23 days, 5:23:21",2013-02-07 00:02:19,2013-02-07 00:02:19,2013-03-02 05:25:40,9750
96,5028,5177,10301,"23 days, 5:23:43",2013-02-07 00:01:57,2013-02-07 00:01:57,2013-03-02 05:25:40,3889
193,2781,4459,7433,"23 days, 5:24:16",2013-02-07 00:01:24,2013-02-07 00:01:24,2013-03-02 05:25:40,437
839,4438,4717,9994,"23 days, 5:24:55",2013-02-07 00:00:45,2013-02-07 00:00:45,2013-03-02 05:25:40,9091
42,719,1743,2504,"23 days, 5:25:14",2013-02-07 00:00:26,2013-02-07 00:00:26,2013-03-02 05:25:40,7820
593,1005,1296,2894,"23 days, 7:53:35",2013-02-07 07:20:02,2010-02-28 03:43:49,2010-03-23 11:37:24,9645
4136,7737,9327,21200,"23 days, 13:37:32",2013-02-07 07:15:26,2010-02-01 10:32:08,2010-02-25 00:09:40,5950
212,2046,2502,4760,"23 days, 13:40:45",2013-02-07 07:50:59,2010-02-01 10:32:08,2010-02-25 00:12:53,5230
1043,594,1416,3053,"23 days, 13:44:59",2013-02-07 00:19:55,2010-02-01 10:32:08,2010-02-25 00:17:07,4917
1419,1978,2457,5854,"23 days, 14:01:56",2013-02-07 10:24:50,2010-02-01 10:32:08,2010-02-25 00:34:04,1539
1554,3397,3203,8154,"23 days, 14:06:52",2013-02-07 08:14:12,2010-02-28 11:26:34,2010-03-24 01:33:26,5678
49,6849,8341,15239,"23 days, 14:19:01",2013-02-07 08:26:06,2010-02-01 10:32:08,2010-02-25 00:51:09,6658
492,6739,7641,14872,"23 days, 14:29:02",2013-02-07 11:55:03,2010-02-01 10:32:08,2010-02-25 01:01:10,5614
1776,4937,5227,11940,"23 days, 14:30:49",2013-02-07 09:48:09,2010-02-01 10:32:08,2010-02-25 01:02:57,1138
162,6823,7830,14815,"23 days, 14:31:07",2013-02-11 05:59:17,2010-02-01 10:32:08,2010-02-25 01:03:15,1159
430,2981,3991,7402,"23 days, 14:38:37",2013-02-07 02:17:47,2010-02-01 10:32:08,2010-02-25 01:10:45,8304
1792,3041,5790,10623,"23 days, 14:39:07",2013-02-07 06:21:00,2010-02-01 10:32:08,2010-02-25 01:11:15,7044
964,1896,3723,6583,"23 days, 14:57:05",2013-02-07 06:07:03,2010-02-01 10:32:08,2010-02-25 01:29:13,9913
1907,7213,7796,16916,"23 days, 15:04:07",2013-02-07 02:39:44,2010-02-01 10:32:08,2010-02-25 01:36:15,2944
1435,3769,4113,9317,"23 days, 15:15:51",2013-02-07 01:44:44,2010-02-01 10:32:08,2010-02-25 01:47:59,8430
51,3097,3290,6438,"23 days, 15:39:52",2013-02-07 04:56:26,2010-02-01 10:32:08,2010-02-25 02:12:00,9085
143,9492,7147,16782,"23 days, 15:43:58",2013-02-07 01:53:21,2010-02-01 10:32:08,2010-02-25 02:16:06,1576
21,2125,3438,5584,"23 days, 15:54:10",2013-02-07 04:38:26,2010-02-01 10:32:08,2010-02-25 02:26:18,654
609,754,1072,2435,"23 days, 15:59:05",2013-02-07 03:38:55,2010-02-01 10:32:08,2010-02-25 02:31:13,7357
1125,3966,6710,11801,"23 days, 16:03:00",2013-02-07 11:05:03,2010-02-01 10:32:08,2010-02-25 02:35:08,8965
306,3666,6923,10895,"23 days, 16:03:45",2013-02-09 06:44:50,2010-02-01 10:32:08,2010-02-25 02:35:53,3269
540,1652,3366,5558,"23 days, 16:06:14",2013-02-07 06:53:41,2010-02-01 10:32:08,2010-02-25 02:38:22,1960
446,1350,1784,3580,"23 days, 16:24:04",2013-02-14 06:16:43,2010-02-01 10:32:08,2010-02-25 02:56:12,6926
904,3799,2777,7480,"23 days, 16:31:10",2013-02-12 00:39:13,2010-02-01 10:32:08,2010-02-25 03:03:18,3172
216,577,1058,1851,"23 days, 16:34:28",2013-02-07 03:48:22,2010-02-01 10:32:08,2010-02-25 03:06:36,4295
868,2398,3170,6436,"23 days, 16:36:19",2013-02-07 05:13:46,2010-02-01 10:32:08,2010-02-25 03:08:27,1109
871,5216,4613,10700,"23 days, 16:48:02",2013-02-07 10:59:29,2010-02-01 10:32:08,2010-02-25 03:20:10,2119
141,4124,5033,9298,"23 days, 17:13:10",2013-02-07 00:29:54,2010-02-01 10:32:08,2010-02-25 03:45:18,46
1202,997,1447,3646,"23 days, 17:26:03",2013-02-06 11:59:37,2013-02-06 11:59:37,2013-03-02 05:25:40,5821
482,3568,4161,8211,"23 days, 17:26:43",2013-02-06 11:58:57,2013-02-06 11:58:57,2013-03-02 05:25:40,119
1128,2793,3548,7469,"23 days, 17:26:46",2013-02-06 11:58:54,2013-02-06 11:58:54,2013-03-02 05:25:40,8915
205,3918,3273,7396,"23 days, 17:27:25",2013-02-06 11:58:15,2013-02-06 11:58:15,2013-03-02 05:25:40,7206
94,2741,3885,6720,"23 days, 17:28:16",2013-02-06 11:57:24,2013-02-06 11:57:24,2013-03-02 05:25:40,1618
745,1322,1742,3809,"23 days, 17:28:32",2013-02-06 11:57:08,2013-02-06 11:57:08,2013-03-02 05:25:40,3965
222,4802,4641,9665,"23 days, 17:28:36",2013-02-06 11:57:04,2013-02-06 11:57:04,2013-03-02 05:25:40,8389
66,1158,2295,3519,"23 days, 17:29:02",2013-02-06 11:56:38,2013-02-06 11:56:38,2013-03-02 05:25:40,4277
72,5972,5053,11097,"23 days, 17:29:17",2013-02-06 11:56:23,2013-02-06 11:56:23,2013-03-02 05:25:40,1991
23,4696,5365,10084,"23 days, 17:29:42",2013-02-06 11:55:58,2013-02-06 11:55:58,2013-03-02 05:25:40,1765
1950,7120,6740,15810,"23 days, 17:29:53",2013-02-06 11:55:47,2013-02-06 11:55:47,2013-03-02 05:25:40,3525
51,2036,4060,6147,"23 days, 17:30:01",2013-02-06 11:55:39,2013-02-06 11:55:39,2013-03-02 05:25:40,6958
396,2438,4017,6851,"23 days, 17:30:20",2013-02-06 11:55:20,2013-02-06 11:55:20,2013-03-02 05:25:40,503
371,6109,5882,12362,"23 days, 17:31:27",2013-02-06 11:54:13,2013-02-06 11:54:13,2013-03-02 05:25:40,5734
2193,4011,4651,10855,"23 days, 17:31:55",2013-02-06 11:53:45,2013-02-06 11:53:45,2013-03-02 05:25:40,7378
142,3771,3235,7148,"23 days, 17:32:26",2013-02-06 11:53:14,2013-02-06 11:53:14,2013-03-02 05:25:40,978
880,3685,5171,9736,"23 days, 17:32:54",2013-02-06 11:52:46,2013-02-06 11:52:46,2013-03-02 05:25:40,283
745,1759,2455,4959,"23 days, 17:33:34",2013-02-06 11:52:06,2013-02-06 11:52:06,2013-03-02 05:25:40,7612
1058,2914,4729,8701,"23 days, 17:33:51",2013-02-06 11:51:49,2013-02-06 11:51:49,2013-03-02 05:25:40,3135
1320,7010,8664,16994,"23 days, 17:35:01",2013-02-06 11:50:39,2013-02-06 11:50:39,2013-03-02 05:25:40,8059
584,2883,4760,8227,"23 days, 17:35:09",2013-02-06 11:50:31,2013-02-06 11:50:31,2013-03-02 05:25:40,5754
483,5440,5581,11504,"23 days, 17:36:12",2013-02-06 11:49:28,2013-02-06 11:49:28,2013-03-02 05:25:40,7290
36,6180,5339,11555,"23 days, 17:37:10",2013-02-06 11:48:30,2013-02-06 11:48:30,2013-03-02 05:25:40,9872
1098,1607,2718,5423,"23 days, 17:38:09",2013-02-06 11:47:31,2013-02-06 11:47:31,2013-03-02 05:25:40,6865
1586,6495,5780,13861,"23 days, 17:38:22",2013-02-06 11:47:18,2013-02-06 11:47:18,2013-03-02 05:25:40,9934
1248,407,1235,2890,"23 days, 17:38:43",2013-02-06 11:46:57,2013-02-06 11:46:57,2013-03-02 05:25:40,4994
1926,4747,4295,10968,"23 days, 17:38:48",2013-02-06 11:46:52,2013-02-06 11:46:52,2013-03-02 05:25:40,2881
514,4207,4138,8859,"23 days, 17:39:13",2013-02-06 11:46:27,2013-02-06 11:46:27,2013-03-02 05:25:40,1435
194,7886,7615,15695,"23 days, 17:39:37",2013-02-06 11:46:03,2013-02-06 11:46:03,2013-03-02 05:25:40,31
1120,6485,5579,13184,"23 days, 17:39:43",2013-02-06 11:45:57,2013-02-06 11:45:57,2013-03-02 05:25:40,8298
2420,8351,7507,18278,"23 days, 17:40:20",2013-02-06 11:45:20,2013-02-06 11:45:20,2013-03-02 05:25:40,3828
1883,5716,6920,14519,"23 days, 17:40:23",2013-02-06 11:45:17,2013-02-06 11:45:17,2013-03-02 05:25:40,7199
660,5990,6792,13442,"23 days, 17:40:26",2013-02-06 11:45:14,2013-02-06 11:45:14,2013-03-02 05:25:40,9343
60,5257,4558,9875,"23 days, 17:40:33",2013-02-06 11:45:07,2013-02-06 11:45:07,2013-03-02 05:25:40,9218
1051,5741,4672,11464,"23 days, 17:40:44",2013-02-06 11:44:56,2013-02-06 11:44:56,2013-03-02 05:25:40,3521
578,7866,7903,16347,"23 days, 17:40:54",2013-02-06 11:44:46,2013-02-06 11:44:46,2013-03-02 05:25:40,7981
1400,6249,6996,14645,"23 days, 17:40:57",2013-02-06 11:44:43,2013-02-06 11:44:43,2013-03-02 05:25:40,7858
344,3752,5414,9510,"23 days, 17:41:31",2013-02-06 11:44:09,2013-02-06 11:44:09,2013-03-02 05:25:40,2967
120,906,1215,2241,"23 days, 17:42:08",2013-02-06 11:43:32,2013-02-06 11:43:32,2013-03-02 05:25:40,6085
226,4519,5117,9862,"23 days, 17:43:03",2013-02-06 11:42:37,2013-02-06 11:42:37,2013-03-02 05:25:40,2898
32,3777,4422,8231,"23 days, 17:43:16",2013-02-06 11:42:24,2013-02-06 11:42:24,2013-03-02 05:25:40,6230
545,6234,7224,14003,"23 days, 17:43:27",2013-02-06 11:42:13,2013-02-06 11:42:13,2013-03-02 05:25:40,1060
859,3291,3584,7734,"23 days, 17:43:58",2013-02-06 11:41:42,2013-02-06 11:41:42,2013-03-02 05:25:40,1441
1353,4799,5589,11741,"23 days, 17:44:01",2013-02-06 11:41:39,2013-02-06 11:41:39,2013-03-02 05:25:40,9994
39,2629,2977,5645,"23 days, 17:44:39",2013-02-06 11:41:01,2013-02-06 11:41:01,2013-03-02 05:25:40,5782
72,5885,6624,12581,"23 days, 17:45:44",2013-02-06 11:39:56,2013-02-06 11:39:56,2013-03-02 05:25:40,9966
227,3406,3425,7058,"23 days, 17:46:03",2013-02-06 11:53:13,2010-02-01 10:32:08,2010-02-25 04:18:11,4758
576,2593,3288,6457,"23 days, 17:46:07",2013-02-06 11:39:33,2013-02-06 11:39:33,2013-03-02 05:25:40,6737
1735,4674,5732,12141,"23 days, 17:46:12",2013-02-06 11:39:28,2013-02-06 11:39:28,2013-03-02 05:25:40,7450
723,4186,5221,10130,"23 days, 17:46:39",2013-02-07 07:10:52,2010-02-01 10:32:08,2010-02-25 04:18:47,6461
2403,7319,7453,17175,"23 days, 17:46:48",2013-02-06 11:38:52,2013-02-06 11:38:52,2013-03-02 05:25:40,3386
1974,5046,5729,12749,"23 days, 17:47:02",2013-02-06 11:38:38,2013-02-06 11:38:38,2013-03-02 05:25:40,9629
87,6266,6604,12957,"23 days, 17:47:49",2013-02-06 11:37:51,2013-02-06 11:37:51,2013-03-02 05:25:40,4718
222,1250,1606,3078,"23 days, 17:50:01",2013-02-06 11:35:39,2013-02-06 11:35:39,2013-03-02 05:25:40,3815
562,4937,4674,10173,"23 days, 17:50:33",2013-02-06 11:35:07,2013-02-06 11:35:07,2013-03-02 05:25:40,8193
1774,3127,5725,10626,"23 days, 17:51:21",2013-02-06 11:34:19,2013-02-06 11:34:19,2013-03-02 05:25:40,4646
894,6957,9365,17216,"23 days, 17:51:27",2013-02-06 11:34:13,2013-02-06 11:34:13,2013-03-02 05:25:40,3385
350,4206,4843,9399,"23 days, 17:51:58",2013-02-07 11:06:23,2010-02-01 10:32:08,2010-02-25 04:24:06,7542
1112,3466,4557,9135,"23 days, 17:52:01",2013-02-06 11:33:39,2013-02-06 11:33:39,2013-03-02 05:25:40,7024
231,828,1932,2991,"23 days, 17:52:14",2013-02-06 11:33:26,2013-02-06 11:33:26,2013-03-02 05:25:40,9295
2179,4922,6767,13868,"23 days, 17:52:27",2013-02-06 11:33:13,2013-02-06 11:33:13,2013-03-02 05:25:40,8688
510,2381,4481,7372,"23 days, 17:52:51",2013-02-06 11:32:49,2013-02-06 11:32:49,2013-03-02 05:25:40,1240
325,3377,5084,8786,"23 days, 17:52:54",2013-02-06 11:32:46,2013-02-06 11:32:46,2013-03-02 05:25:40,3137
121,4550,7671,12342,"23 days, 17:53:02",2013-02-06 11:32:38,2013-02-06 11:32:38,2013-03-02 05:25:40,8937
2090,7481,8372,17943,"23 days, 17:53:03",2013-02-06 11:32:37,2013-02-06 11:32:37,2013-03-02 05:25:40,6290
2373,4292,3656,10321,"23 days, 17:53:05",2013-02-06 11:32:35,2013-02-06 11:32:35,2013-03-02 05:25:40,1202
144,1351,4194,5689,"23 days, 17:53:52",2013-02-06 11:31:48,2013-02-06 11:31:48,2013-03-02 05:25:40,7271
233,7033,7121,14387,"23 days, 17:53:53",2013-02-06 11:31:47,2013-02-06 11:31:47,2013-03-02 05:25:40,1590
200,3415,3647,7262,"23 days, 17:54:14",2013-02-06 11:31:26,2013-02-06 11:31:26,2013-03-02 05:25:40,3017
13,2413,3212,5638,"23 days, 17:54:37",2013-02-06 11:31:03,2013-02-06 11:31:03,2013-03-02 05:25:40,1311
2415,10700,9337,22452,"23 days, 17:54:39",2013-02-06 11:31:01,2013-02-06 11:31:01,2013-03-02 05:25:40,8260
846,4007,4609,9462,"23 days, 17:54:54",2013-02-06 11:30:46,2013-02-06 11:30:46,2013-03-02 05:25:40,8252
249,4427,6120,10796,"23 days, 17:55:52",2013-02-06 11:29:48,2013-02-06 11:29:48,2013-03-02 05:25:40,8538
1696,6583,7397,15676,"23 days, 17:56:02",2013-02-06 11:29:38,2013-02-06 11:29:38,2013-03-02 05:25:40,7375
968,4858,3985,9811,"23 days, 17:56:15",2013-02-06 11:29:25,2013-02-06 11:29:25,2013-03-02 05:25:40,2711
57,1274,1819,3150,"23 days, 17:57:29",2013-02-06 11:28:11,2013-02-06 11:28:11,2013-03-02 05:25:40,2660
581,4625,6808,12014,"23 days, 17:57:33",2013-02-06 11:28:07,2013-02-06 11:28:07,2013-03-02 05:25:40,3089
1441,5664,8194,15299,"23 days, 17:58:09",2013-02-06 11:27:31,2013-02-06 11:27:31,2013-03-02 05:25:40,6716
571,1585,2091,4247,"23 days, 17:58:38",2013-02-06 11:27:02,2013-02-06 11:27:02,2013-03-02 05:25:40,4435
378,1666,2961,5005,"23 days, 17:58:38",2013-02-06 11:27:02,2013-02-06 11:27:02,2013-03-02 05:25:40,4645
1332,1528,2750,5610,"23 days, 17:59:21",2013-02-06 11:26:19,2013-02-06 11:26:19,2013-03-02 05:25:40,2700
481,781,1345,2607,"23 days, 17:59:21",2013-02-06 11:26:19,2013-02-06 11:26:19,2013-03-02 05:25:40,3771
1528,3139,4667,9334,"23 days, 17:59:42",2013-02-06 11:25:58,2013-02-06 11:25:58,2013-03-02 05:25:40,9100
1063,3532,3762,8357,"23 days, 18:00:27",2013-02-06 11:25:13,2013-02-06 11:25:13,2013-03-02 05:25:40,7262
499,2521,3080,6100,"23 days, 18:00:52",2013-02-06 11:24:48,2013-02-06 11:24:48,2013-03-02 05:25:40,886
1784,5883,6226,13893,"23 days, 18:01:24",2013-02-06 11:24:16,2013-02-06 11:24:16,2013-03-02 05:25:40,7559
698,5868,6914,13480,"23 days, 18:03:48",2013-02-06 11:21:52,2013-02-06 11:21:52,2013-03-02 05:25:40,3887
1673,1362,3327,6362,"23 days, 18:04:02",2013-02-06 11:21:38,2013-02-06 11:21:38,2013-03-02 05:25:40,872
921,3003,3435,7359,"23 days, 18:05:01",2013-02-06 11:20:39,2013-02-06 11:20:39,2013-03-02 05:25:40,1257
573,3871,4600,9044,"23 days, 18:05:53",2013-02-06 11:19:47,2013-02-06 11:19:47,2013-03-02 05:25:40,9622
80,6532,6590,13202,"23 days, 18:06:35",2013-02-06 11:19:05,2013-02-06 11:19:05,2013-03-02 05:25:40,2918
266,5512,7849,13627,"23 days, 18:07:11",2013-02-06 11:18:29,2013-02-06 11:18:29,2013-03-02 05:25:40,5916
369,3829,7216,11414,"23 days, 18:07:22",2013-02-06 11:18:18,2013-02-06 11:18:18,2013-03-02 05:25:40,4382
238,582,1073,1893,"23 days, 18:07:49",2013-02-06 11:17:51,2013-02-06 11:17:51,2013-03-02 05:25:40,4306
1404,119,157,1680,"23 days, 18:07:54",2013-02-06 11:17:46,2013-02-06 11:17:46,2013-03-02 05:25:40,7102
1292,6406,6092,13790,"23 days, 18:08:03",2013-02-06 11:17:37,2013-02-06 11:17:37,2013-03-02 05:25:40,2271
666,3520,5226,9412,"23 days, 18:08:13",2013-02-06 11:17:27,2013-02-06 11:17:27,2013-03-02 05:25:40,3069
202,831,1562,2595,"23 days, 18:09:20",2013-02-06 11:16:20,2013-02-06 11:16:20,2013-03-02 05:25:40,4509
1355,5414,5107,11876,"23 days, 18:09:32",2013-02-10 11:56:03,2010-02-01 10:32:08,2010-02-25 04:41:40,5303
224,9738,8331,18293,"23 days, 18:09:34",2013-02-06 11:16:06,2013-02-06 11:16:06,2013-03-02 05:25:40,8778
728,6928,7513,15169,"23 days, 18:10:18",2013-02-06 11:15:22,2013-02-06 11:15:22,2013-03-02 05:25:40,5072
201,623,1143,1967,"23 days, 18:10:19",2013-02-06 11:15:21,2013-02-06 11:15:21,2013-03-02 05:25:40,1887
1636,5494,5544,12674,"23 days, 18:11:31",2013-02-06 11:14:09,2013-02-06 11:14:09,2013-03-02 05:25:40,3284
727,1527,2979,5233,"23 days, 18:12:09",2013-02-06 11:13:31,2013-02-06 11:13:31,2013-03-02 05:25:40,4950
901,1821,3668,6390,"23 days, 18:12:14",2013-02-06 11:13:26,2013-02-06 11:13:26,2013-03-02 05:25:40,1808
599,3331,4052,7982,"23 days, 18:12:26",2013-02-06 11:13:14,2013-02-06 11:13:14,2013-03-02 05:25:40,1070
184,4750,4582,9516,"23 days, 18:12:51",2013-02-06 11:12:49,2013-02-06 11:12:49,2013-03-02 05:25:40,2567
1311,8836,7629,17776,"23 days, 18:12:52",2013-02-06 11:12:48,2013-02-06 11:12:48,2013-03-02 05:25:40,9806
900,4293,5831,11024,"23 days, 18:13:01",2013-02-06 11:12:39,2013-02-06 11:12:39,2013-03-02 05:25:40,1369
895,5943,5755,12593,"23 days, 18:13:04",2013-02-06 11:12:36,2013-02-06 11:12:36,2013-03-02 05:25:40,3968
171,3985,4800,8956,"23 days, 18:13:43",2013-02-06 11:11:57,2013-02-06 11:11:57,2013-03-02 05:25:40,230
2,1018,1744,2764,"23 days, 18:13:50",2013-02-06 11:11:50,2013-02-06 11:11:50,2013-03-02 05:25:40,3821
1192,3934,4206,9332,"23 days, 18:14:14",2013-02-06 11:11:26,2013-02-06 11:11:26,2013-03-02 05:25:40,6584
403,3645,4890,8938,"23 days, 18:15:27",2013-02-06 11:10:13,2013-02-06 11:10:13,2013-03-02 05:25:40,7498
74,118,291,483,"23 days, 18:16:36",2013-02-06 11:09:04,2013-02-06 11:09:04,2013-03-02 05:25:40,7113
604,1855,2348,4807,"23 days, 18:16:48",2013-02-06 11:08:52,2013-02-06 11:08:52,2013-03-02 05:25:40,576
966,7779,7397,16142,"23 days, 18:18:14",2013-02-06 11:07:26,2013-02-06 11:07:26,2013-03-02 05:25:40,7251
981,5575,6113,12669,"23 days, 18:18:14",2013-02-06 11:07:26,2013-02-06 11:07:26,2013-03-02 05:25:40,1667
571,3603,4453,8627,"23 days, 18:18:39",2013-02-06 11:07:01,2013-02-06 11:07:01,2013-03-02 05:25:40,7288
219,893,1476,2588,"23 days, 18:18:50",2013-02-06 11:06:50,2013-02-06 11:06:50,2013-03-02 05:25:40,1352
110,3685,3395,7190,"23 days, 18:19:13",2013-02-06 11:06:27,2013-02-06 11:06:27,2013-03-02 05:25:40,4888
1163,3119,4700,8982,"23 days, 18:19:37",2013-02-06 11:06:03,2013-02-06 11:06:03,2013-03-02 05:25:40,7423
512,1780,3373,5665,"23 days, 18:21:26",2013-02-06 11:04:14,2013-02-06 11:04:14,2013-03-02 05:25:40,208
1057,6371,6083,13511,"23 days, 18:21:33",2013-02-06 11:04:07,2013-02-06 11:04:07,2013-03-02 05:25:40,1557
1563,7665,7415,16643,"23 days, 18:21:46",2013-02-06 11:03:54,2013-02-06 11:03:54,2013-03-02 05:25:40,1754
439,4841,5204,10484,"23 days, 18:22:36",2013-02-06 11:03:04,2013-02-06 11:03:04,2013-03-02 05:25:40,4735
45,1952,2796,4793,"23 days, 18:23:17",2013-02-06 11:02:23,2013-02-06 11:02:23,2013-03-02 05:25:40,9600
1716,1979,3388,7083,"23 days, 18:23:31",2013-02-06 11:02:09,2013-02-06 11:02:09,2013-03-02 05:25:40,4588
84,1316,2343,3743,"23 days, 18:23:38",2013-02-06 11:02:02,2013-02-06 11:02:02,2013-03-02 05:25:40,5930
48,3922,6379,10349,"23 days, 18:23:53",2013-02-06 11:01:47,2013-02-06 11:01:47,2013-03-02 05:25:40,2523
1466,4969,5570,12005,"23 days, 18:24:17",2013-02-06 11:01:23,2013-02-06 11:01:23,2013-03-02 05:25:40,465
132,3460,2882,6474,"23 days, 18:25:14",2013-02-06 11:00:26,2013-02-06 11:00:26,2013-03-02 05:25:40,1880
801,5895,7367,14063,"23 days, 18:27:35",2013-02-06 10:58:05,2013-02-06 10:58:05,2013-03-02 05:25:40,4344
1118,8179,5493,14790,"23 days, 18:27:36",2013-02-06 10:58:04,2013-02-06 10:58:04,2013-03-02 05:25:40,1372
347,5126,5814,11287,"23 days, 18:27:59",2013-02-06 10:57:41,2013-02-06 10:57:41,2013-03-02 05:25:40,2405
507,1388,1959,3854,"23 days, 18:28:18",2013-02-06 10:57:22,2013-02-06 10:57:22,2013-03-02 05:25:40,7116
48,3021,4618,7687,"23 days, 18:29:51",2013-02-06 10:55:49,2013-02-06 10:55:49,2013-03-02 05:25:40,3973
299,5060,5732,11091,"23 days, 18:30:25",2013-02-06 10:55:15,2013-02-06 10:55:15,2013-03-02 05:25:40,848
315,1170,1691,3176,"23 days, 18:30:45",2013-02-06 10:54:55,2013-02-06 10:54:55,2013-03-02 05:25:40,6074
605,7171,8172,15948,"23 days, 18:30:54",2013-02-06 10:54:46,2013-02-06 10:54:46,2013-03-02 05:25:40,973
426,9501,6285,16212,"23 days, 18:31:19",2013-02-06 10:54:21,2013-02-06 10:54:21,2013-03-02 05:25:40,4860
216,6413,5692,12321,"23 days, 18:31:25",2013-02-06 10:54:15,2013-02-06 10:54:15,2013-03-02 05:25:40,8267
338,2200,2147,4685,"23 days, 18:31:39",2013-02-06 10:54:01,2013-02-06 10:54:01,2013-03-02 05:25:40,5702
189,1789,2372,4350,"23 days, 18:32:45",2013-02-06 10:52:55,2013-02-06 10:52:55,2013-03-02 05:25:40,1230
664,1472,1479,3615,"23 days, 18:33:04",2013-02-06 10:52:36,2013-02-06 10:52:36,2013-03-02 05:25:40,5599
1515,10764,9532,21811,"23 days, 18:34:13",2013-02-06 10:51:27,2013-02-06 10:51:27,2013-03-02 05:25:40,2294
1147,1959,4128,7234,"23 days, 18:35:35",2013-02-06 10:50:05,2013-02-06 10:50:05,2013-03-02 05:25:40,396
942,2602,2971,6515,"23 days, 18:35:35",2013-02-06 10:50:05,2013-02-06 10:50:05,2013-03-02 05:25:40,1712
203,2784,1869,4856,"23 days, 18:35:56",2013-02-06 10:49:44,2013-02-06 10:49:44,2013-03-02 05:25:40,830
840,6017,6442,13299,"23 days, 18:36:06",2013-02-06 10:49:34,2013-02-06 10:49:34,2013-03-02 05:25:40,310
1215,2790,4298,8303,"23 days, 18:36:33",2013-02-06 10:49:07,2013-02-06 10:49:07,2013-03-02 05:25:40,3758
157,6633,6165,12955,"23 days, 18:36:35",2013-02-06 10:49:05,2013-02-06 10:49:05,2013-03-02 05:25:40,7579
1372,5639,3784,10795,"23 days, 18:36:49",2013-02-06 10:48:51,2013-02-06 10:48:51,2013-03-02 05:25:40,5114
1063,4559,4068,9690,"23 days, 18:36:55",2013-02-06 10:48:45,2013-02-06 10:48:45,2013-03-02 05:25:40,7933
127,4988,7559,12674,"23 days, 18:36:58",2013-02-06 10:48:42,2013-02-06 10:48:42,2013-03-02 05:25:40,6590
603,4784,5332,10719,"23 days, 18:37:11",2013-02-07 10:37:13,2010-02-01 10:32:08,2010-02-25 05:09:19,3544
1739,4018,3812,9569,"23 days, 18:37:13",2013-02-06 10:48:27,2013-02-06 10:48:27,2013-03-02 05:25:40,28
1185,2679,6813,10677,"23 days, 18:37:54",2013-02-06 10:47:46,2013-02-06 10:47:46,2013-03-02 05:25:40,4439
576,1141,1432,3149,"23 days, 18:38:34",2013-02-06 10:47:06,2013-02-06 10:47:06,2013-03-02 05:25:40,7067
859,315,561,1735,"23 days, 18:38:39",2013-02-06 10:47:01,2013-02-06 10:47:01,2013-03-02 05:25:40,8868
184,3493,2989,6666,"23 days, 18:39:05",2013-02-06 10:46:35,2013-02-06 10:46:35,2013-03-02 05:25:40,8210
1307,5593,5219,12119,"23 days, 18:39:13",2013-02-06 10:46:27,2013-02-06 10:46:27,2013-03-02 05:25:40,8215
1050,3716,6902,11668,"23 days, 18:39:47",2013-02-06 10:45:53,2013-02-06 10:45:53,2013-03-02 05:25:40,7032
634,1347,2104,4085,"23 days, 18:40:03",2013-02-06 10:45:37,2013-02-06 10:45:37,2013-03-02 05:25:40,7225
800,3186,3758,7744,"23 days, 18:40:13",2013-02-06 10:45:27,2013-02-06 10:45:27,2013-03-02 05:25:40,3989
472,1088,1970,3530,"23 days, 18:40:43",2013-02-06 10:44:57,2013-02-06 10:44:57,2013-03-02 05:25:40,2707
1414,8201,7753,17368,"23 days, 18:40:58",2013-02-06 10:44:42,2013-02-06 10:44:42,2013-03-02 05:25:40,2158
289,1849,2310,4448,"23 days, 18:41:46",2013-02-06 10:43:54,2013-02-06 10:43:54,2013-03-02 05:25:40,8787
713,1279,2239,4231,"23 days, 18:41:57",2013-02-06 10:43:43,2013-02-06 10:43:43,2013-03-02 05:25:40,2801
748,5145,7872,13765,"23 days, 18:42:29",2013-02-06 10:43:11,2013-02-06 10:43:11,2013-03-02 05:25:40,6896
690,5344,6072,12106,"23 days, 18:42:40",2013-02-06 10:43:00,2013-02-06 10:43:00,2013-03-02 05:25:40,6019
1018,6277,6166,13461,"23 days, 18:43:05",2013-02-06 10:42:35,2013-02-06 10:42:35,2013-03-02 05:25:40,101
312,2356,3900,6568,"23 days, 18:43:55",2013-02-06 10:41:45,2013-02-06 10:41:45,2013-03-02 05:25:40,8704
170,3806,5055,9031,"23 days, 18:44:23",2013-02-06 10:41:17,2013-02-06 10:41:17,2013-03-02 05:25:40,8612
145,6327,7517,13989,"23 days, 18:44:33",2013-02-06 10:41:07,2013-02-06 10:41:07,2013-03-02 05:25:40,7739
1314,3734,6505,11553,"23 days, 18:44:49",2013-02-06 10:40:51,2013-02-06 10:40:51,2013-03-02 05:25:40,2076
5,7136,8354,15495,"23 days, 18:44:55",2013-02-06 10:40:45,2013-02-06 10:40:45,2013-03-02 05:25:40,5558
74,2889,2726,5689,"23 days, 18:45:06",2013-02-06 10:40:34,2013-02-06 10:40:34,2013-03-02 05:25:40,319
1148,5427,4373,10948,"23 days, 18:45:36",2013-02-06 10:40:04,2013-02-06 10:40:04,2013-03-02 05:25:40,507
42,3901,3791,7734,"23 days, 18:45:39",2013-02-06 10:40:01,2013-02-06 10:40:01,2013-03-02 05:25:40,9837
81,529,780,1390,"23 days, 18:45:43",2013-02-06 10:39:57,2013-02-06 10:39:57,2013-03-02 05:25:40,751
469,824,1287,2580,"23 days, 18:46:29",2013-02-06 10:39:11,2013-02-06 10:39:11,2013-03-02 05:25:40,3397
633,5024,6232,11889,"23 days, 18:47:10",2013-02-06 10:38:30,2013-02-06 10:38:30,2013-03-02 05:25:40,9212
336,7748,7733,15817,"23 days, 18:47:18",2013-02-06 10:38:22,2013-02-06 10:38:22,2013-03-02 05:25:40,7418
2333,7495,7362,17190,"23 days, 18:48:02",2013-02-06 10:37:38,2013-02-06 10:37:38,2013-03-02 05:25:40,6235
1146,2449,2578,6173,"23 days, 18:48:10",2013-02-06 10:37:30,2013-02-06 10:37:30,2013-03-02 05:25:40,8684
2759,7304,9561,19624,"23 days, 18:48:35",2013-02-06 10:37:05,2013-02-06 10:37:05,2013-03-02 05:25:40,9593
93,1913,2694,4700,"23 days, 18:49:43",2013-02-06 10:35:57,2013-02-06 10:35:57,2013-03-02 05:25:40,3140
135,86,354,575,"23 days, 18:50:11",2013-02-06 10:35:29,2013-02-06 10:35:29,2013-03-02 05:25:40,1537
2754,3630,3890,10274,"23 days, 18:51:44",2013-02-06 10:33:56,2013-02-06 10:33:56,2013-03-02 05:25:40,3058
212,5443,5061,10716,"23 days, 18:52:12",2013-02-06 10:33:28,2013-02-06 10:33:28,2013-03-02 05:25:40,1857
371,2432,3533,6336,"23 days, 18:52:34",2013-02-06 10:33:06,2013-02-06 10:33:06,2013-03-02 05:25:40,4224
714,6416,8189,15319,"23 days, 18:52:36",2013-02-06 10:33:04,2013-02-06 10:33:04,2013-03-02 05:25:40,8156
26,4015,4525,8566,"23 days, 18:53:05",2013-02-06 10:32:35,2013-02-06 10:32:35,2013-03-02 05:25:40,9767
40,6163,6984,13187,"23 days, 18:53:14",2013-02-06 10:32:26,2013-02-06 10:32:26,2013-03-02 05:25:40,2527
56,8935,8328,17319,"23 days, 18:53:28",2013-02-06 10:32:12,2013-02-06 10:32:12,2013-03-02 05:25:40,6719
625,2455,3112,6192,"23 days, 18:53:33",2013-02-06 10:32:07,2013-02-06 10:32:07,2013-03-02 05:25:40,8594
623,6680,7658,14961,"23 days, 18:53:39",2013-02-06 10:32:01,2013-02-06 10:32:01,2013-03-02 05:25:40,5719
1216,4420,4691,10327,"23 days, 18:55:37",2013-02-06 10:30:03,2013-02-06 10:30:03,2013-03-02 05:25:40,8633
668,4838,5732,11238,"23 days, 18:56:07",2013-02-06 10:29:33,2013-02-06 10:29:33,2013-03-02 05:25:40,9669
373,794,1213,2380,"23 days, 18:56:26",2013-02-06 10:29:14,2013-02-06 10:29:14,2013-03-02 05:25:40,5969
1238,2013,2445,5696,"23 days, 18:57:47",2013-02-06 10:27:53,2013-02-06 10:27:53,2013-03-02 05:25:40,9811
229,6787,6799,13815,"23 days, 18:58:02",2013-02-06 10:27:38,2013-02-06 10:27:38,2013-03-02 05:25:40,1514
1658,6169,6202,14029,"23 days, 18:58:14",2013-02-06 10:27:26,2013-02-06 10:27:26,2013-03-02 05:25:40,4170
989,5724,6744,13457,"23 days, 18:59:46",2013-02-11 11:18:32,2010-02-01 10:32:08,2010-02-25 05:31:54,7690
2455,7733,7887,18075,"23 days, 19:00:23",2013-02-06 10:25:17,2013-02-06 10:25:17,2013-03-02 05:25:40,9169
786,2580,3283,6649,"23 days, 19:00:25",2013-02-06 10:25:15,2013-02-06 10:25:15,2013-03-02 05:25:40,8656
1193,7280,6847,15320,"23 days, 19:00:27",2013-02-06 10:25:13,2013-02-06 10:25:13,2013-03-02 05:25:40,1111
1873,7412,6810,16095,"23 days, 19:01:27",2013-02-06 10:24:13,2013-02-06 10:24:13,2013-03-02 05:25:40,1277
964,2687,4500,8151,"23 days, 19:02:17",2013-02-06 10:23:23,2013-02-06 10:23:23,2013-03-02 05:25:40,1517
304,4510,7170,11984,"23 days, 19:03:41",2013-02-06 10:21:59,2013-02-06 10:21:59,2013-03-02 05:25:40,4603
189,2606,3414,6209,"23 days, 19:04:12",2013-02-06 10:21:28,2013-02-06 10:21:28,2013-03-02 05:25:40,6064
61,4447,6067,10575,"23 days, 19:06:02",2013-02-06 10:19:38,2013-02-06 10:19:38,2013-03-02 05:25:40,819
36,3191,4725,7952,"23 days, 19:06:18",2013-02-06 10:19:22,2013-02-06 10:19:22,2013-03-02 05:25:40,9718
51,8436,8824,17311,"23 days, 19:06:43",2013-02-06 10:18:57,2013-02-06 10:18:57,2013-03-02 05:25:40,3378
790,494,800,2084,"23 days, 19:06:49",2013-02-06 10:18:51,2013-02-06 10:18:51,2013-03-02 05:25:40,8247
948,6513,6775,14236,"23 days, 19:07:11",2013-02-06 10:18:29,2013-02-06 10:18:29,2013-03-02 05:25:40,8540
1006,7024,6358,14388,"23 days, 19:07:28",2013-02-06 10:18:12,2013-02-06 10:18:12,2013-03-02 05:25:40,5963
2563,4714,6699,13976,"23 days, 19:07:36",2013-02-06 10:18:04,2013-02-06 10:18:04,2013-03-02 05:25:40,6112
51,6001,6699,12751,"23 days, 19:07:57",2013-02-06 10:17:43,2013-02-06 10:17:43,2013-03-02 05:25:40,9373
1022,2142,3115,6279,"23 days, 19:08:09",2013-02-06 10:17:31,2013-02-06 10:17:31,2013-03-02 05:25:40,1041
71,1440,2289,3800,"23 days, 19:09:23",2013-02-06 10:16:17,2013-02-06 10:16:17,2013-03-02 05:25:40,2642
907,5781,7297,13985,"23 days, 19:09:55",2013-02-06 10:15:45,2013-02-06 10:15:45,2013-03-02 05:25:40,4822
1554,5903,6226,13683,"23 days, 19:10:38",2013-02-06 10:15:02,2013-02-06 10:15:02,2013-03-02 05:25:40,429
2364,7276,5365,15005,"23 days, 19:11:29",2013-02-06 10:14:11,2013-02-06 10:14:11,2013-03-02 05:25:40,8788
376,7911,7481,15768,"23 days, 19:13:17",2013-02-06 10:12:23,2013-02-06 10:12:23,2013-03-02 05:25:40,296
1300,6024,6512,13836,"23 days, 19:14:06",2013-02-06 10:11:34,2013-02-06 10:11:34,2013-03-02 05:25:40,1945
234,885,1138,2257,"23 days, 19:14:51",2013-02-06 10:10:49,2013-02-06 10:10:49,2013-03-02 05:25:40,3218
358,687,1135,2180,"23 days, 19:15:44",2013-02-06 10:09:56,2013-02-06 10:09:56,2013-03-02 05:25:40,3675
655,3293,4463,8411,"23 days, 19:16:30",2013-02-06 10:09:10,2013-02-06 10:09:10,2013-03-02 05:25:40,5847
453,1202,2124,3779,"23 days, 19:17:11",2013-02-06 10:08:29,2013-02-06 10:08:29,2013-03-02 05:25:40,8756
1128,7096,7109,15333,"23 days, 19:17:21",2013-02-06 10:08:19,2013-02-06 10:08:19,2013-03-02 05:25:40,9262
3,1232,2039,3274,"23 days, 19:17:23",2013-02-06 10:08:17,2013-02-06 10:08:17,2013-03-02 05:25:40,5149
263,2001,3076,5340,"23 days, 19:17:26",2013-02-06 10:08:14,2013-02-06 10:08:14,2013-03-02 05:25:40,8720
86,3972,3922,7980,"23 days, 19:17:32",2013-02-06 10:08:08,2013-02-06 10:08:08,2013-03-02 05:25:40,6951
227,8253,5765,14245,"23 days, 19:17:57",2013-02-06 10:07:43,2013-02-06 10:07:43,2013-03-02 05:25:40,9161
112,7094,6429,13635,"23 days, 19:18:03",2013-02-06 10:07:37,2013-02-06 10:07:37,2013-03-02 05:25:40,3650
1277,3479,3351,8107,"23 days, 19:18:08",2013-02-06 10:07:32,2013-02-06 10:07:32,2013-03-02 05:25:40,2489
150,247,552,949,"23 days, 19:18:29",2013-02-06 10:07:11,2013-02-06 10:07:11,2013-03-02 05:25:40,1530
259,6424,5561,12244,"23 days, 19:18:43",2013-02-06 10:06:57,2013-02-06 10:06:57,2013-03-02 05:25:40,1260
520,7939,7578,16037,"23 days, 19:19:22",2013-02-06 10:06:18,2013-02-06 10:06:18,2013-03-02 05:25:40,2840
562,3251,5148,8961,"23 days, 19:20:17",2013-02-06 10:05:23,2013-02-06 10:05:23,2013-03-02 05:25:40,941
377,5748,6069,12194,"23 days, 19:20:51",2013-02-08 04:01:58,2010-02-01 10:32:08,2010-02-25 05:52:59,7914
902,2886,3571,7359,"23 days, 19:21:35",2013-02-06 10:04:05,2013-02-06 10:04:05,2013-03-02 05:25:40,2253
1085,5575,6790,13450,"23 days, 19:22:34",2013-02-06 10:03:06,2013-02-06 10:03:06,2013-03-02 05:25:40,2560
1333,6231,4056,11620,"23 days, 19:22:49",2013-02-06 10:02:51,2013-02-06 10:02:51,2013-03-02 05:25:40,7470
1507,7292,6777,15576,"23 days, 19:23:09",2013-02-06 10:02:31,2013-02-06 10:02:31,2013-03-02 05:25:40,3610
1148,1867,3586,6601,"23 days, 19:23:41",2013-02-06 10:01:59,2013-02-06 10:01:59,2013-03-02 05:25:40,9094
2324,3029,5294,10647,"23 days, 19:24:55",2013-02-06 10:00:45,2013-02-06 10:00:45,2013-03-02 05:25:40,9019
25,1546,3063,4634,"23 days, 19:25:10",2013-02-06 10:00:30,2013-02-06 10:00:30,2013-03-02 05:25:40,2260
49,2367,2959,5375,"23 days, 19:26:39",2013-02-06 09:59:01,2013-02-06 09:59:01,2013-03-02 05:25:40,6109
519,2321,2914,5754,"23 days, 19:26:45",2013-02-06 09:58:55,2013-02-06 09:58:55,2013-03-02 05:25:40,1198
907,4748,4428,10083,"23 days, 19:27:20",2013-02-06 09:58:20,2013-02-06 09:58:20,2013-03-02 05:25:40,1512
1189,5616,7564,14369,"23 days, 19:27:47",2013-02-06 09:57:53,2013-02-06 09:57:53,2013-03-02 05:25:40,4659
2230,9806,7779,19815,"23 days, 19:27:56",2013-02-06 09:57:44,2013-02-06 09:57:44,2013-03-02 05:25:40,7132
144,7359,6985,14488,"23 days, 19:28:23",2013-02-06 09:57:17,2013-02-06 09:57:17,2013-03-02 05:25:40,4919
20,2017,2167,4204,"23 days, 19:28:25",2013-02-06 09:57:15,2013-02-06 09:57:15,2013-03-02 05:25:40,7051
659,1529,2167,4355,"23 days, 19:28:25",2013-02-06 09:57:15,2013-02-06 09:57:15,2013-03-02 05:25:40,2638
686,6753,4930,12369,"23 days, 19:28:49",2013-02-06 09:56:51,2013-02-06 09:56:51,2013-03-02 05:25:40,426
253,1470,2604,4327,"23 days, 19:29:07",2013-02-06 09:56:33,2013-02-06 09:56:33,2013-03-02 05:25:40,1636
918,1464,2657,5039,"23 days, 19:29:58",2013-02-06 09:55:42,2013-02-06 09:55:42,2013-03-02 05:25:40,9677
1001,1221,2793,5015,"23 days, 19:29:58",2013-02-06 09:55:42,2013-02-06 09:55:42,2013-03-02 05:25:40,2858
975,10755,8537,20267,"23 days, 19:30:01",2013-02-06 09:55:39,2013-02-06 09:55:39,2013-03-02 05:25:40,2879
235,1622,2384,4241,"23 days, 19:30:04",2013-02-06 09:55:36,2013-02-06 09:55:36,2013-03-02 05:25:40,970
52,3748,3565,7365,"23 days, 19:31:06",2013-02-06 09:54:34,2013-02-06 09:54:34,2013-03-02 05:25:40,9893
1094,1706,2337,5137,"23 days, 19:31:09",2013-02-06 09:54:31,2013-02-06 09:54:31,2013-03-02 05:25:40,364
101,1848,3167,5116,"23 days, 19:31:50",2013-02-06 09:53:50,2013-02-06 09:53:50,2013-03-02 05:25:40,1941
411,608,1315,2334,"23 days, 19:32:14",2013-02-06 09:53:26,2013-02-06 09:53:26,2013-03-02 05:25:40,1489
483,4576,3660,8719,"23 days, 19:32:14",2013-02-06 09:53:26,2013-02-06 09:53:26,2013-03-02 05:25:40,6278
576,5983,5011,11570,"23 days, 19:32:18",2013-02-06 09:53:22,2013-02-06 09:53:22,2013-03-02 05:25:40,755
208,8832,7976,17016,"23 days, 19:32:52",2013-02-06 09:52:48,2013-02-06 09:52:48,2013-03-02 05:25:40,8234
247,2037,2728,5012,"23 days, 19:33:27",2013-02-06 09:52:13,2013-02-06 09:52:13,2013-03-02 05:25:40,2581
876,4097,4245,9218,"23 days, 19:33:28",2013-02-06 09:52:12,2013-02-06 09:52:12,2013-03-02 05:25:40,10
3406,8172,7258,18836,"23 days, 19:33:52",2013-02-06 09:51:48,2013-02-06 09:51:48,2013-03-02 05:25:40,3107
913,1721,2975,5609,"23 days, 19:34:12",2013-02-06 09:51:28,2013-02-06 09:51:28,2013-03-02 05:25:40,7614
674,7844,3910,12428,"23 days, 19:34:52",2013-02-06 09:50:48,2013-02-06 09:50:48,2013-03-02 05:25:40,4868
798,4672,6447,11917,"23 days, 19:35:11",2013-02-06 09:50:29,2013-02-06 09:50:29,2013-03-02 05:25:40,9393
1358,1848,1759,4965,"23 days, 19:35:26",2013-02-06 09:50:14,2013-02-06 09:50:14,2013-03-02 05:25:40,8255
1766,2158,3125,7049,"23 days, 19:36:21",2013-02-06 09:49:19,2013-02-06 09:49:19,2013-03-02 05:25:40,1687
195,765,1591,2551,"23 days, 19:36:28",2013-02-06 09:49:12,2013-02-06 09:49:12,2013-03-02 05:25:40,3651
176,4332,4402,8910,"23 days, 19:36:48",2013-02-06 09:48:52,2013-02-06 09:48:52,2013-03-02 05:25:40,6008
540,2923,3767,7230,"23 days, 19:37:38",2013-02-06 09:48:02,2013-02-06 09:48:02,2013-03-02 05:25:40,1564
322,1558,1988,3868,"23 days, 19:38:13",2013-02-06 09:47:27,2013-02-06 09:47:27,2013-03-02 05:25:40,7016
741,7132,5347,13220,"23 days, 19:38:22",2013-02-06 09:47:18,2013-02-06 09:47:18,2013-03-02 05:25:40,4767
396,9093,6917,16406,"23 days, 19:38:35",2013-02-06 09:47:05,2013-02-06 09:47:05,2013-03-02 05:25:40,4831
919,5030,4786,10735,"23 days, 19:39:32",2013-02-06 09:46:08,2013-02-06 09:46:08,2013-03-02 05:25:40,7741
263,855,1671,2789,"23 days, 19:39:40",2013-02-06 09:46:00,2013-02-06 09:46:00,2013-03-02 05:25:40,6292
2260,4035,4365,10660,"23 days, 19:40:39",2013-02-06 09:45:01,2013-02-06 09:45:01,2013-03-02 05:25:40,4768
703,763,1412,2878,"23 days, 19:42:07",2013-02-06 09:43:33,2013-02-06 09:43:33,2013-03-02 05:25:40,9328
283,5849,6758,12890,"23 days, 19:42:48",2013-02-06 09:42:52,2013-02-06 09:42:52,2013-03-02 05:25:40,9124
403,3479,3155,7037,"23 days, 19:43:04",2013-02-06 09:42:36,2013-02-06 09:42:36,2013-03-02 05:25:40,5720
1057,8295,8396,17748,"23 days, 19:43:32",2013-02-06 09:42:08,2013-02-06 09:42:08,2013-03-02 05:25:40,3902
1420,5365,6765,13550,"23 days, 19:43:43",2013-02-06 09:41:57,2013-02-06 09:41:57,2013-03-02 05:25:40,8533
542,4419,5989,10950,"23 days, 19:43:49",2013-02-06 09:41:51,2013-02-06 09:41:51,2013-03-02 05:25:40,1325
921,3061,4082,8064,"23 days, 19:44:08",2013-02-06 09:41:32,2013-02-06 09:41:32,2013-03-02 05:25:40,9209
73,3409,3687,7169,"23 days, 19:44:09",2013-02-06 09:41:31,2013-02-06 09:41:31,2013-03-02 05:25:40,6897
138,2489,2439,5066,"23 days, 19:44:50",2013-02-06 09:40:50,2013-02-06 09:40:50,2013-03-02 05:25:40,2958
18,662,1675,2355,"23 days, 19:44:53",2013-02-06 09:40:47,2013-02-06 09:40:47,2013-03-02 05:25:40,5693
1268,7153,5206,13627,"23 days, 19:44:55",2013-02-06 09:40:45,2013-02-06 09:40:45,2013-03-02 05:25:40,1756
1791,4615,5574,11980,"23 days, 19:45:41",2013-02-06 09:39:59,2013-02-06 09:39:59,2013-03-02 05:25:40,9532
153,1438,2676,4267,"23 days, 19:45:49",2013-02-06 09:39:51,2013-02-06 09:39:51,2013-03-02 05:25:40,8920
319,1584,2516,4419,"23 days, 19:46:07",2013-02-06 09:39:33,2013-02-06 09:39:33,2013-03-02 05:25:40,6501
285,1522,1936,3743,"23 days, 19:46:24",2013-02-06 09:39:16,2013-02-06 09:39:16,2013-03-02 05:25:40,8100
434,955,1704,3093,"23 days, 19:46:49",2013-02-06 09:38:51,2013-02-06 09:38:51,2013-03-02 05:25:40,6656
186,1412,2174,3772,"23 days, 19:47:44",2013-02-06 09:37:56,2013-02-06 09:37:56,2013-03-02 05:25:40,9903
1270,1863,2087,5220,"23 days, 19:47:48",2013-02-06 09:37:52,2013-02-06 09:37:52,2013-03-02 05:25:40,8840
1477,3747,5442,10666,"23 days, 19:47:55",2013-02-06 09:37:45,2013-02-06 09:37:45,2013-03-02 05:25:40,4523
943,7217,6355,14515,"23 days, 19:48:05",2013-02-06 09:37:35,2013-02-06 09:37:35,2013-03-02 05:25:40,789
1376,1386,1985,4747,"23 days, 19:48:54",2013-02-06 09:36:46,2013-02-06 09:36:46,2013-03-02 05:25:40,4183
468,4262,5853,10583,"23 days, 19:49:10",2013-02-06 09:36:30,2013-02-06 09:36:30,2013-03-02 05:25:40,5187
1231,5246,5269,11746,"23 days, 19:49:11",2013-02-06 09:36:29,2013-02-06 09:36:29,2013-03-02 05:25:40,2460
970,1272,2182,4424,"23 days, 19:49:12",2013-02-06 09:36:28,2013-02-06 09:36:28,2013-03-02 05:25:40,1269
259,1658,2043,3960,"23 days, 19:50:43",2013-02-06 09:34:57,2013-02-06 09:34:57,2013-03-02 05:25:40,1437
1130,7967,8327,17424,"23 days, 19:50:52",2013-02-06 09:34:48,2013-02-06 09:34:48,2013-03-02 05:25:40,8765
164,2302,3739,6205,"23 days, 19:51:14",2013-02-06 09:34:26,2013-02-06 09:34:26,2013-03-02 05:25:40,5040
30,2302,2826,5158,"23 days, 19:51:26",2013-02-06 09:34:14,2013-02-06 09:34:14,2013-03-02 05:25:40,9338
429,3270,4532,8231,"23 days, 19:51:50",2013-02-06 09:33:50,2013-02-06 09:33:50,2013-03-02 05:25:40,8491
1944,1187,2238,5369,"23 days, 19:52:01",2013-02-06 09:33:39,2013-02-06 09:33:39,2013-03-02 05:25:40,8037
777,854,1681,3312,"23 days, 19:52:38",2013-02-06 09:33:02,2013-02-06 09:33:02,2013-03-02 05:25:40,3145
761,2190,2548,5499,"23 days, 19:52:39",2013-02-06 09:33:01,2013-02-06 09:33:01,2013-03-02 05:25:40,479
136,3462,4138,7736,"23 days, 19:53:03",2013-02-06 09:32:37,2013-02-06 09:32:37,2013-03-02 05:25:40,6021
1864,2523,3231,7618,"23 days, 19:53:07",2013-02-06 09:32:33,2013-02-06 09:32:33,2013-03-02 05:25:40,9148
658,1832,3016,5506,"23 days, 19:54:37",2013-02-06 09:31:03,2013-02-06 09:31:03,2013-03-02 05:25:40,8698
542,2461,3043,6046,"23 days, 19:55:09",2013-02-06 09:30:31,2013-02-06 09:30:31,2013-03-02 05:25:40,7350
1216,3441,3231,7888,"23 days, 19:55:57",2013-02-06 09:29:43,2013-02-06 09:29:43,2013-03-02 05:25:40,5020
205,2936,3269,6410,"23 days, 19:56:07",2013-02-06 09:29:33,2013-02-06 09:29:33,2013-03-02 05:25:40,8248
1436,6319,6759,14514,"23 days, 19:56:16",2013-02-06 09:29:24,2013-02-06 09:29:24,2013-03-02 05:25:40,7327
850,5739,6673,13262,"23 days, 19:56:21",2013-02-06 09:29:19,2013-02-06 09:29:19,2013-03-02 05:25:40,6305
140,2741,3738,6619,"23 days, 19:56:44",2013-02-06 09:28:56,2013-02-06 09:28:56,2013-03-02 05:25:40,8876
1186,4416,6455,12057,"23 days, 19:56:52",2013-02-06 09:28:48,2013-02-06 09:28:48,2013-03-02 05:25:40,7795
1392,2455,3145,6992,"23 days, 19:57:11",2013-02-06 09:28:29,2013-02-06 09:28:29,2013-03-02 05:25:40,5874
92,1353,2240,3685,"23 days, 19:58:26",2013-02-06 09:27:14,2013-02-06 09:27:14,2013-03-02 05:25:40,4524
423,3913,4321,8657,"23 days, 19:59:27",2013-02-06 09:26:13,2013-02-06 09:26:13,2013-03-02 05:25:40,7384
1229,2710,3884,7823,"23 days, 20:00:15",2013-02-06 09:25:25,2013-02-06 09:25:25,2013-03-02 05:25:40,7777
62,6661,5764,12487,"23 days, 20:00:20",2013-02-06 09:25:20,2013-02-06 09:25:20,2013-03-02 05:25:40,7201
165,1674,2687,4526,"23 days, 20:01:53",2013-02-06 09:23:47,2013-02-06 09:23:47,2013-03-02 05:25:40,1877
1655,5412,6546,13613,"23 days, 20:02:31",2013-02-06 09:23:09,2013-02-06 09:23:09,2013-03-02 05:25:40,1475
178,2255,3064,5497,"23 days, 20:02:50",2013-02-06 09:22:50,2013-02-06 09:22:50,2013-03-02 05:25:40,9081
197,4666,6501,11364,"23 days, 20:03:12",2013-02-06 09:22:28,2013-02-06 09:22:28,2013-03-02 05:25:40,7929
501,5691,8452,14644,"23 days, 20:03:19",2013-02-06 09:22:21,2013-02-06 09:22:21,2013-03-02 05:25:40,6379
1625,6566,5397,13588,"23 days, 20:03:21",2013-02-06 09:22:19,2013-02-06 09:22:19,2013-03-02 05:25:40,5615
223,2601,2221,5045,"23 days, 20:03:24",2013-02-06 09:22:16,2013-02-06 09:22:16,2013-03-02 05:25:40,8259
378,1352,1119,2849,"23 days, 20:03:51",2013-02-06 09:21:49,2013-02-06 09:21:49,2013-03-02 05:25:40,6815
66,1704,1309,3079,"23 days, 20:04:08",2013-02-06 09:21:32,2013-02-06 09:21:32,2013-03-02 05:25:40,108
1029,1272,1237,3538,"23 days, 20:04:42",2013-02-06 09:20:58,2013-02-06 09:20:58,2013-03-02 05:25:40,1927
516,3922,3742,8180,"23 days, 20:06:29",2013-02-06 09:19:11,2013-02-06 09:19:11,2013-03-02 05:25:40,8290
1198,2965,3720,7883,"23 days, 20:06:31",2013-02-06 09:19:09,2013-02-06 09:19:09,2013-03-02 05:25:40,9191
683,1383,1808,3874,"23 days, 20:06:47",2013-02-07 05:37:24,2010-03-03 05:29:37,2010-03-27 01:36:24,6898
418,6792,8114,15324,"23 days, 20:07:44",2013-02-07 08:25:38,2010-02-01 10:32:08,2010-02-25 06:39:52,5849
1541,253,951,2745,"23 days, 20:07:58",2013-02-06 09:17:42,2013-02-06 09:17:42,2013-03-02 05:25:40,3750
307,1461,2628,4396,"23 days, 20:09:18",2013-02-06 09:16:22,2013-02-06 09:16:22,2013-03-02 05:25:40,4678
69,3443,3904,7416,"23 days, 20:09:30",2013-02-06 09:16:10,2013-02-06 09:16:10,2013-03-02 05:25:40,1197
780,3420,3992,8192,"23 days, 20:09:35",2013-02-06 09:16:05,2013-02-06 09:16:05,2013-03-02 05:25:40,9886
51,809,1509,2369,"23 days, 20:09:55",2013-02-06 09:15:45,2013-02-06 09:15:45,2013-03-02 05:25:40,9106
37,4592,4663,9292,"23 days, 20:10:47",2013-02-06 09:14:53,2013-02-06 09:14:53,2013-03-02 05:25:40,9219
2923,5520,7832,16275,"23 days, 20:10:51",2013-02-06 09:14:49,2013-02-06 09:14:49,2013-03-02 05:25:40,8793
83,5121,7729,12933,"23 days, 20:10:57",2013-02-06 09:14:43,2013-02-06 09:14:43,2013-03-02 05:25:40,271
1692,2594,4959,9245,"23 days, 20:11:50",2013-02-06 09:13:50,2013-02-06 09:13:50,2013-03-02 05:25:40,1700
289,1389,1949,3627,"23 days, 20:12:07",2013-02-06 09:13:33,2013-02-06 09:13:33,2013-03-02 05:25:40,6219
417,3731,6387,10535,"23 days, 20:14:29",2013-02-06 09:11:11,2013-02-06 09:11:11,2013-03-02 05:25:40,4816
1222,3068,3784,8074,"23 days, 20:15:31",2013-02-06 09:10:09,2013-02-06 09:10:09,2013-03-02 05:25:40,4838
662,2741,3472,6875,"23 days, 20:15:56",2013-02-06 09:09:44,2013-02-06 09:09:44,2013-03-02 05:25:40,9401
50,1848,3451,5349,"23 days, 20:16:16",2013-02-06 09:09:24,2013-02-06 09:09:24,2013-03-02 05:25:40,5758
322,9399,7494,17215,"23 days, 20:16:34",2013-02-06 09:09:06,2013-02-06 09:09:06,2013-03-02 05:25:40,5133
709,243,604,1556,"23 days, 20:17:51",2013-02-06 09:07:49,2013-02-06 09:07:49,2013-03-02 05:25:40,1716
304,7603,6367,14274,"23 days, 20:18:07",2013-02-06 09:07:33,2013-02-06 09:07:33,2013-03-02 05:25:40,7667
2625,5098,6195,13918,"23 days, 20:18:52",2013-02-06 09:06:48,2013-02-06 09:06:48,2013-03-02 05:25:40,9097
293,1525,2465,4283,"23 days, 20:19:30",2013-02-06 09:06:10,2013-02-06 09:06:10,2013-03-02 05:25:40,2082
2033,4440,5181,11654,"23 days, 20:19:48",2013-02-06 09:05:52,2013-02-06 09:05:52,2013-03-02 05:25:40,9825
382,979,1559,2920,"23 days, 20:20:18",2013-02-06 09:05:22,2013-02-06 09:05:22,2013-03-02 05:25:40,358
1294,3507,4961,9762,"23 days, 20:21:12",2013-02-06 09:04:28,2013-02-06 09:04:28,2013-03-02 05:25:40,1096
1776,7657,6721,16154,"23 days, 20:21:44",2013-02-06 09:03:56,2013-02-06 09:03:56,2013-03-02 05:25:40,8677
845,10064,7283,18192,"23 days, 20:22:29",2013-02-06 09:03:11,2013-02-06 09:03:11,2013-03-02 05:25:40,938
715,2140,3486,6341,"23 days, 20:22:30",2013-02-06 09:03:10,2013-02-06 09:03:10,2013-03-02 05:25:40,9681
1110,4771,4748,10629,"23 days, 20:23:19",2013-02-06 09:02:21,2013-02-06 09:02:21,2013-03-02 05:25:40,3570
147,5051,3875,9073,"23 days, 20:23:40",2013-02-06 09:02:00,2013-02-06 09:02:00,2013-03-02 05:25:40,3271
1378,3883,4328,9589,"23 days, 20:24:09",2013-02-07 03:19:37,2010-02-01 10:32:08,2010-02-25 06:56:17,3154
346,7801,6954,15101,"23 days, 20:24:40",2013-02-06 09:01:00,2013-02-06 09:01:00,2013-03-02 05:25:40,568
331,6017,6207,12555,"23 days, 20:26:17",2013-02-06 08:59:23,2013-02-06 08:59:23,2013-03-02 05:25:40,3444
721,3614,6467,10802,"23 days, 20:26:56",2013-02-06 08:58:44,2013-02-06 08:58:44,2013-03-02 05:25:40,8325
397,831,2222,3450,"23 days, 20:28:08",2013-02-06 08:57:32,2013-02-06 08:57:32,2013-03-02 05:25:40,7511
1004,3793,4977,9774,"23 days, 20:28:35",2013-02-06 08:57:05,2013-02-06 08:57:05,2013-03-02 05:25:40,8108
501,235,585,1321,"23 days, 20:28:37",2013-02-07 04:35:16,2010-02-08 04:33:26,2010-03-04 01:02:03,3753
124,1059,2035,3218,"23 days, 20:28:44",2013-02-06 08:56:56,2013-02-06 08:56:56,2013-03-02 05:25:40,1376
1872,806,1072,3750,"23 days, 20:28:56",2013-02-06 08:56:44,2013-02-06 08:56:44,2013-03-02 05:25:40,3712
184,1058,1126,2368,"23 days, 20:28:57",2013-02-06 08:56:43,2013-02-06 08:56:43,2013-03-02 05:25:40,8536
147,3683,3986,7816,"23 days, 20:29:41",2013-02-06 08:55:59,2013-02-06 08:55:59,2013-03-02 05:25:40,7479
56,3286,3097,6439,"23 days, 20:31:19",2013-02-06 08:54:21,2013-02-06 08:54:21,2013-03-02 05:25:40,4778
23,3728,3523,7274,"23 days, 20:31:44",2013-02-06 08:53:56,2013-02-06 08:53:56,2013-03-02 05:25:40,8858
270,5560,6563,12393,"23 days, 20:31:46",2013-02-06 08:53:54,2013-02-06 08:53:54,2013-03-02 05:25:40,304
48,2633,2430,5111,"23 days, 20:31:52",2013-02-06 08:53:48,2013-02-06 08:53:48,2013-03-02 05:25:40,2067
1307,8163,6939,16409,"23 days, 20:32:24",2013-02-06 08:53:16,2013-02-06 08:53:16,2013-03-02 05:25:40,3437
287,2841,4089,7217,"23 days, 20:33:43",2013-02-06 08:51:57,2013-02-06 08:51:57,2013-03-02 05:25:40,2180
2362,7818,5838,16018,"23 days, 20:34:24",2013-02-06 08:51:16,2013-02-06 08:51:16,2013-03-02 05:25:40,6186
1760,6641,5461,13862,"23 days, 20:35:39",2013-02-06 08:50:01,2013-02-06 08:50:01,2013-03-02 05:25:40,6333
22,729,1645,2396,"23 days, 20:36:02",2013-02-06 08:49:38,2013-02-06 08:49:38,2013-03-02 05:25:40,5120
777,2339,3960,7076,"23 days, 20:37:02",2013-02-06 08:48:38,2013-02-06 08:48:38,2013-03-02 05:25:40,2424
503,6011,6567,13081,"23 days, 20:38:10",2013-02-06 08:47:30,2013-02-06 08:47:30,2013-03-02 05:25:40,7185
1079,922,1195,3196,"23 days, 20:38:10",2013-02-06 10:04:44,2010-02-01 10:32:08,2010-02-25 07:10:18,3598
918,528,1629,3075,"23 days, 20:40:11",2013-02-06 08:45:29,2013-02-06 08:45:29,2013-03-02 05:25:40,7236
1144,4790,5242,11176,"23 days, 20:40:18",2013-02-06 08:45:22,2013-02-06 08:45:22,2013-03-02 05:25:40,3344
948,9705,6763,17416,"23 days, 20:40:18",2013-02-06 08:45:22,2013-02-06 08:45:22,2013-03-02 05:25:40,8235
73,3513,5069,8655,"23 days, 20:41:14",2013-02-06 08:44:26,2013-02-06 08:44:26,2013-03-02 05:25:40,1966
234,2961,3648,6843,"23 days, 20:41:14",2013-02-06 08:44:26,2013-02-06 08:44:26,2013-03-02 05:25:40,9599
445,4531,2878,7854,"23 days, 20:41:59",2013-02-06 08:43:41,2013-02-06 08:43:41,2013-03-02 05:25:40,8962
2578,5820,9303,17701,"23 days, 20:42:16",2013-02-06 08:43:24,2013-02-06 08:43:24,2013-03-02 05:25:40,5655
572,5444,4264,10280,"23 days, 20:43:01",2013-02-06 09:37:23,2010-02-01 10:32:08,2010-02-25 07:15:09,8199
297,2008,2974,5279,"23 days, 20:43:12",2013-02-06 08:42:28,2013-02-06 08:42:28,2013-03-02 05:25:40,956
86,6640,5874,12600,"23 days, 20:43:37",2013-02-07 11:56:03,2010-02-01 10:32:08,2010-02-25 07:15:45,9076
749,7177,7339,15265,"23 days, 20:44:16",2013-02-06 08:41:24,2013-02-06 08:41:24,2013-03-02 05:25:40,1653
748,1494,3209,5451,"23 days, 20:44:18",2013-02-06 08:41:22,2013-02-06 08:41:22,2013-03-02 05:25:40,7254
1086,2529,3259,6874,"23 days, 20:45:19",2013-02-06 08:40:21,2013-02-06 08:40:21,2013-03-02 05:25:40,3177
979,3842,3565,8386,"23 days, 20:45:58",2013-02-06 08:39:42,2013-02-06 08:39:42,2013-03-02 05:25:40,456
1191,677,1019,2887,"23 days, 20:46:04",2013-02-06 08:39:36,2013-02-06 08:39:36,2013-03-02 05:25:40,7018
190,720,1287,2197,"23 days, 20:46:52",2013-02-06 08:38:48,2013-02-06 08:38:48,2013-03-02 05:25:40,7390
163,3803,3370,7336,"23 days, 20:46:58",2013-02-06 08:38:42,2013-02-06 08:38:42,2013-03-02 05:25:40,3812
292,2654,3507,6453,"23 days, 20:47:07",2013-02-06 08:38:33,2013-02-06 08:38:33,2013-03-02 05:25:40,5177
1132,5227,8909,15268,"23 days, 20:48:00",2013-02-06 08:37:40,2013-02-06 08:37:40,2013-03-02 05:25:40,1491
758,7523,5991,14272,"23 days, 20:48:27",2013-02-06 08:37:13,2013-02-06 08:37:13,2013-03-02 05:25:40,4005
554,4210,4335,9099,"23 days, 20:48:44",2013-02-06 08:36:56,2013-02-06 08:36:56,2013-03-02 05:25:40,2098
36,1246,2336,3618,"23 days, 20:49:14",2013-02-06 08:36:26,2013-02-06 08:36:26,2013-03-02 05:25:40,1228
2003,7630,6620,16253,"23 days, 20:49:34",2013-02-06 08:36:06,2013-02-06 08:36:06,2013-03-02 05:25:40,5838
351,1003,1174,2528,"23 days, 20:49:50",2013-02-07 05:27:43,2010-02-01 10:32:08,2010-02-25 07:21:58,1640
1602,1570,1821,4993,"23 days, 20:50:01",2013-02-06 08:35:39,2013-02-06 08:35:39,2013-03-02 05:25:40,3221
1866,1850,3576,7292,"23 days, 20:51:03",2013-02-06 08:34:37,2013-02-06 08:34:37,2013-03-02 05:25:40,2843
24,1424,1180,2628,"23 days, 20:51:38",2013-02-21 11:27:49,2010-02-01 10:32:08,2010-02-25 07:23:46,1634
966,2780,3695,7441,"23 days, 20:51:45",2013-02-06 08:33:55,2013-02-06 08:33:55,2013-03-02 05:25:40,6512
55,757,1204,2016,"23 days, 20:51:56",2013-02-06 08:33:44,2013-02-06 08:33:44,2013-03-02 05:25:40,8731
1085,6708,9588,17381,"23 days, 20:52:03",2013-02-06 08:33:37,2013-02-06 08:33:37,2013-03-02 05:25:40,40
442,1793,2938,5173,"23 days, 20:52:37",2013-02-06 08:33:03,2013-02-06 08:33:03,2013-03-02 05:25:40,1641
915,3905,5519,10339,"23 days, 20:52:49",2013-02-06 08:32:51,2013-02-06 08:32:51,2013-03-02 05:25:40,6938
50,1918,2746,4714,"23 days, 20:52:50",2013-02-06 08:32:50,2013-02-06 08:32:50,2013-03-02 05:25:40,5291
83,709,1201,1993,"23 days, 20:53:31",2013-02-06 08:32:09,2013-02-06 08:32:09,2013-03-02 05:25:40,4954
253,6538,4717,11508,"23 days, 20:53:37",2013-02-06 08:32:03,2013-02-06 08:32:03,2013-03-02 05:25:40,7708
650,7185,6370,14205,"23 days, 20:53:53",2013-02-07 00:05:22,2010-02-01 10:32:08,2010-02-25 07:26:01,2321
244,3233,5190,8667,"23 days, 20:54:54",2013-02-06 08:30:46,2013-02-06 08:30:46,2013-03-02 05:25:40,9996
908,5959,7709,14576,"23 days, 20:56:09",2013-02-06 08:29:31,2013-02-06 08:29:31,2013-03-02 05:25:40,2200
195,3493,5343,9031,"23 days, 20:57:26",2013-02-07 05:42:48,2010-02-01 10:32:08,2010-02-25 07:29:34,2611
725,1452,2349,4526,"23 days, 20:57:36",2013-02-06 08:28:04,2013-02-06 08:28:04,2013-03-02 05:25:40,7062
53,355,944,1352,"23 days, 20:59:21",2013-02-06 08:26:19,2013-02-06 08:26:19,2013-03-02 05:25:40,7066
699,1174,1876,3749,"23 days, 21:00:40",2013-02-06 08:25:00,2013-02-06 08:25:00,2013-03-02 05:25:40,450
862,3691,5261,9814,"23 days, 21:00:58",2013-02-06 08:24:42,2013-02-06 08:24:42,2013-03-02 05:25:40,6914
469,2049,2610,5128,"23 days, 21:01:31",2013-02-06 08:24:09,2013-02-06 08:24:09,2013-03-02 05:25:40,342
563,3498,4383,8444,"23 days, 21:02:15",2013-02-06 08:23:25,2013-02-06 08:23:25,2013-03-02 05:25:40,1506
139,950,1359,2448,"23 days, 21:03:11",2013-02-06 08:22:29,2013-02-06 08:22:29,2013-03-02 05:25:40,5427
36,4573,5279,9888,"23 days, 21:03:21",2013-02-06 08:22:19,2013-02-06 08:22:19,2013-03-02 05:25:40,3977
1826,4918,4160,10904,"23 days, 21:03:45",2013-02-06 08:21:55,2013-02-06 08:21:55,2013-03-02 05:25:40,7364
213,1270,2438,3921,"23 days, 21:03:58",2013-02-06 08:21:42,2013-02-06 08:21:42,2013-03-02 05:25:40,7993
1035,3800,4472,9307,"23 days, 21:04:11",2013-02-06 08:21:29,2013-02-06 08:21:29,2013-03-02 05:25:40,9558
159,2447,3479,6085,"23 days, 21:04:47",2013-02-06 08:20:53,2013-02-06 08:20:53,2013-03-02 05:25:40,4541
125,6667,8761,15553,"23 days, 21:06:36",2013-02-06 08:19:04,2013-02-06 08:19:04,2013-03-02 05:25:40,7974
332,1974,3287,5593,"23 days, 21:07:34",2013-02-06 08:18:06,2013-02-06 08:18:06,2013-03-02 05:25:40,7700
1611,2857,3918,8386,"23 days, 21:08:18",2013-02-06 08:17:22,2013-02-06 08:17:22,2013-03-02 05:25:40,882
333,4451,4708,9492,"23 days, 21:08:32",2013-02-06 08:17:08,2013-02-06 08:17:08,2013-03-02 05:25:40,6113
1189,3996,5774,10959,"23 days, 21:08:35",2013-02-06 08:17:05,2013-02-06 08:17:05,2013-03-02 05:25:40,6302
1063,2800,2712,6575,"23 days, 21:09:59",2013-02-06 08:15:41,2013-02-06 08:15:41,2013-03-02 05:25:40,7301
1776,9767,7984,19527,"23 days, 21:11:46",2013-02-06 08:13:54,2013-02-06 08:13:54,2013-03-02 05:25:40,225
211,2505,3155,5871,"23 days, 21:11:58",2013-02-06 08:13:42,2013-02-06 08:13:42,2013-03-02 05:25:40,8874
844,2864,3979,7687,"23 days, 21:12:21",2013-02-06 08:13:19,2013-02-06 08:13:19,2013-03-02 05:25:40,5855
781,136,624,1541,"23 days, 21:12:37",2013-02-06 08:13:03,2013-02-06 08:13:03,2013-03-02 05:25:40,3012
750,5407,4413,10570,"23 days, 21:12:41",2013-02-06 08:12:59,2013-02-06 08:12:59,2013-03-02 05:25:40,3581
352,2290,2317,4959,"23 days, 21:14:54",2013-02-06 08:10:46,2013-02-06 08:10:46,2013-03-02 05:25:40,9914
997,980,1757,3734,"23 days, 21:15:27",2013-02-06 08:10:13,2013-02-06 08:10:13,2013-03-02 05:25:40,8510
24,1825,3141,4990,"23 days, 21:15:56",2013-02-06 08:09:44,2013-02-06 08:09:44,2013-03-02 05:25:40,4650
241,4025,4992,9258,"23 days, 21:16:33",2013-02-06 08:09:07,2013-02-06 08:09:07,2013-03-02 05:25:40,8490
1249,760,1605,3614,"23 days, 21:19:25",2013-02-06 08:06:15,2013-02-06 08:06:15,2013-03-02 05:25:40,1024
100,3661,4625,8386,"23 days, 21:19:51",2013-02-06 08:05:49,2013-02-06 08:05:49,2013-03-02 05:25:40,4417
405,598,1169,2172,"23 days, 21:20:36",2013-02-06 08:05:04,2013-02-06 08:05:04,2013-03-02 05:25:40,1970
560,6463,5786,12809,"23 days, 21:20:41",2013-02-06 08:04:59,2013-02-06 08:04:59,2013-03-02 05:25:40,5983
502,8193,9719,18414,"23 days, 21:21:14",2013-02-07 10:51:36,2010-02-01 10:32:08,2010-02-25 07:53:22,5732
812,333,609,1754,"23 days, 21:22:53",2013-02-06 08:02:47,2013-02-06 08:02:47,2013-03-02 05:25:40,4952
1092,2009,2617,5718,"23 days, 21:22:59",2013-02-06 08:02:41,2013-02-06 08:02:41,2013-03-02 05:25:40,69
347,228,500,1075,"23 days, 21:24:38",2013-02-06 08:01:02,2013-02-06 08:01:02,2013-03-02 05:25:40,6087
27,1499,2256,3782,"23 days, 21:25:43",2013-02-06 07:59:57,2013-02-06 07:59:57,2013-03-02 05:25:40,9142
27,1242,1143,2412,"23 days, 21:26:07",2013-02-06 07:59:33,2013-02-06 07:59:33,2013-03-02 05:25:40,8827
636,2564,3890,7090,"23 days, 21:26:38",2013-02-06 07:59:02,2013-02-06 07:59:02,2013-03-02 05:25:40,7853
910,2781,4137,7828,"23 days, 21:26:47",2013-02-06 07:58:53,2013-02-06 07:58:53,2013-03-02 05:25:40,911
2535,7715,8704,18954,"23 days, 21:27:28",2013-02-06 07:58:12,2013-02-06 07:58:12,2013-03-02 05:25:40,8051
1434,3512,4886,9832,"23 days, 21:28:31",2013-02-06 07:57:09,2013-02-06 07:57:09,2013-03-02 05:25:40,5478
651,2998,4533,8182,"23 days, 21:28:39",2013-02-06 07:57:01,2013-02-06 07:57:01,2013-03-02 05:25:40,7833
1055,1140,1347,3542,"23 days, 21:28:51",2013-02-07 08:03:35,2010-02-01 10:32:08,2010-02-25 08:00:59,9086
660,1077,1881,3618,"23 days, 21:28:55",2013-02-06 07:56:45,2013-02-06 07:56:45,2013-03-02 05:25:40,9909
1130,6948,6939,15017,"23 days, 21:29:04",2013-02-06 07:56:36,2013-02-06 07:56:36,2013-03-02 05:25:40,4030
534,1717,4034,6285,"23 days, 21:29:23",2013-02-06 07:56:17,2013-02-06 07:56:17,2013-03-02 05:25:40,2191
1732,4599,6277,12608,"23 days, 21:29:39",2013-02-06 07:56:01,2013-02-06 07:56:01,2013-03-02 05:25:40,325
2297,7417,6576,16290,"23 days, 21:30:38",2013-02-06 07:55:02,2013-02-06 07:55:02,2013-03-02 05:25:40,8178
1062,1109,2316,4487,"23 days, 21:31:24",2013-02-06 07:54:16,2013-02-06 07:54:16,2013-03-02 05:25:40,4967
809,775,1327,2911,"23 days, 21:32:07",2013-02-06 07:53:33,2013-02-06 07:53:33,2013-03-02 05:25:40,8277
456,6974,7356,14786,"23 days, 21:32:18",2013-02-06 07:53:22,2013-02-06 07:53:22,2013-03-02 05:25:40,8880
1477,7504,7890,16871,"23 days, 21:32:45",2013-02-06 07:52:55,2013-02-06 07:52:55,2013-03-02 05:25:40,8589
306,2534,4896,7736,"23 days, 21:33:25",2013-02-07 08:01:56,2010-02-01 10:32:08,2010-02-25 08:05:33,9079
989,3173,3103,7265,"23 days, 21:36:22",2013-02-06 07:49:18,2013-02-06 07:49:18,2013-03-02 05:25:40,359
1374,5085,6030,12489,"23 days, 21:36:43",2013-02-06 07:48:57,2013-02-06 07:48:57,2013-03-02 05:25:40,6237
2590,5788,6549,14927,"23 days, 21:38:04",2013-02-06 07:47:36,2013-02-06 07:47:36,2013-03-02 05:25:40,2305
1521,3952,3683,9156,"23 days, 21:38:32",2013-02-06 07:47:08,2013-02-06 07:47:08,2013-03-02 05:25:40,9659
1234,6737,7232,15203,"23 days, 21:38:42",2013-02-06 07:46:58,2013-02-06 07:46:58,2013-03-02 05:25:40,3903
326,3334,4138,7798,"23 days, 21:39:07",2013-02-06 07:46:33,2013-02-06 07:46:33,2013-03-02 05:25:40,1772
43,6430,5144,11617,"23 days, 21:40:13",2013-02-06 07:45:27,2013-02-06 07:45:27,2013-03-02 05:25:40,5042
1102,2752,3218,7072,"23 days, 21:40:36",2013-02-06 10:24:02,2010-02-13 10:29:31,2010-03-09 08:10:07,3447
149,6440,4608,11197,"23 days, 21:41:07",2013-02-06 07:44:33,2013-02-06 07:44:33,2013-03-02 05:25:40,1764
938,1912,3269,6119,"23 days, 21:45:06",2013-02-06 07:40:34,2013-02-06 07:40:34,2013-03-02 05:25:40,7415
102,1960,2042,4104,"23 days, 21:45:28",2013-02-06 07:40:12,2013-02-06 07:40:12,2013-03-02 05:25:40,5668
658,5916,6668,13242,"23 days, 21:45:53",2013-02-06 07:39:47,2013-02-06 07:39:47,2013-03-02 05:25:40,1628
1363,2630,3601,7594,"23 days, 21:47:37",2013-02-06 07:38:03,2013-02-06 07:38:03,2013-03-02 05:25:40,5287
163,2325,2389,4877,"23 days, 21:48:15",2013-02-06 07:37:25,2013-02-06 07:37:25,2013-03-02 05:25:40,8133
481,6777,5323,12581,"23 days, 21:48:24",2013-02-06 07:37:16,2013-02-06 07:37:16,2013-03-02 05:25:40,3699
181,7190,6306,13677,"23 days, 21:49:32",2013-02-06 07:36:08,2013-02-06 07:36:08,2013-03-02 05:25:40,5694
647,1365,2612,4624,"23 days, 21:50:43",2013-02-06 07:34:57,2013-02-06 07:34:57,2013-03-02 05:25:40,8446
555,8693,6830,16078,"23 days, 21:50:53",2013-02-06 07:34:47,2013-02-06 07:34:47,2013-03-02 05:25:40,3462
702,2098,4158,6958,"23 days, 21:50:58",2013-02-06 07:34:42,2013-02-06 07:34:42,2013-03-02 05:25:40,6286
488,845,1325,2658,"23 days, 21:51:19",2013-02-06 07:34:21,2013-02-06 07:34:21,2013-03-02 05:25:40,4742
2641,4080,6471,13192,"23 days, 21:52:16",2013-02-06 07:33:24,2013-02-06 07:33:24,2013-03-02 05:25:40,9362
1825,6252,5333,13410,"23 days, 21:52:40",2013-02-06 07:33:00,2013-02-06 07:33:00,2013-03-02 05:25:40,2839
43,931,1676,2650,"23 days, 21:52:47",2013-02-11 11:46:12,2010-02-01 10:32:08,2010-02-25 08:24:55,6650
19,3854,5548,9421,"23 days, 21:52:50",2013-02-06 07:32:50,2013-02-06 07:32:50,2013-03-02 05:25:40,8665
67,2637,4972,7676,"23 days, 21:52:59",2013-02-06 07:32:41,2013-02-06 07:32:41,2013-03-02 05:25:40,8695
569,1135,2802,4506,"23 days, 21:53:36",2013-02-06 07:32:04,2013-02-06 07:32:04,2013-03-02 05:25:40,4639
288,5774,5551,11613,"23 days, 21:54:08",2013-02-07 08:32:44,2010-02-01 10:32:08,2010-02-25 08:26:16,3735
1148,7989,7404,16541,"23 days, 21:55:12",2013-02-06 07:30:28,2013-02-06 07:30:28,2013-03-02 05:25:40,8004
477,3966,4581,9024,"23 days, 21:57:06",2013-02-06 07:28:34,2013-02-06 07:28:34,2013-03-02 05:25:40,5415
1062,3329,5100,9491,"23 days, 21:57:45",2013-02-06 07:27:55,2013-02-06 07:27:55,2013-03-02 05:25:40,2734
842,4249,5219,10310,"23 days, 21:58:40",2013-02-06 07:27:00,2013-02-06 07:27:00,2013-03-02 05:25:40,4871
401,1369,2135,3905,"23 days, 21:59:05",2013-02-06 07:26:35,2013-02-06 07:26:35,2013-03-02 05:25:40,3943
257,2645,3966,6868,"23 days, 21:59:30",2013-02-06 07:26:10,2013-02-06 07:26:10,2013-03-02 05:25:40,8667
1477,3734,3659,8870,"23 days, 21:59:39",2013-02-06 07:26:01,2013-02-06 07:26:01,2013-03-02 05:25:40,3348
417,983,1738,3138,"23 days, 21:59:43",2013-02-06 07:25:57,2013-02-06 07:25:57,2013-03-02 05:25:40,9545
986,1353,2600,4939,"23 days, 21:59:55",2013-02-06 07:25:45,2013-02-06 07:25:45,2013-03-02 05:25:40,6349
874,332,540,1746,"23 days, 22:00:32",2013-02-06 07:25:08,2013-02-06 07:25:08,2013-03-02 05:25:40,8847
1056,3825,4963,9844,"23 days, 22:00:49",2013-02-06 07:24:51,2013-02-06 07:24:51,2013-03-02 05:25:40,4793
1312,1534,2317,5163,"23 days, 22:01:32",2013-02-06 07:24:08,2013-02-06 07:24:08,2013-03-02 05:25:40,4996
764,8550,8145,17459,"23 days, 22:02:09",2013-02-06 07:23:31,2013-02-06 07:23:31,2013-03-02 05:25:40,6484
49,2030,2392,4471,"23 days, 22:03:18",2013-02-06 07:22:22,2013-02-06 07:22:22,2013-03-02 05:25:40,5624
140,2042,2866,5048,"23 days, 22:03:18",2013-02-06 07:22:22,2013-02-06 07:22:22,2013-03-02 05:25:40,1581
706,7842,5705,14253,"23 days, 22:03:51",2013-02-07 00:28:26,2010-02-01 10:32:08,2010-02-25 08:35:59,1151
345,617,1570,2532,"23 days, 22:05:01",2013-02-06 07:20:39,2013-02-06 07:20:39,2013-03-02 05:25:40,1726
825,2625,2796,6246,"23 days, 22:05:21",2013-02-06 07:20:19,2013-02-06 07:20:19,2013-03-02 05:25:40,674
909,1759,3385,6053,"23 days, 22:06:23",2013-02-06 07:19:17,2013-02-06 07:19:17,2013-03-02 05:25:40,693
303,4343,5357,10003,"23 days, 22:08:03",2013-02-06 07:17:37,2013-02-06 07:17:37,2013-03-02 05:25:40,9315
946,3499,4350,8795,"23 days, 22:08:26",2013-02-09 06:17:40,2010-02-01 10:32:08,2010-02-25 08:40:34,6642
487,11259,6872,18618,"23 days, 22:08:37",2013-02-06 07:17:03,2013-02-06 07:17:03,2013-03-02 05:25:40,9603
489,2724,2549,5762,"23 days, 22:08:43",2013-02-06 07:16:57,2013-02-06 07:16:57,2013-03-02 05:25:40,7653
539,7037,8042,15618,"23 days, 22:08:55",2013-02-06 07:16:45,2013-02-06 07:16:45,2013-03-02 05:25:40,1750
1212,1815,2362,5389,"23 days, 22:10:14",2013-02-06 07:15:26,2013-02-06 07:15:26,2013-03-02 05:25:40,423
708,6585,8816,16109,"23 days, 22:11:14",2013-02-06 07:14:26,2013-02-06 07:14:26,2013-03-02 05:25:40,1148
1164,4828,5235,11227,"23 days, 22:12:16",2013-02-06 07:13:24,2013-02-06 07:13:24,2013-03-02 05:25:40,7198
165,5223,5123,10511,"23 days, 22:12:23",2013-02-06 07:13:17,2013-02-06 07:13:17,2013-03-02 05:25:40,5166
925,2254,1692,4871,"23 days, 22:13:21",2013-02-06 07:12:19,2013-02-06 07:12:19,2013-03-02 05:25:40,2044
165,4619,5647,10431,"23 days, 22:16:24",2013-02-06 07:09:16,2013-02-06 07:09:16,2013-03-02 05:25:40,6922
50,3063,3496,6609,"23 days, 22:16:33",2013-02-06 11:47:26,2010-02-01 10:32:08,2010-02-25 08:48:41,8462
307,4616,6407,11330,"23 days, 22:17:11",2013-02-06 07:08:29,2013-02-06 07:08:29,2013-03-02 05:25:40,3403
1133,2805,4920,8858,"23 days, 22:18:45",2013-02-06 07:06:55,2013-02-06 07:06:55,2013-03-02 05:25:40,7001
687,3518,5925,10130,"23 days, 22:20:12",2013-02-06 07:05:28,2013-02-06 07:05:28,2013-03-02 05:25:40,3048
1241,1581,2893,5715,"23 days, 22:20:39",2013-02-06 07:05:01,2013-02-06 07:05:01,2013-03-02 05:25:40,1586
420,1789,2121,4330,"23 days, 22:21:06",2013-02-06 11:46:07,2010-02-25 09:23:50,2010-03-21 07:44:56,5503
153,1028,1338,2519,"23 days, 22:22:28",2013-02-07 05:06:45,2010-04-24 07:23:11,2010-05-18 05:45:39,544
823,6038,6538,13399,"23 days, 22:23:03",2013-02-06 07:02:37,2013-02-06 07:02:37,2013-03-02 05:25:40,812
1401,1458,1324,4183,"23 days, 22:23:26",2013-02-06 07:02:14,2013-02-06 07:02:14,2013-03-02 05:25:40,5840
213,4021,3910,8144,"23 days, 22:23:58",2013-02-06 07:01:42,2013-02-06 07:01:42,2013-03-02 05:25:40,2085
2110,5846,8098,16054,"23 days, 22:24:16",2013-02-06 07:01:24,2013-02-06 07:01:24,2013-03-02 05:25:40,8272
488,6128,6281,12897,"23 days, 22:24:18",2013-02-06 07:01:22,2013-02-06 07:01:22,2013-03-02 05:25:40,7099
352,1271,1359,2982,"23 days, 22:24:47",2013-02-06 07:00:53,2013-02-06 07:00:53,2013-03-02 05:25:40,5931
1372,2435,2706,6513,"23 days, 22:24:54",2013-02-06 07:00:46,2013-02-06 07:00:46,2013-03-02 05:25:40,1816
406,4391,5439,10236,"23 days, 22:24:55",2013-02-06 07:00:45,2013-02-06 07:00:45,2013-03-02 05:25:40,2526
352,1882,1647,3881,"23 days, 22:25:54",2013-02-06 06:59:46,2013-02-06 06:59:46,2013-03-02 05:25:40,7780
243,844,2365,3452,"23 days, 22:27:55",2013-02-06 06:57:45,2013-02-06 06:57:45,2013-03-02 05:25:40,4275
1360,2609,3220,7189,"23 days, 22:28:20",2013-02-06 06:57:20,2013-02-06 06:57:20,2013-03-02 05:25:40,2145
2656,6200,7136,15992,"23 days, 22:30:32",2013-02-06 06:55:08,2013-02-06 06:55:08,2013-03-02 05:25:40,9733
847,5151,5946,11944,"23 days, 22:30:40",2013-02-06 06:55:00,2013-02-06 06:55:00,2013-03-02 05:25:40,5542
2884,6748,8298,17930,"23 days, 22:30:42",2013-02-06 06:54:58,2013-02-06 06:54:58,2013-03-02 05:25:40,2407
1010,3829,5518,10357,"23 days, 22:31:16",2013-02-06 06:54:24,2013-02-06 06:54:24,2013-03-02 05:25:40,2336
621,3753,4528,8902,"23 days, 22:34:04",2013-02-06 06:51:36,2013-02-06 06:51:36,2013-03-02 05:25:40,5747
314,321,1410,2045,"23 days, 22:34:12",2013-02-06 06:51:28,2013-02-06 06:51:28,2013-03-02 05:25:40,7842
242,8917,5837,14996,"23 days, 22:34:39",2013-02-06 06:51:01,2013-02-06 06:51:01,2013-03-02 05:25:40,8505
1039,3856,4317,9212,"23 days, 22:36:10",2013-02-06 06:49:30,2013-02-06 06:49:30,2013-03-02 05:25:40,8288
1003,3426,4619,9048,"23 days, 22:36:26",2013-02-14 08:23:47,2010-02-01 10:32:08,2010-02-25 09:08:34,2282
229,2744,3167,6140,"23 days, 22:36:35",2013-02-06 06:49:05,2013-02-06 06:49:05,2013-03-02 05:25:40,7274
2525,5638,4795,12958,"23 days, 22:37:32",2013-02-06 06:48:08,2013-02-06 06:48:08,2013-03-02 05:25:40,7841
645,2596,2764,6005,"23 days, 22:37:54",2013-02-06 06:47:46,2013-02-06 06:47:46,2013-03-02 05:25:40,4809
769,2471,2032,5272,"23 days, 22:37:58",2013-02-06 06:47:42,2013-02-06 06:47:42,2013-03-02 05:25:40,9596
812,1218,2553,4583,"23 days, 22:38:28",2013-02-06 06:47:12,2013-02-06 06:47:12,2013-03-02 05:25:40,6909
527,5806,7044,13377,"23 days, 22:38:30",2013-02-06 06:47:10,2013-02-06 06:47:10,2013-03-02 05:25:40,5266
466,791,1211,2468,"23 days, 22:40:25",2013-02-06 06:45:15,2013-02-06 06:45:15,2013-03-02 05:25:40,4875
1563,6965,6404,14932,"23 days, 22:40:30",2013-02-06 06:45:10,2013-02-06 06:45:10,2013-03-02 05:25:40,4038
2364,7180,6771,16315,"23 days, 22:41:27",2013-02-06 06:44:13,2013-02-06 06:44:13,2013-03-02 05:25:40,7937
38,1558,2221,3817,"23 days, 22:42:11",2013-02-06 06:43:29,2013-02-06 06:43:29,2013-03-02 05:25:40,2999
707,1030,1233,2970,"23 days, 22:42:30",2013-02-06 06:43:10,2013-02-06 06:43:10,2013-03-02 05:25:40,3939
1969,2626,3312,7907,"23 days, 22:43:56",2013-02-06 06:41:44,2013-02-06 06:41:44,2013-03-02 05:25:40,8110
436,5798,5316,11550,"23 days, 22:45:13",2013-02-06 06:40:27,2013-02-06 06:40:27,2013-03-02 05:25:40,1296
173,6204,7028,13405,"23 days, 22:45:26",2013-02-06 06:40:14,2013-02-06 06:40:14,2013-03-02 05:25:40,7651
169,7918,6442,14529,"23 days, 22:46:32",2013-02-06 06:39:08,2013-02-06 06:39:08,2013-03-02 05:25:40,5738
626,2174,3187,5987,"23 days, 22:47:07",2013-02-06 06:38:33,2013-02-06 06:38:33,2013-03-02 05:25:40,5324
35,2476,2592,5103,"23 days, 22:47:27",2013-02-07 06:14:14,2010-02-01 10:32:08,2010-02-25 09:19:35,4345
27,1157,2262,3446,"23 days, 22:47:31",2013-02-06 06:38:09,2013-02-06 06:38:09,2013-03-02 05:25:40,9417
645,6371,6062,13078,"23 days, 22:47:31",2013-02-06 06:38:09,2013-02-06 06:38:09,2013-03-02 05:25:40,404
511,1239,2094,3844,"23 days, 22:48:40",2013-02-06 06:37:00,2013-02-06 06:37:00,2013-03-02 05:25:40,9383
61,3627,4482,8170,"23 days, 22:48:58",2013-02-06 06:36:42,2013-02-06 06:36:42,2013-03-02 05:25:40,7818
723,1566,1668,3957,"23 days, 22:50:13",2013-02-06 06:35:27,2013-02-06 06:35:27,2013-03-02 05:25:40,5674
140,9680,7088,16908,"23 days, 22:50:28",2013-02-07 10:06:17,2010-02-01 10:32:08,2010-02-25 09:22:36,8123
98,346,748,1192,"23 days, 22:51:30",2013-02-06 06:34:10,2013-02-06 06:34:10,2013-03-02 05:25:40,2702
1928,7192,9221,18341,"23 days, 22:52:09",2013-02-06 06:33:31,2013-02-06 06:33:31,2013-03-02 05:25:40,7483
646,7746,5604,13996,"23 days, 22:53:22",2013-02-06 06:32:18,2013-02-06 06:32:18,2013-03-02 05:25:40,6652
266,1769,3064,5099,"23 days, 22:53:39",2013-02-06 06:32:01,2013-02-06 06:32:01,2013-03-02 05:25:40,3037
1024,1973,2246,5243,"23 days, 22:54:03",2013-02-06 06:31:37,2013-02-06 06:31:37,2013-03-02 05:25:40,9478
946,5297,5341,11584,"23 days, 22:54:09",2013-02-06 06:31:31,2013-02-06 06:31:31,2013-03-02 05:25:40,4227
558,1997,3105,5660,"23 days, 22:55:06",2013-02-06 06:30:34,2013-02-06 06:30:34,2013-03-02 05:25:40,5769
74,5110,5455,10639,"23 days, 22:57:04",2013-02-06 06:28:36,2013-02-06 06:28:36,2013-03-02 05:25:40,9342
343,2731,3297,6371,"23 days, 22:57:37",2013-02-06 06:28:03,2013-02-06 06:28:03,2013-03-02 05:25:40,3486
829,8440,7479,16748,"23 days, 22:57:54",2013-02-06 06:27:46,2013-02-06 06:27:46,2013-03-02 05:25:40,1620
1059,4051,5256,10366,"23 days, 22:58:36",2013-02-06 06:27:04,2013-02-06 06:27:04,2013-03-02 05:25:40,5865
624,598,1441,2663,"23 days, 22:58:47",2013-02-06 06:26:53,2013-02-06 06:26:53,2013-03-02 05:25:40,2876
1602,772,1479,3853,"23 days, 22:59:36",2013-02-06 06:26:04,2013-02-06 06:26:04,2013-03-02 05:25:40,6497
871,2023,2971,5865,"23 days, 23:00:33",2013-02-06 06:25:07,2013-02-06 06:25:07,2013-03-02 05:25:40,9798
507,2234,2493,5234,"23 days, 23:01:39",2013-02-06 06:24:01,2013-02-06 06:24:01,2013-03-02 05:25:40,9665
41,2762,4356,7159,"23 days, 23:02:36",2013-02-06 11:45:08,2010-02-01 10:32:08,2010-02-25 09:34:44,2219
854,1206,1562,3622,"23 days, 23:02:52",2013-02-06 06:22:48,2013-02-06 06:22:48,2013-03-02 05:25:40,95
474,2883,5372,8729,"23 days, 23:03:27",2013-02-06 06:22:13,2013-02-06 06:22:13,2013-03-02 05:25:40,3689
372,463,1129,1964,"23 days, 23:03:50",2013-02-06 06:21:50,2013-02-06 06:21:50,2013-03-02 05:25:40,1049
34,1109,1220,2363,"23 days, 23:04:01",2013-02-06 06:21:39,2013-02-06 06:21:39,2013-03-02 05:25:40,6145
580,6163,5545,12288,"23 days, 23:04:11",2013-02-06 06:21:29,2013-02-06 06:21:29,2013-03-02 05:25:40,1982
221,4240,3663,8124,"23 days, 23:04:51",2013-02-06 06:20:49,2013-02-06 06:20:49,2013-03-02 05:25:40,855
690,1104,2227,4021,"23 days, 23:05:08",2013-02-06 06:20:32,2013-02-06 06:20:32,2013-03-02 05:25:40,5629
2471,6685,7973,17129,"23 days, 23:06:06",2013-02-06 06:19:34,2013-02-06 06:19:34,2013-03-02 05:25:40,5350
606,2349,2312,5267,"23 days, 23:06:06",2013-02-06 06:19:34,2013-02-06 06:19:34,2013-03-02 05:25:40,2446
319,7703,7494,15516,"23 days, 23:06:52",2013-02-06 06:18:48,2013-02-06 06:18:48,2013-03-02 05:25:40,3676
621,1875,2646,5142,"23 days, 23:06:56",2013-02-06 06:18:44,2013-02-06 06:18:44,2013-03-02 05:25:40,8467
2371,9409,8036,19816,"23 days, 23:08:35",2013-02-06 06:17:05,2013-02-06 06:17:05,2013-03-02 05:25:40,8851
951,1526,2769,5246,"23 days, 23:09:25",2013-02-06 06:16:15,2013-02-06 06:16:15,2013-03-02 05:25:40,8743
35,4677,5609,10321,"23 days, 23:11:11",2013-02-06 06:14:29,2013-02-06 06:14:29,2013-03-02 05:25:40,5012
2249,6773,5528,14550,"23 days, 23:15:32",2013-02-06 06:10:08,2013-02-06 06:10:08,2013-03-02 05:25:40,1761
1105,680,916,2701,"23 days, 23:15:54",2013-02-06 06:09:46,2013-02-06 06:09:46,2013-03-02 05:25:40,1689
1002,513,959,2474,"23 days, 23:17:52",2013-02-06 06:07:48,2013-02-06 06:07:48,2013-03-02 05:25:40,5929
275,3420,4885,8580,"23 days, 23:18:29",2013-02-06 06:07:11,2013-02-06 06:07:11,2013-03-02 05:25:40,5481
99,2565,2731,5395,"23 days, 23:18:45",2013-02-06 06:06:55,2013-02-06 06:06:55,2013-03-02 05:25:40,6795
304,1740,1784,3828,"23 days, 23:20:18",2013-02-06 06:05:22,2013-02-06 06:05:22,2013-03-02 05:25:40,5336
935,609,1581,3125,"23 days, 23:20:30",2013-02-06 06:05:10,2013-02-06 06:05:10,2013-03-02 05:25:40,7608
761,1369,2504,4634,"23 days, 23:21:39",2013-02-06 06:04:01,2013-02-06 06:04:01,2013-03-02 05:25:40,8703
1918,635,1496,4049,"23 days, 23:21:49",2013-02-06 06:03:51,2013-02-06 06:03:51,2013-03-02 05:25:40,8879
557,3588,3786,7931,"23 days, 23:22:59",2013-02-06 06:02:41,2013-02-06 06:02:41,2013-03-02 05:25:40,3895
879,503,934,2316,"23 days, 23:23:11",2013-02-06 06:02:29,2013-02-06 06:02:29,2013-03-02 05:25:40,9643
325,1252,1596,3173,"23 days, 23:24:18",2013-02-06 06:01:22,2013-02-06 06:01:22,2013-03-02 05:25:40,8257
1218,2010,2716,5944,"23 days, 23:24:47",2013-02-06 06:00:53,2013-02-06 06:00:53,2013-03-02 05:25:40,2743
760,9459,6281,16500,"23 days, 23:27:02",2013-02-06 05:58:38,2013-02-06 05:58:38,2013-03-02 05:25:40,9052
389,3341,2476,6206,"23 days, 23:27:10",2013-02-06 05:58:30,2013-02-06 05:58:30,2013-03-02 05:25:40,3890
1704,6972,6386,15062,"23 days, 23:27:25",2013-02-06 05:58:15,2013-02-06 05:58:15,2013-03-02 05:25:40,538
768,7446,5867,14081,"23 days, 23:27:43",2013-02-06 05:57:57,2013-02-06 05:57:57,2013-03-02 05:25:40,5139
1127,1313,1597,4037,"23 days, 23:29:04",2013-02-06 05:56:36,2013-02-06 05:56:36,2013-03-02 05:25:40,6251
2470,3919,6226,12615,"23 days, 23:29:57",2013-02-06 05:55:43,2013-02-06 05:55:43,2013-03-02 05:25:40,5309
192,1524,2647,4363,"23 days, 23:30:04",2013-02-06 05:55:36,2013-02-06 05:55:36,2013-03-02 05:25:40,614
1375,1611,2235,5221,"23 days, 23:30:49",2013-02-06 05:54:51,2013-02-06 05:54:51,2013-03-02 05:25:40,8286
1049,3999,4642,9690,"23 days, 23:31:03",2013-02-06 05:54:37,2013-02-06 05:54:37,2013-03-02 05:25:40,7373
253,6162,5462,11877,"23 days, 23:31:05",2013-02-06 05:54:35,2013-02-06 05:54:35,2013-03-02 05:25:40,1003
201,742,1007,1950,"23 days, 23:31:59",2013-02-06 05:53:41,2013-02-06 05:53:41,2013-03-02 05:25:40,8056
986,1180,1327,3493,"23 days, 23:32:16",2013-02-06 05:53:24,2013-02-06 05:53:24,2013-03-02 05:25:40,8484
44,463,1014,1521,"23 days, 23:33:29",2013-02-06 05:52:11,2013-02-06 05:52:11,2013-03-02 05:25:40,4756
439,1279,2066,3784,"23 days, 23:33:34",2013-02-06 05:52:06,2013-02-06 05:52:06,2013-03-02 05:25:40,8749
11,2326,2540,4877,"23 days, 23:33:38",2013-02-06 05:52:02,2013-02-06 05:52:02,2013-03-02 05:25:40,9163
16,1569,2819,4404,"23 days, 23:34:35",2013-02-06 05:51:05,2013-02-06 05:51:05,2013-03-02 05:25:40,3086
1261,491,647,2399,"23 days, 23:34:57",2013-02-06 05:50:43,2013-02-06 05:50:43,2013-03-02 05:25:40,1497
754,5847,8080,14681,"23 days, 23:35:05",2013-02-06 05:50:35,2013-02-06 05:50:35,2013-03-02 05:25:40,149
50,854,1602,2506,"23 days, 23:35:13",2013-02-06 05:50:27,2013-02-06 05:50:27,2013-03-02 05:25:40,4487
449,833,1487,2769,"23 days, 23:35:26",2013-02-06 05:50:14,2013-02-06 05:50:14,2013-03-02 05:25:40,556
614,3001,4250,7865,"23 days, 23:38:38",2013-02-06 05:47:02,2013-02-06 05:47:02,2013-03-02 05:25:40,1450
267,906,1511,2684,"23 days, 23:40:38",2013-02-06 05:45:02,2013-02-06 05:45:02,2013-03-02 05:25:40,6472
879,772,1074,2725,"23 days, 23:41:43",2013-02-06 05:43:57,2013-02-06 05:43:57,2013-03-02 05:25:40,890
234,1727,2237,4198,"23 days, 23:42:42",2013-02-06 05:42:58,2013-02-06 05:42:58,2013-03-02 05:25:40,9300
751,2020,2865,5636,"23 days, 23:45:46",2013-02-06 05:39:54,2013-02-06 05:39:54,2013-03-02 05:25:40,1364
65,1048,2130,3243,"23 days, 23:45:51",2013-02-06 05:39:49,2013-02-06 05:39:49,2013-03-02 05:25:40,9001
589,7082,8564,16235,"23 days, 23:47:06",2013-02-06 05:38:34,2013-02-06 05:38:34,2013-03-02 05:25:40,2470
234,5822,4414,10470,"23 days, 23:47:40",2013-02-06 05:38:00,2013-02-06 05:38:00,2013-03-02 05:25:40,4887
887,6409,4862,12158,"23 days, 23:47:42",2013-02-06 05:37:58,2013-02-06 05:37:58,2013-03-02 05:25:40,5873
130,1788,2259,4177,"23 days, 23:48:26",2013-02-06 05:37:14,2013-02-06 05:37:14,2013-03-02 05:25:40,9552
918,3462,3994,8374,"23 days, 23:49:00",2013-02-06 05:36:40,2013-02-06 05:36:40,2013-03-02 05:25:40,68
913,6244,7745,14902,"23 days, 23:49:25",2013-02-06 05:36:15,2013-02-06 05:36:15,2013-03-02 05:25:40,1058
403,383,624,1410,"23 days, 23:50:21",2013-02-06 05:35:19,2013-02-06 05:35:19,2013-03-02 05:25:40,5105
1368,6247,6940,14555,"23 days, 23:55:27",2013-02-06 05:30:13,2013-02-06 05:30:13,2013-03-02 05:25:40,8668
255,6712,7171,14138,"23 days, 23:55:40",2013-02-06 09:32:25,2010-02-16 04:38:27,2010-03-12 04:34:07,1814
1884,4567,4418,10869,"23 days, 23:58:26",2013-02-06 05:27:14,2013-02-06 05:27:14,2013-03-02 05:25:40,3395
1086,972,1342,3400,"23 days, 23:58:35",2013-02-06 05:27:05,2013-02-06 05:27:05,2013-03-02 05:25:40,5905
1520,4610,3472,9602,"23 days, 23:58:55",2013-02-07 07:12:03,2010-02-08 04:25:54,2010-03-04 04:24:49,1649
373,1006,1964,3343,"23 days, 23:59:16",2013-02-06 05:26:24,2013-02-06 05:26:24,2013-03-02 05:25:40,6014
59,603,1629,2291,"23 days, 23:59:18",2013-02-06 05:26:22,2013-02-06 05:26:22,2013-03-02 05:25:40,261
743,3918,6406,11067,"24 days, 0:00:26",2013-02-07 03:58:21,2010-02-01 10:32:08,2010-02-25 10:32:34,6709
980,9755,8996,19731,"24 days, 0:01:00",2013-02-06 05:24:40,2013-02-06 05:24:40,2013-03-02 05:25:40,2198
300,669,1459,2428,"24 days, 0:01:37",2013-02-06 05:24:03,2013-02-06 05:24:03,2013-03-02 05:25:40,9341
895,8196,6605,15696,"24 days, 0:01:43",2013-02-06 05:23:57,2013-02-06 05:23:57,2013-03-02 05:25:40,918
1670,3250,3014,7934,"24 days, 0:03:30",2013-02-06 05:22:10,2013-02-06 05:22:10,2013-03-02 05:25:40,4446
1017,1333,2597,4947,"24 days, 0:04:23",2013-02-06 05:21:17,2013-02-06 05:21:17,2013-03-02 05:25:40,3209
310,1544,1534,3388,"24 days, 0:04:45",2013-02-06 05:20:55,2013-02-06 05:20:55,2013-03-02 05:25:40,2622
960,654,1328,2942,"24 days, 0:05:38",2013-02-06 05:20:02,2013-02-06 05:20:02,2013-03-02 05:25:40,9987
577,3752,4977,9306,"24 days, 0:05:51",2013-02-06 05:19:49,2013-02-06 05:19:49,2013-03-02 05:25:40,4212
474,3910,5978,10362,"24 days, 0:07:14",2013-02-06 05:18:26,2013-02-06 05:18:26,2013-03-02 05:25:40,1354
252,5938,3463,9653,"24 days, 0:07:44",2013-02-06 05:17:56,2013-02-06 05:17:56,2013-03-02 05:25:40,835
160,6064,6209,12433,"24 days, 0:08:56",2013-02-06 05:16:44,2013-02-06 05:16:44,2013-03-02 05:25:40,8169
609,4149,5630,10388,"24 days, 0:10:14",2013-02-06 05:15:26,2013-02-06 05:15:26,2013-03-02 05:25:40,7748
1091,328,705,2124,"24 days, 0:10:58",2013-02-06 05:14:42,2013-02-06 05:14:42,2013-03-02 05:25:40,2072
3446,7145,6963,17554,"24 days, 0:12:26",2013-02-06 05:13:14,2013-02-06 05:13:14,2013-03-02 05:25:40,5772
552,5361,4184,10097,"24 days, 0:13:13",2013-02-06 05:12:27,2013-02-06 05:12:27,2013-03-02 05:25:40,3210
526,4174,4461,9161,"24 days, 0:15:30",2013-02-06 05:10:10,2013-02-06 05:10:10,2013-03-02 05:25:40,627
474,2102,3043,5619,"24 days, 0:15:40",2013-02-06 05:10:00,2013-02-06 05:10:00,2013-03-02 05:25:40,8066
662,482,746,1890,"24 days, 0:18:20",2013-02-06 05:07:20,2013-02-06 05:07:20,2013-03-02 05:25:40,3749
1669,2362,4273,8304,"24 days, 0:18:32",2013-02-06 05:07:08,2013-02-06 05:07:08,2013-03-02 05:25:40,7555
257,1294,2520,4071,"24 days, 0:19:08",2013-02-06 05:06:32,2013-02-06 05:06:32,2013-03-02 05:25:40,33
2183,1634,3410,7227,"24 days, 0:20:20",2013-02-06 05:05:20,2013-02-06 05:05:20,2013-03-02 05:25:40,8206
61,1039,2377,3477,"24 days, 0:20:51",2013-02-07 07:46:20,2010-03-10 11:03:56,2010-04-03 11:24:47,3468
656,2263,3533,6452,"24 days, 0:20:58",2013-02-06 05:04:42,2013-02-06 05:04:42,2013-03-02 05:25:40,4267
39,6828,4222,11089,"24 days, 0:22:44",2013-02-06 05:02:56,2013-02-06 05:02:56,2013-03-02 05:25:40,4056
1293,1966,2587,5846,"24 days, 0:23:26",2013-02-06 05:02:14,2013-02-06 05:02:14,2013-03-02 05:25:40,4731
554,2628,2953,6135,"24 days, 0:26:14",2013-02-06 04:59:26,2013-02-06 04:59:26,2013-03-02 05:25:40,3596
921,5148,7954,14023,"24 days, 0:26:25",2013-02-06 04:59:15,2013-02-06 04:59:15,2013-03-02 05:25:40,5313
1853,5946,6295,14094,"24 days, 0:26:55",2013-02-06 04:58:45,2013-02-06 04:58:45,2013-03-02 05:25:40,4233
663,999,2379,4041,"24 days, 0:28:11",2013-02-06 04:57:29,2013-02-06 04:57:29,2013-03-02 05:25:40,5906
1381,4352,4953,10686,"24 days, 0:28:35",2013-02-06 04:57:05,2013-02-06 04:57:05,2013-03-02 05:25:40,2231
54,3919,5143,9116,"24 days, 0:28:39",2013-03-01 05:15:08,2013-02-05 04:46:29,2013-03-01 05:15:08,7328
38,6054,6747,12839,"24 days, 0:29:01",2013-02-06 04:56:39,2013-02-06 04:56:39,2013-03-02 05:25:40,8647
600,5013,5095,10708,"24 days, 0:29:17",2013-02-06 04:56:23,2013-02-06 04:56:23,2013-03-02 05:25:40,2750
1469,1053,2727,5249,"24 days, 0:31:22",2013-02-06 04:54:18,2013-02-06 04:54:18,2013-03-02 05:25:40,2973
17,2091,3898,6006,"24 days, 0:32:03",2013-02-06 04:53:37,2013-02-06 04:53:37,2013-03-02 05:25:40,300
313,763,1313,2389,"24 days, 0:33:44",2013-02-06 04:51:56,2013-02-06 04:51:56,2013-03-02 05:25:40,1980
317,1286,1636,3239,"24 days, 0:34:29",2013-02-06 04:51:11,2013-02-06 04:51:11,2013-03-02 05:25:40,5501
228,1358,1575,3161,"24 days, 0:34:35",2013-02-06 04:51:05,2013-02-06 04:51:05,2013-03-02 05:25:40,3881
3062,11338,8143,22543,"24 days, 0:34:42",2013-02-06 04:50:58,2013-02-06 04:50:58,2013-03-02 05:25:40,6916
132,2566,2887,5585,"24 days, 0:36:38",2013-02-06 04:49:02,2013-02-06 04:49:02,2013-03-02 05:25:40,4525
243,5654,5392,11289,"24 days, 0:36:50",2013-02-06 04:48:50,2013-02-06 04:48:50,2013-03-02 05:25:40,596
927,600,1486,3013,"24 days, 0:36:57",2013-02-06 04:48:43,2013-02-06 04:48:43,2013-03-02 05:25:40,3050
1193,7012,6871,15076,"24 days, 0:37:58",2013-02-06 04:47:42,2013-02-06 04:47:42,2013-03-02 05:25:40,8878
603,1521,2576,4700,"24 days, 0:38:21",2013-02-06 04:47:19,2013-02-06 04:47:19,2013-03-02 05:25:40,4777
12,554,1299,1865,"24 days, 0:38:57",2013-02-06 04:46:43,2013-02-06 04:46:43,2013-03-02 05:25:40,3957
926,8390,8941,18257,"24 days, 0:39:29",2013-02-06 04:46:11,2013-02-06 04:46:11,2013-03-02 05:25:40,6016
165,736,1119,2020,"24 days, 0:40:12",2013-02-06 04:45:28,2013-02-06 04:45:28,2013-03-02 05:25:40,5627
966,1467,2644,5077,"24 days, 0:40:41",2013-02-06 04:44:59,2013-02-06 04:44:59,2013-03-02 05:25:40,348
1605,4995,4223,10823,"24 days, 0:40:42",2013-02-06 04:44:58,2013-02-06 04:44:58,2013-03-02 05:25:40,6404
215,382,844,1441,"24 days, 0:40:45",2013-02-06 04:44:55,2013-02-06 04:44:55,2013-03-02 05:25:40,1156
458,3560,4428,8446,"24 days, 0:41:11",2013-02-06 04:44:29,2013-02-06 04:44:29,2013-03-02 05:25:40,4737
118,1761,2833,4712,"24 days, 0:41:15",2013-02-06 04:44:25,2013-02-06 04:44:25,2013-03-02 05:25:40,8816
1446,1988,2177,5611,"24 days, 0:41:57",2013-02-06 04:43:43,2013-02-06 04:43:43,2013-03-02 05:25:40,9631
271,797,1249,2317,"24 days, 0:42:51",2013-02-06 04:42:49,2013-02-06 04:42:49,2013-03-02 05:25:40,7138
1137,3925,4119,9181,"24 days, 0:43:42",2013-02-06 04:41:58,2013-02-06 04:41:58,2013-03-02 05:25:40,4110
290,5459,4910,10659,"24 days, 0:43:46",2013-02-06 06:52:31,2010-02-01 10:32:08,2010-02-25 11:15:54,8146
1121,209,401,1731,"24 days, 0:44:30",2013-02-06 04:41:10,2013-02-06 04:41:10,2013-03-02 05:25:40,7770
1027,4186,4413,9626,"24 days, 0:45:01",2013-02-06 04:40:39,2013-02-06 04:40:39,2013-03-02 05:25:40,8501
180,3726,5108,9014,"24 days, 0:45:31",2013-02-07 07:18:57,2010-02-01 10:32:08,2010-02-25 11:17:39,839
593,1368,2123,4084,"24 days, 0:45:42",2013-02-06 04:39:58,2013-02-06 04:39:58,2013-03-02 05:25:40,2863
175,981,2019,3175,"24 days, 0:46:58",2013-02-06 04:38:42,2013-02-06 04:38:42,2013-03-02 05:25:40,4445
1102,2657,3198,6957,"24 days, 0:47:14",2013-02-07 01:35:54,2010-02-01 10:32:08,2010-02-25 11:19:22,6929
1241,3041,3676,7958,"24 days, 0:48:58",2013-02-06 04:36:42,2013-02-06 04:36:42,2013-03-02 05:25:40,9489
386,370,963,1719,"24 days, 0:49:26",2013-02-10 01:28:43,2010-02-01 10:32:08,2010-02-25 11:21:34,1242
1547,743,1531,3821,"24 days, 0:49:43",2013-02-06 04:35:57,2013-02-06 04:35:57,2013-03-02 05:25:40,6597
57,4482,6123,10662,"24 days, 0:52:02",2013-02-06 04:33:38,2013-02-06 04:33:38,2013-03-02 05:25:40,1155
146,8742,8995,17883,"24 days, 0:52:33",2013-02-06 04:33:07,2013-02-06 04:33:07,2013-03-02 05:25:40,9287
50,2558,4297,6905,"24 days, 0:52:59",2013-02-06 04:32:41,2013-02-06 04:32:41,2013-03-02 05:25:40,3155
1244,1658,1796,4698,"24 days, 0:53:12",2013-02-06 08:47:57,2010-02-24 08:07:05,2010-03-20 09:00:17,8086
251,3009,3364,6624,"24 days, 0:53:56",2013-02-06 04:31:44,2013-02-06 04:31:44,2013-03-02 05:25:40,6765
334,629,1144,2107,"24 days, 0:54:55",2013-02-06 08:44:13,2010-06-02 04:34:33,2010-06-26 05:29:28,3896
2131,2444,3241,7816,"24 days, 0:56:15",2013-02-06 04:29:25,2013-02-06 04:29:25,2013-03-02 05:25:40,7275
50,2436,3214,5700,"24 days, 0:58:43",2013-02-06 04:26:57,2013-02-06 04:26:57,2013-03-02 05:25:40,174
1450,6979,6643,15072,"24 days, 0:59:09",2013-02-06 04:26:31,2013-02-06 04:26:31,2013-03-02 05:25:40,3150
1631,4773,5952,12356,"24 days, 0:59:10",2013-02-06 04:26:30,2013-02-06 04:26:30,2013-03-02 05:25:40,156
462,1508,3167,5137,"24 days, 0:59:40",2013-02-06 04:26:00,2013-02-06 04:26:00,2013-03-02 05:25:40,8791
1117,1213,1418,3748,"24 days, 1:01:24",2013-02-06 04:24:16,2013-02-06 04:24:16,2013-03-02 05:25:40,4003
593,5689,5228,11510,"24 days, 1:01:59",2013-02-06 04:23:41,2013-02-06 04:23:41,2013-03-02 05:25:40,8755
84,1064,1837,2985,"24 days, 1:02:36",2013-02-06 04:23:04,2013-02-06 04:23:04,2013-03-02 05:25:40,7234
1358,494,900,2752,"24 days, 1:03:09",2013-02-06 04:22:31,2013-02-06 04:22:31,2013-03-02 05:25:40,9285
394,10002,5822,16218,"24 days, 1:03:52",2013-02-06 04:21:48,2013-02-06 04:21:48,2013-03-02 05:25:40,3565
2098,2560,3032,7690,"24 days, 1:04:34",2013-02-06 04:21:06,2013-02-06 04:21:06,2013-03-02 05:25:40,9842
3,2755,2924,5682,"24 days, 1:05:27",2013-02-06 04:20:13,2013-02-06 04:20:13,2013-03-02 05:25:40,1631
556,4337,5703,10596,"24 days, 1:05:50",2013-02-06 04:19:50,2013-02-06 04:19:50,2013-03-02 05:25:40,6
680,5791,7079,13550,"24 days, 1:08:12",2013-02-06 04:17:28,2013-02-06 04:17:28,2013-03-02 05:25:40,1028
437,2412,3339,6188,"24 days, 1:08:54",2013-02-06 04:16:46,2013-02-06 04:16:46,2013-03-02 05:25:40,4516
408,4021,6261,10690,"24 days, 1:09:20",2013-02-06 04:16:20,2013-02-06 04:16:20,2013-03-02 05:25:40,6613
737,2436,3236,6409,"24 days, 1:10:21",2013-02-06 04:15:19,2013-02-06 04:15:19,2013-03-02 05:25:40,5510
57,698,666,1421,"24 days, 1:11:10",2013-02-06 04:14:30,2013-02-06 04:14:30,2013-03-02 05:25:40,3527
42,2741,3503,6286,"24 days, 1:11:16",2013-02-06 04:14:24,2013-02-06 04:14:24,2013-03-02 05:25:40,711
1814,4955,4803,11572,"24 days, 1:11:47",2013-02-06 04:13:53,2013-02-06 04:13:53,2013-03-02 05:25:40,3591
1501,2504,3180,7185,"24 days, 1:11:58",2013-02-06 04:13:42,2013-02-06 04:13:42,2013-03-02 05:25:40,5417
76,1598,1789,3463,"24 days, 1:12:55",2013-02-06 04:12:45,2013-02-06 04:12:45,2013-03-02 05:25:40,7591
701,5302,5330,11333,"24 days, 1:15:00",2013-02-06 04:10:40,2013-02-06 04:10:40,2013-03-02 05:25:40,7053
1353,739,1320,3412,"24 days, 1:15:17",2013-02-06 04:10:23,2013-02-06 04:10:23,2013-03-02 05:25:40,4799
275,1936,3967,6178,"24 days, 1:15:36",2013-02-06 04:10:04,2013-02-06 04:10:04,2013-03-02 05:25:40,9725
1246,4154,4836,10236,"24 days, 1:16:18",2013-02-06 04:09:22,2013-02-06 04:09:22,2013-03-02 05:25:40,6728
239,2056,3495,5790,"24 days, 1:17:22",2013-02-06 04:08:18,2013-02-06 04:08:18,2013-03-02 05:25:40,6712
210,2196,3645,6051,"24 days, 1:19:41",2013-02-06 04:05:59,2013-02-06 04:05:59,2013-03-02 05:25:40,272
1188,2109,3120,6417,"24 days, 1:21:27",2013-02-06 04:04:13,2013-02-06 04:04:13,2013-03-02 05:25:40,6521
322,1174,1938,3434,"24 days, 1:23:20",2013-02-06 04:02:20,2013-02-06 04:02:20,2013-03-02 05:25:40,5180
491,2344,4713,7548,"24 days, 1:23:38",2013-02-06 04:02:02,2013-02-06 04:02:02,2013-03-02 05:25:40,4636
157,691,1174,2022,"24 days, 1:24:34",2013-02-06 04:01:06,2013-02-06 04:01:06,2013-03-02 05:25:40,2791
226,4454,8341,13021,"24 days, 1:25:22",2013-02-06 04:00:18,2013-02-06 04:00:18,2013-03-02 05:25:40,8499
241,6953,6270,13464,"24 days, 1:26:16",2013-02-06 03:59:24,2013-02-06 03:59:24,2013-03-02 05:25:40,316
674,5019,4105,9798,"24 days, 1:27:21",2013-02-06 03:58:19,2013-02-06 03:58:19,2013-03-02 05:25:40,2544
135,1506,2450,4091,"24 days, 1:27:22",2013-02-06 03:58:18,2013-02-06 03:58:18,2013-03-02 05:25:40,8400
291,875,1913,3079,"24 days, 1:28:33",2013-02-06 03:57:07,2013-02-06 03:57:07,2013-03-02 05:25:40,9337
1245,1393,1819,4457,"24 days, 1:29:48",2013-02-06 04:24:04,2010-03-10 00:43:26,2010-04-03 02:13:14,9840
454,297,665,1416,"24 days, 1:30:08",2013-02-06 03:55:32,2013-02-06 03:55:32,2013-03-02 05:25:40,8741
831,3508,3676,8015,"24 days, 1:30:52",2013-02-06 03:54:48,2013-02-06 03:54:48,2013-03-02 05:25:40,3195
2125,5729,4572,12426,"24 days, 1:31:12",2013-02-06 03:54:28,2013-02-06 03:54:28,2013-03-02 05:25:40,9323
1628,1482,2182,5292,"24 days, 1:31:13",2013-02-06 03:54:27,2013-02-06 03:54:27,2013-03-02 05:25:40,451
208,281,389,878,"24 days, 1:32:02",2013-02-06 03:53:38,2013-02-06 03:53:38,2013-03-02 05:25:40,3709
388,1599,1694,3681,"24 days, 1:37:29",2013-02-06 03:48:11,2013-02-06 03:48:11,2013-03-02 05:25:40,2615
1452,8747,9984,20183,"24 days, 1:38:23",2013-02-06 03:47:17,2013-02-06 03:47:17,2013-03-02 05:25:40,2938
1340,6249,5294,12883,"24 days, 1:39:48",2013-02-06 03:45:52,2013-02-06 03:45:52,2013-03-02 05:25:40,104
643,1182,1478,3303,"24 days, 1:40:45",2013-02-06 03:44:55,2013-02-06 03:44:55,2013-03-02 05:25:40,8130
1089,8569,6705,16363,"24 days, 1:41:06",2013-02-06 03:44:34,2013-02-06 03:44:34,2013-03-02 05:25:40,7195
97,514,609,1220,"24 days, 1:45:07",2013-02-06 03:40:33,2013-02-06 03:40:33,2013-03-02 05:25:40,3793
1698,1707,2809,6214,"24 days, 1:45:08",2013-02-06 03:40:32,2013-02-06 03:40:32,2013-03-02 05:25:40,8897
319,1153,2465,3937,"24 days, 1:45:12",2013-02-06 03:40:28,2013-02-06 03:40:28,2013-03-02 05:25:40,8129
1476,925,1764,4165,"24 days, 1:47:00",2013-02-06 03:38:40,2013-02-06 03:38:40,2013-03-02 05:25:40,3760
1270,1024,1114,3408,"24 days, 1:47:14",2013-02-06 03:38:26,2013-02-06 03:38:26,2013-03-02 05:25:40,1399
109,2679,6341,9129,"24 days, 1:49:58",2013-02-06 03:35:42,2013-02-06 03:35:42,2013-03-02 05:25:40,4353
1143,4066,5722,10931,"24 days, 1:50:01",2013-02-06 03:35:39,2013-02-06 03:35:39,2013-03-02 05:25:40,6600
765,8210,7374,16349,"24 days, 1:50:05",2013-02-06 03:35:35,2013-02-06 03:35:35,2013-03-02 05:25:40,3139
1199,348,779,2326,"24 days, 1:50:17",2013-02-06 03:35:23,2013-02-06 03:35:23,2013-03-02 05:25:40,6458
274,4219,4073,8566,"24 days, 1:53:35",2013-02-06 03:32:05,2013-02-06 03:32:05,2013-03-02 05:25:40,5993
515,1829,2717,5061,"24 days, 1:54:42",2013-02-06 03:30:58,2013-02-06 03:30:58,2013-03-02 05:25:40,6623
2272,4027,7893,14192,"24 days, 1:54:44",2013-02-06 03:30:56,2013-02-06 03:30:56,2013-03-02 05:25:40,8932
301,2165,3234,5700,"24 days, 1:58:02",2013-02-06 03:27:38,2013-02-06 03:27:38,2013-03-02 05:25:40,236
704,2166,3291,6161,"24 days, 1:58:39",2013-02-06 03:27:01,2013-02-06 03:27:01,2013-03-02 05:25:40,1219
858,916,1321,3095,"24 days, 2:01:24",2013-02-06 03:24:16,2013-02-06 03:24:16,2013-03-02 05:25:40,921
38,6770,6251,13059,"24 days, 2:01:27",2013-02-06 03:24:13,2013-02-06 03:24:13,2013-03-02 05:25:40,1145
1281,5995,5285,12561,"24 days, 2:01:31",2013-02-06 03:24:09,2013-02-06 03:24:09,2013-03-02 05:25:40,8183
54,764,1225,2043,"24 days, 2:01:32",2013-02-06 03:24:08,2013-02-06 03:24:08,2013-03-02 05:25:40,8458
1195,371,692,2258,"24 days, 2:02:33",2013-02-06 03:23:07,2013-02-06 03:23:07,2013-03-02 05:25:40,2443
736,2301,3286,6323,"24 days, 2:03:17",2013-02-06 03:22:23,2013-02-06 03:22:23,2013-03-02 05:25:40,122
147,1091,1976,3214,"24 days, 2:03:48",2013-02-06 03:21:52,2013-02-06 03:21:52,2013-03-02 05:25:40,2127
498,2822,3126,6446,"24 days, 2:05:28",2013-02-06 03:20:12,2013-02-06 03:20:12,2013-03-02 05:25:40,6877
687,1007,2140,3834,"24 days, 2:07:33",2013-02-06 03:18:07,2013-02-06 03:18:07,2013-03-02 05:25:40,960
948,1992,3084,6024,"24 days, 2:08:05",2013-02-06 03:17:35,2013-02-06 03:17:35,2013-03-02 05:25:40,8251
250,2361,2603,5214,"24 days, 2:12:31",2013-02-06 03:13:09,2013-02-06 03:13:09,2013-03-02 05:25:40,1547
126,1118,2112,3356,"24 days, 2:13:37",2013-02-07 03:37:34,2010-03-07 07:16:21,2010-03-31 09:29:58,1963
132,1430,3632,5194,"24 days, 2:13:57",2013-02-06 03:11:43,2013-02-06 03:11:43,2013-03-02 05:25:40,4294
119,3328,3657,7104,"24 days, 2:14:05",2013-02-06 03:11:35,2013-02-06 03:11:35,2013-03-02 05:25:40,5034
87,2377,3060,5524,"24 days, 2:14:48",2013-02-06 03:10:52,2013-02-06 03:10:52,2013-03-02 05:25:40,9595
132,3370,3732,7234,"24 days, 2:15:05",2013-02-06 03:10:35,2013-02-06 03:10:35,2013-03-02 05:25:40,2995
1245,2023,2786,6054,"24 days, 2:16:15",2013-02-06 03:09:25,2013-02-06 03:09:25,2013-03-02 05:25:40,6513
1039,222,553,1814,"24 days, 2:16:20",2013-02-06 03:09:20,2013-02-06 03:09:20,2013-03-02 05:25:40,585
717,487,954,2158,"24 days, 2:18:09",2013-02-06 03:07:31,2013-02-06 03:07:31,2013-03-02 05:25:40,6330
589,6498,6531,13618,"24 days, 2:18:28",2013-02-06 03:07:12,2013-02-06 03:07:12,2013-03-02 05:25:40,1971
228,5765,5935,11928,"24 days, 2:19:32",2013-02-06 03:06:08,2013-02-06 03:06:08,2013-03-02 05:25:40,7025
1531,3114,3879,8524,"24 days, 2:22:14",2013-02-06 03:03:26,2013-02-06 03:03:26,2013-03-02 05:25:40,7847
787,1876,3926,6589,"24 days, 2:22:49",2013-02-06 03:02:51,2013-02-06 03:02:51,2013-03-02 05:25:40,4652
616,6856,6796,14268,"24 days, 2:23:34",2013-02-06 03:02:06,2013-02-06 03:02:06,2013-03-02 05:25:40,4760
336,782,1461,2579,"24 days, 2:25:40",2013-02-06 03:00:00,2013-02-06 03:00:00,2013-03-02 05:25:40,4330
79,6726,6314,13119,"24 days, 2:28:04",2013-02-06 02:57:36,2013-02-06 02:57:36,2013-03-02 05:25:40,1577
2037,3643,3574,9254,"24 days, 2:30:50",2013-02-06 02:54:50,2013-02-06 02:54:50,2013-03-02 05:25:40,3867
542,3335,3429,7306,"24 days, 2:32:02",2013-02-06 02:53:38,2013-02-06 02:53:38,2013-03-02 05:25:40,2268
229,4869,4418,9516,"24 days, 2:33:19",2013-02-06 02:52:21,2013-02-06 02:52:21,2013-03-02 05:25:40,8069
382,4835,4928,10145,"24 days, 2:33:25",2013-02-06 02:52:15,2013-02-06 02:52:15,2013-03-02 05:25:40,395
690,5110,6452,12252,"24 days, 2:34:15",2013-02-06 02:51:25,2013-02-06 02:51:25,2013-03-02 05:25:40,3136
727,2928,5317,8972,"24 days, 2:35:30",2013-02-06 02:50:10,2013-02-06 02:50:10,2013-03-02 05:25:40,74
57,756,1478,2291,"24 days, 2:36:40",2013-02-06 02:49:00,2013-02-06 02:49:00,2013-03-02 05:25:40,7680
1280,233,517,2030,"24 days, 2:38:31",2013-02-06 02:47:09,2013-02-06 02:47:09,2013-03-02 05:25:40,446
432,667,1530,2629,"24 days, 2:38:51",2013-02-06 02:46:49,2013-02-06 02:46:49,2013-03-02 05:25:40,233
109,8240,8262,16611,"24 days, 2:46:07",2013-02-06 02:39:33,2013-02-06 02:39:33,2013-03-02 05:25:40,8189
85,1299,1667,3051,"24 days, 2:46:23",2013-02-06 02:39:17,2013-02-06 02:39:17,2013-03-02 05:25:40,5102
259,1618,1902,3779,"24 days, 2:50:30",2013-02-06 02:35:10,2013-02-06 02:35:10,2013-03-02 05:25:40,3587
1213,4880,4891,10984,"24 days, 2:50:39",2013-02-06 02:35:01,2013-02-06 02:35:01,2013-03-02 05:25:40,7082
8,4517,5317,9842,"24 days, 2:50:39",2013-02-06 02:35:01,2013-02-06 02:35:01,2013-03-02 05:25:40,6155
36,2677,3647,6360,"24 days, 2:51:57",2013-02-06 02:33:43,2013-02-06 02:33:43,2013-03-02 05:25:40,7405
238,1873,2605,4716,"24 days, 2:52:02",2013-02-06 02:33:38,2013-02-06 02:33:38,2013-03-02 05:25:40,4497
605,6813,7199,14617,"24 days, 2:53:46",2013-02-07 01:48:30,2010-02-15 03:11:49,2010-03-11 06:05:35,8132
229,552,653,1434,"24 days, 2:54:07",2013-02-06 02:31:33,2013-02-06 02:31:33,2013-03-02 05:25:40,1022
2014,2201,3353,7568,"24 days, 2:55:16",2013-02-06 02:30:24,2013-02-06 02:30:24,2013-03-02 05:25:40,6985
1757,1493,2187,5437,"24 days, 2:56:03",2013-02-06 02:29:37,2013-02-06 02:29:37,2013-03-02 05:25:40,8750
603,116,885,1604,"24 days, 2:57:12",2013-02-06 02:28:28,2013-02-06 02:28:28,2013-03-02 05:25:40,1135
1075,1624,2099,4798,"24 days, 3:00:49",2013-02-06 02:24:51,2013-02-06 02:24:51,2013-03-02 05:25:40,8663
889,1757,2865,5511,"24 days, 3:01:06",2013-02-06 02:24:34,2013-02-06 02:24:34,2013-03-02 05:25:40,3719
23,3007,2870,5900,"24 days, 3:03:37",2013-02-06 02:22:03,2013-02-06 02:22:03,2013-03-02 05:25:40,4930
41,4078,5713,9832,"24 days, 3:04:44",2013-02-06 02:20:56,2013-02-06 02:20:56,2013-03-02 05:25:40,3680
111,989,1193,2293,"24 days, 3:05:34",2013-02-06 02:20:06,2013-02-06 02:20:06,2013-03-02 05:25:40,3782
72,1551,2124,3747,"24 days, 3:06:27",2013-02-06 02:19:13,2013-02-06 02:19:13,2013-03-02 05:25:40,370
505,2123,2231,4859,"24 days, 3:08:34",2013-02-06 02:17:06,2013-02-06 02:17:06,2013-03-02 05:25:40,2333
727,977,1226,2930,"24 days, 3:08:43",2013-02-06 02:16:57,2013-02-06 02:16:57,2013-03-02 05:25:40,3469
2516,1751,2894,7161,"24 days, 3:12:35",2013-02-06 02:13:05,2013-02-06 02:13:05,2013-03-02 05:25:40,3322
422,2147,3066,5635,"24 days, 3:14:21",2013-02-06 02:11:19,2013-02-06 02:11:19,2013-03-02 05:25:40,4818
32,2121,6068,8221,"24 days, 3:14:44",2013-02-06 02:10:56,2013-02-06 02:10:56,2013-03-02 05:25:40,4280
1038,2109,2894,6041,"24 days, 3:14:58",2013-02-06 02:10:42,2013-02-06 02:10:42,2013-03-02 05:25:40,4803
1440,5670,6331,13441,"24 days, 3:15:45",2013-02-06 02:09:55,2013-02-06 02:09:55,2013-03-02 05:25:40,152
333,3919,4708,8960,"24 days, 3:19:59",2013-02-06 02:05:41,2013-02-06 02:05:41,2013-03-02 05:25:40,5014
322,2705,3498,6525,"24 days, 3:21:17",2013-02-06 02:04:23,2013-02-06 02:04:23,2013-03-02 05:25:40,1466
3213,5552,7064,15829,"24 days, 3:23:23",2013-02-06 02:02:17,2013-02-06 02:02:17,2013-03-02 05:25:40,8646
253,4159,6759,11171,"24 days, 3:24:44",2013-02-06 02:00:56,2013-02-06 02:00:56,2013-03-02 05:25:40,4320
1359,1319,1671,4349,"24 days, 3:26:09",2013-02-06 01:59:31,2013-02-06 01:59:31,2013-03-02 05:25:40,5160
1148,2617,3304,7069,"24 days, 3:28:27",2013-02-06 01:57:13,2013-02-06 01:57:13,2013-03-02 05:25:40,4741
310,2863,2867,6040,"24 days, 3:30:07",2013-02-06 01:55:33,2013-02-06 01:55:33,2013-03-02 05:25:40,7404
724,491,1045,2260,"24 days, 3:30:13",2013-02-06 01:55:27,2013-02-06 01:55:27,2013-03-02 05:25:40,5957
2248,7674,8554,18476,"24 days, 3:31:13",2013-02-06 01:54:27,2013-02-06 01:54:27,2013-03-02 05:25:40,8194
320,4403,4584,9307,"24 days, 3:34:30",2013-02-06 01:51:10,2013-02-06 01:51:10,2013-03-02 05:25:40,7226
1685,644,1141,3470,"24 days, 3:36:37",2013-02-06 01:49:03,2013-02-06 01:49:03,2013-03-02 05:25:40,3947
237,7247,5649,13133,"24 days, 3:38:19",2013-02-06 01:47:21,2013-02-06 01:47:21,2013-03-02 05:25:40,6192
338,823,726,1887,"24 days, 3:39:25",2013-02-06 01:46:15,2013-02-06 01:46:15,2013-03-02 05:25:40,7019
493,3715,5429,9637,"24 days, 3:40:11",2013-02-06 01:45:29,2013-02-06 01:45:29,2013-03-02 05:25:40,4318
906,4577,5349,10832,"24 days, 3:40:20",2013-02-06 01:45:20,2013-02-06 01:45:20,2013-03-02 05:25:40,3340
260,5494,5682,11436,"24 days, 3:40:26",2013-02-06 01:45:14,2013-02-06 01:45:14,2013-03-02 05:25:40,9647
390,7857,8258,16505,"24 days, 3:40:28",2013-02-06 01:45:12,2013-02-06 01:45:12,2013-03-02 05:25:40,1408
1357,586,1431,3374,"24 days, 3:40:44",2013-02-06 01:44:56,2013-02-06 01:44:56,2013-03-02 05:25:40,1390
992,2446,3675,7113,"24 days, 3:41:05",2013-02-06 01:44:35,2013-02-06 01:44:35,2013-03-02 05:25:40,780
292,986,1608,2886,"24 days, 3:41:24",2013-02-06 01:44:16,2013-02-06 01:44:16,2013-03-02 05:25:40,9168
1317,8680,8012,18009,"24 days, 3:41:25",2013-02-06 01:44:15,2013-02-06 01:44:15,2013-03-02 05:25:40,5958
454,3242,3492,7188,"24 days, 3:42:33",2013-02-06 01:43:07,2013-02-06 01:43:07,2013-03-02 05:25:40,3754
25,989,2140,3154,"24 days, 3:42:53",2013-02-06 01:42:47,2013-02-06 01:42:47,2013-03-02 05:25:40,8701
84,659,1207,1950,"24 days, 3:45:52",2013-02-07 08:52:17,2010-02-23 06:06:45,2010-03-19 09:52:37,6060
905,3245,4447,8597,"24 days, 3:48:14",2013-02-06 01:37:26,2013-02-06 01:37:26,2013-03-02 05:25:40,4682
39,3274,3562,6875,"24 days, 3:48:30",2013-02-07 09:40:02,2010-02-26 08:06:37,2010-03-22 11:55:07,7425
1685,1937,2591,6213,"24 days, 3:48:39",2013-02-06 01:37:01,2013-02-06 01:37:01,2013-03-02 05:25:40,7878
1020,3196,3406,7622,"24 days, 3:48:58",2013-02-06 01:36:42,2013-02-06 01:36:42,2013-03-02 05:25:40,3055
63,8139,6656,14858,"24 days, 3:49:51",2013-02-06 01:35:49,2013-02-06 01:35:49,2013-03-02 05:25:40,9172
324,1735,2392,4451,"24 days, 3:54:32",2013-02-06 01:31:08,2013-02-06 01:31:08,2013-03-02 05:25:40,7899
197,668,1637,2502,"24 days, 3:54:47",2013-02-06 01:30:53,2013-02-06 01:30:53,2013-03-02 05:25:40,9981
75,10158,5858,16091,"24 days, 3:56:29",2013-02-06 01:29:11,2013-02-06 01:29:11,2013-03-02 05:25:40,6664
456,3745,4210,8411,"24 days, 3:56:52",2013-02-06 01:28:48,2013-02-06 01:28:48,2013-03-02 05:25:40,9697
68,222,230,520,"24 days, 3:57:12",2013-02-06 01:28:28,2013-02-06 01:28:28,2013-03-02 05:25:40,5472
543,319,635,1497,"24 days, 3:57:31",2013-02-06 01:28:09,2013-02-06 01:28:09,2013-03-02 05:25:40,1916
1132,434,910,2476,"24 days, 4:00:01",2013-02-06 01:25:39,2013-02-06 01:25:39,2013-03-02 05:25:40,4303
1352,2356,4283,7991,"24 days, 4:01:59",2013-02-06 01:23:41,2013-02-06 01:23:41,2013-03-02 05:25:40,7645
953,362,748,2063,"24 days, 4:02:59",2013-02-06 01:22:41,2013-02-06 01:22:41,2013-03-02 05:25:40,3318
405,1559,1829,3793,"24 days, 4:03:29",2013-02-06 01:22:11,2013-02-06 01:22:11,2013-03-02 05:25:40,6975
174,8088,7982,16244,"24 days, 4:04:06",2013-02-06 01:21:34,2013-02-06 01:21:34,2013-03-02 05:25:40,8136
104,1471,1561,3136,"24 days, 4:04:23",2013-02-06 01:21:17,2013-02-06 01:21:17,2013-03-02 05:25:40,8306
260,1553,1794,3607,"24 days, 4:04:37",2013-02-06 01:21:03,2013-02-06 01:21:03,2013-03-02 05:25:40,8168
171,1422,3062,4655,"24 days, 4:04:57",2013-02-06 01:20:43,2013-02-06 01:20:43,2013-03-02 05:25:40,3514
39,4726,5516,10281,"24 days, 4:05:26",2013-02-06 01:20:14,2013-02-06 01:20:14,2013-03-02 05:25:40,7769
927,914,1167,3008,"24 days, 4:07:10",2013-02-06 01:18:30,2013-02-06 01:18:30,2013-03-02 05:25:40,5544
2274,4922,4089,11285,"24 days, 4:09:10",2013-02-06 01:16:30,2013-02-06 01:16:30,2013-03-02 05:25:40,8281
1346,7097,7158,15601,"24 days, 4:11:57",2013-02-06 01:13:43,2013-02-06 01:13:43,2013-03-02 05:25:40,4773
240,1246,1677,3163,"24 days, 4:15:05",2013-02-06 01:10:35,2013-02-06 01:10:35,2013-03-02 05:25:40,4643
474,5634,6889,12997,"24 days, 4:15:42",2013-02-06 01:09:58,2013-02-06 01:09:58,2013-03-02 05:25:40,2504
1120,1875,3157,6152,"24 days, 4:16:21",2013-02-06 01:09:19,2013-02-06 01:09:19,2013-03-02 05:25:40,1307
1395,3944,5105,10444,"24 days, 4:17:57",2013-02-06 01:07:43,2013-02-06 01:07:43,2013-03-02 05:25:40,2100
103,3250,2761,6114,"24 days, 4:18:48",2013-02-06 01:06:52,2013-02-06 01:06:52,2013-03-02 05:25:40,1798
248,561,895,1704,"24 days, 4:18:58",2013-02-06 01:06:42,2013-02-06 01:06:42,2013-03-02 05:25:40,4389
1043,3185,3806,8034,"24 days, 4:19:57",2013-02-06 01:05:43,2013-02-06 01:05:43,2013-03-02 05:25:40,7768
750,3110,3570,7430,"24 days, 4:21:17",2013-02-06 01:04:23,2013-02-06 01:04:23,2013-03-02 05:25:40,7515
113,1381,1636,3130,"24 days, 4:25:07",2013-02-06 01:00:33,2013-02-06 01:00:33,2013-03-02 05:25:40,9128
696,3904,4054,8654,"24 days, 4:25:39",2013-02-06 01:00:01,2013-02-06 01:00:01,2013-03-02 05:25:40,2974
648,1809,2640,5097,"24 days, 4:26:19",2013-02-06 11:28:55,2010-02-14 07:27:20,2010-03-10 11:53:39,1209
541,2186,4818,7545,"24 days, 4:28:45",2013-02-06 00:56:55,2013-02-06 00:56:55,2013-03-02 05:25:40,8361
1438,3799,3841,9078,"24 days, 4:29:10",2013-02-06 00:56:30,2013-02-06 00:56:30,2013-03-02 05:25:40,9619
2081,1836,3097,7014,"24 days, 4:30:35",2013-02-06 00:55:05,2013-02-06 00:55:05,2013-03-02 05:25:40,7355
1014,3311,3724,8049,"24 days, 4:31:45",2013-02-14 10:07:22,2010-03-16 01:15:31,2010-04-09 05:47:16,5413
586,4859,5895,11340,"24 days, 4:32:37",2013-02-06 00:53:03,2013-02-06 00:53:03,2013-03-02 05:25:40,4787
309,692,1455,2456,"24 days, 4:35:14",2013-02-06 00:50:26,2013-02-06 00:50:26,2013-03-02 05:25:40,1051
269,2565,3156,5990,"24 days, 4:35:44",2013-02-06 00:49:56,2013-02-06 00:49:56,2013-03-02 05:25:40,3644
862,494,898,2254,"24 days, 4:36:00",2013-02-06 00:49:40,2013-02-06 00:49:40,2013-03-02 05:25:40,4281
524,2564,2837,5925,"24 days, 4:38:45",2013-02-06 00:46:55,2013-02-06 00:46:55,2013-03-02 05:25:40,5823
546,7457,8183,16186,"24 days, 4:39:57",2013-02-06 00:45:43,2013-02-06 00:45:43,2013-03-02 05:25:40,2163
219,5825,6158,12202,"24 days, 4:41:47",2013-02-06 00:43:53,2013-02-06 00:43:53,2013-03-02 05:25:40,3560
430,8171,7678,16279,"24 days, 4:44:48",2013-02-06 00:40:52,2013-02-06 00:40:52,2013-03-02 05:25:40,2861
342,2820,4075,7237,"24 days, 4:46:05",2013-02-06 00:39:35,2013-02-06 00:39:35,2013-03-02 05:25:40,7887
1809,3369,7073,12251,"24 days, 4:46:41",2013-02-06 00:38:59,2013-02-06 00:38:59,2013-03-02 05:25:40,29
270,5645,4799,10714,"24 days, 4:47:01",2013-02-06 00:38:39,2013-02-06 00:38:39,2013-03-02 05:25:40,1626
369,1493,2053,3915,"24 days, 4:51:11",2013-02-06 00:34:29,2013-02-06 00:34:29,2013-03-02 05:25:40,1413
191,756,1360,2307,"24 days, 4:51:48",2013-02-06 00:33:52,2013-02-06 00:33:52,2013-03-02 05:25:40,4705
35,2481,3700,6216,"24 days, 4:52:48",2013-02-06 00:32:52,2013-02-06 00:32:52,2013-03-02 05:25:40,9731
438,3108,3139,6685,"24 days, 4:54:11",2013-02-06 00:31:29,2013-02-06 00:31:29,2013-03-02 05:25:40,3802
80,549,1005,1634,"24 days, 4:59:01",2013-02-06 00:26:39,2013-02-06 00:26:39,2013-03-02 05:25:40,349
747,1335,1961,4043,"24 days, 5:01:09",2013-02-06 00:24:31,2013-02-06 00:24:31,2013-03-02 05:25:40,7359
1166,1178,1641,3985,"24 days, 5:01:11",2013-02-06 00:24:29,2013-02-06 00:24:29,2013-03-02 05:25:40,4270
690,8246,5999,14935,"24 days, 5:04:20",2013-02-06 00:21:20,2013-02-06 00:21:20,2013-03-02 05:25:40,6702
1618,2850,3277,7745,"24 days, 5:04:34",2013-02-06 00:21:06,2013-02-06 00:21:06,2013-03-02 05:25:40,7957
246,3694,4363,8303,"24 days, 5:05:23",2013-02-06 00:20:17,2013-02-06 00:20:17,2013-03-02 05:25:40,1353
1939,4714,5932,12585,"24 days, 5:06:04",2013-02-06 00:19:36,2013-02-06 00:19:36,2013-03-02 05:25:40,8270
361,1460,2021,3842,"24 days, 5:07:02",2013-02-06 00:18:38,2013-02-06 00:18:38,2013-03-02 05:25:40,539
94,3346,5147,8587,"24 days, 5:09:07",2013-02-06 00:16:33,2013-02-06 00:16:33,2013-03-02 05:25:40,4681
179,932,1154,2265,"24 days, 5:09:55",2013-02-06 00:15:45,2013-02-06 00:15:45,2013-03-02 05:25:40,4381
793,1574,2138,4505,"24 days, 5:10:12",2013-02-06 00:15:28,2013-02-06 00:15:28,2013-03-02 05:25:40,9779
487,3186,4157,7830,"24 days, 5:10:58",2013-02-06 00:14:42,2013-02-06 00:14:42,2013-03-02 05:25:40,9046
1204,3270,3633,8107,"24 days, 5:12:03",2013-02-06 00:13:37,2013-02-06 00:13:37,2013-03-02 05:25:40,2718
3081,4495,5505,13081,"24 days, 5:12:26",2013-02-06 00:13:14,2013-02-06 00:13:14,2013-03-02 05:25:40,3677
1181,2723,3480,7384,"24 days, 5:13:07",2013-02-06 00:12:33,2013-02-06 00:12:33,2013-03-02 05:25:40,2687
1288,3463,3972,8723,"24 days, 5:15:16",2013-02-06 00:10:24,2013-02-06 00:10:24,2013-03-02 05:25:40,5773
36,6875,6742,13653,"24 days, 5:15:17",2013-02-06 00:10:23,2013-02-06 00:10:23,2013-03-02 05:25:40,9202
245,2233,2763,5241,"24 days, 5:15:52",2013-02-06 00:09:48,2013-02-06 00:09:48,2013-03-02 05:25:40,7677
148,407,653,1208,"24 days, 5:16:55",2013-02-06 00:08:45,2013-02-06 00:08:45,2013-03-02 05:25:40,3800
450,344,1071,1865,"24 days, 5:18:54",2013-02-06 00:06:46,2013-02-06 00:06:46,2013-03-02 05:25:40,7238
699,1074,1444,3217,"24 days, 5:19:01",2013-02-06 00:06:39,2013-02-06 00:06:39,2013-03-02 05:25:40,9800
1598,2334,2529,6461,"24 days, 5:19:08",2013-02-06 00:06:32,2013-02-06 00:06:32,2013-03-02 05:25:40,4322
1419,5858,5477,12754,"24 days, 5:20:41",2013-02-06 00:04:59,2013-02-06 00:04:59,2013-03-02 05:25:40,1401
894,2998,3878,7770,"24 days, 5:20:47",2013-02-06 00:04:53,2013-02-06 00:04:53,2013-03-02 05:25:40,4423
2773,5126,5693,13592,"24 days, 5:22:50",2013-02-06 00:02:50,2013-02-06 00:02:50,2013-03-02 05:25:40,5109
1771,3221,4952,9944,"24 days, 7:34:21",2013-02-06 11:03:00,2010-02-13 03:52:57,2010-03-09 11:27:18,3785
556,1238,2383,4177,"24 days, 12:35:58",2013-02-06 07:56:50,2010-02-18 11:40:39,2010-03-15 00:16:37,9009
103,3326,3259,6688,"24 days, 13:33:35",2013-02-07 07:30:12,2010-02-01 10:32:08,2010-02-26 00:05:43,6739
931,2951,3468,7350,"24 days, 13:36:53",2013-02-06 06:45:44,2010-02-01 10:32:08,2010-02-26 00:09:01,7139
1431,9558,6406,17395,"24 days, 13:37:06",2013-02-06 09:07:27,2010-02-01 10:32:08,2010-02-26 00:09:14,227
1080,220,286,1586,"24 days, 14:02:23",2013-02-06 02:21:40,2010-02-01 10:32:08,2010-02-26 00:34:31,2069
516,1045,1782,3343,"24 days, 14:15:15",2013-02-06 05:14:00,2010-02-01 10:32:08,2010-02-26 00:47:23,274
1923,2186,3030,7139,"24 days, 14:22:16",2013-02-06 00:26:24,2010-02-01 10:32:08,2010-02-26 00:54:24,1098
325,3316,5053,8694,"24 days, 14:30:28",2013-02-07 09:20:37,2010-02-01 10:32:08,2010-02-26 01:02:36,7925
418,948,1916,3282,"24 days, 14:37:25",2013-02-07 03:55:05,2010-02-01 10:32:08,2010-02-26 01:09:33,3534
475,3890,5206,9571,"24 days, 14:48:27",2013-02-08 03:09:42,2010-02-01 10:32:08,2010-02-26 01:20:35,4918
766,2073,2217,5056,"24 days, 14:59:59",2013-02-07 05:01:10,2010-02-01 10:32:08,2010-02-26 01:32:07,1136
28,2231,2685,4944,"24 days, 15:32:04",2013-02-07 00:45:15,2010-02-01 10:32:08,2010-02-26 02:04:12,6920
1195,3232,2483,6910,"24 days, 15:40:37",2013-02-07 04:25:13,2010-02-01 10:32:08,2010-02-26 02:12:45,5727
399,1845,2485,4729,"24 days, 15:49:19",2013-02-06 02:59:43,2010-02-01 10:32:08,2010-02-26 02:21:27,2846
515,8440,8013,16968,"24 days, 16:05:36",2013-02-16 04:31:16,2010-02-01 10:32:08,2010-02-26 02:37:44,2539
153,5120,6579,11852,"24 days, 16:10:15",2013-02-07 04:50:38,2010-02-01 10:32:08,2010-02-26 02:42:23,6632
330,3713,5900,9943,"24 days, 16:18:39",2013-02-07 07:12:59,2010-02-01 10:32:08,2010-02-26 02:50:47,9820
703,3133,4192,8028,"24 days, 16:37:42",2013-02-06 10:55:14,2010-02-01 10:32:08,2010-02-26 03:09:50,4976
240,7731,8462,16433,"24 days, 16:59:33",2013-02-07 07:08:19,2010-02-01 10:32:08,2010-02-26 03:31:41,659
2196,4162,4486,10844,"24 days, 17:27:00",2013-02-05 11:58:40,2013-02-05 11:58:40,2013-03-02 05:25:40,9312
253,2429,2813,5495,"24 days, 17:28:00",2013-02-05 11:57:40,2013-02-05 11:57:40,2013-03-02 05:25:40,1351
241,1284,1555,3080,"24 days, 17:28:15",2013-02-05 11:57:25,2013-02-05 11:57:25,2013-03-02 05:25:40,9248
1333,1872,2665,5870,"24 days, 17:28:53",2013-02-05 11:56:47,2013-02-05 11:56:47,2013-03-02 05:25:40,1021
756,1377,1602,3735,"24 days, 17:29:21",2013-02-05 11:56:19,2013-02-05 11:56:19,2013-03-02 05:25:40,4808
794,3904,3938,8636,"24 days, 17:33:38",2013-02-05 11:52:02,2013-02-05 11:52:02,2013-03-02 05:25:40,7333
165,2796,2858,5819,"24 days, 17:34:53",2013-02-06 09:54:47,2010-02-01 10:32:08,2010-02-26 04:07:01,4749
598,4296,4381,9275,"24 days, 17:34:58",2013-02-07 00:13:25,2010-02-01 10:32:08,2010-02-26 04:07:06,2122
803,4723,4184,9710,"24 days, 17:35:12",2013-02-05 11:50:28,2013-02-05 11:50:28,2013-03-02 05:25:40,7244
336,878,1158,2372,"24 days, 17:35:33",2013-02-05 11:50:07,2013-02-05 11:50:07,2013-03-02 05:25:40,8513
1066,1377,2716,5159,"24 days, 17:37:51",2013-02-05 11:47:49,2013-02-05 11:47:49,2013-03-02 05:25:40,4670
114,1207,1757,3078,"24 days, 17:42:00",2013-02-05 11:43:40,2013-02-05 11:43:40,2013-03-02 05:25:40,8301
371,135,684,1190,"24 days, 17:42:41",2013-02-05 11:42:59,2013-02-05 11:42:59,2013-03-02 05:25:40,5864
966,1489,1825,4280,"24 days, 17:42:47",2013-02-05 11:42:53,2013-02-05 11:42:53,2013-03-02 05:25:40,6944
60,4117,5434,9611,"24 days, 17:43:41",2013-02-05 11:41:59,2013-02-05 11:41:59,2013-03-02 05:25:40,8009
272,552,1214,2038,"24 days, 17:44:06",2013-02-05 11:41:34,2013-02-05 11:41:34,2013-03-02 05:25:40,8563
447,855,1605,2907,"24 days, 17:44:21",2013-02-05 11:41:19,2013-02-05 11:41:19,2013-03-02 05:25:40,8349
107,706,1538,2351,"24 days, 17:48:41",2013-02-05 11:36:59,2013-02-05 11:36:59,2013-03-02 05:25:40,1407
1569,4684,3569,9822,"24 days, 17:50:32",2013-02-05 11:35:08,2013-02-05 11:35:08,2013-03-02 05:25:40,2680
214,1236,2304,3754,"24 days, 17:51:05",2013-02-05 11:34:35,2013-02-05 11:34:35,2013-03-02 05:25:40,9719
267,881,2338,3486,"24 days, 17:51:41",2013-02-05 11:33:59,2013-02-05 11:33:59,2013-03-02 05:25:40,820
88,885,1480,2453,"24 days, 17:52:32",2013-02-05 11:33:08,2013-02-05 11:33:08,2013-03-02 05:25:40,1739
1059,4622,4569,10250,"24 days, 17:53:07",2013-02-05 11:32:33,2013-02-05 11:32:33,2013-03-02 05:25:40,8571
981,1915,2850,5746,"24 days, 17:53:32",2013-02-05 11:32:08,2013-02-05 11:32:08,2013-03-02 05:25:40,8099
344,846,1675,2865,"24 days, 17:57:49",2013-02-05 11:27:51,2013-02-05 11:27:51,2013-03-02 05:25:40,663
1496,609,1794,3899,"24 days, 17:58:46",2013-02-05 11:26:54,2013-02-05 11:26:54,2013-03-02 05:25:40,1047
174,367,570,1111,"24 days, 17:59:58",2013-02-05 11:25:42,2013-02-05 11:25:42,2013-03-02 05:25:40,226
288,2266,2806,5360,"24 days, 18:00:29",2013-02-05 11:25:11,2013-02-05 11:25:11,2013-03-02 05:25:40,413
684,4787,5621,11092,"24 days, 18:00:29",2013-02-05 11:25:11,2013-02-05 11:25:11,2013-03-02 05:25:40,7344
845,841,1535,3221,"24 days, 18:01:06",2013-02-05 11:24:34,2013-02-05 11:24:34,2013-03-02 05:25:40,826
777,725,1672,3174,"24 days, 18:01:29",2013-02-05 11:24:11,2013-02-05 11:24:11,2013-03-02 05:25:40,9102
1881,1864,2815,6560,"24 days, 18:03:01",2013-02-05 11:22:39,2013-02-05 11:22:39,2013-03-02 05:25:40,9924
1141,897,1583,3621,"24 days, 18:03:33",2013-02-05 11:22:07,2013-02-05 11:22:07,2013-03-02 05:25:40,5933
1393,3381,4804,9578,"24 days, 18:04:06",2013-02-05 11:21:34,2013-02-05 11:21:34,2013-03-02 05:25:40,699
1275,415,1126,2816,"24 days, 18:05:46",2013-02-05 11:19:54,2013-02-05 11:19:54,2013-03-02 05:25:40,9307
1540,4208,6258,12006,"24 days, 18:06:12",2013-02-05 11:19:28,2013-02-05 11:19:28,2013-03-02 05:25:40,43
575,1690,2735,5000,"24 days, 18:06:57",2013-02-05 11:18:43,2013-02-05 11:18:43,2013-03-02 05:25:40,2155
1513,755,1122,3390,"24 days, 18:12:29",2013-02-05 11:13:11,2013-02-05 11:13:11,2013-03-02 05:25:40,6168
1033,1417,2051,4501,"24 days, 18:13:00",2013-02-05 11:12:40,2013-02-05 11:12:40,2013-03-02 05:25:40,8360
475,2486,3181,6142,"24 days, 18:14:05",2013-02-05 11:11:35,2013-02-05 11:11:35,2013-03-02 05:25:40,7953
241,9764,10747,20752,"24 days, 18:14:41",2013-02-07 05:54:24,2010-02-01 10:32:08,2010-02-26 04:46:49,2651
1135,1714,1939,4788,"24 days, 18:14:56",2013-02-05 11:10:44,2013-02-05 11:10:44,2013-03-02 05:25:40,5999
43,2020,2929,4992,"24 days, 18:15:34",2013-02-05 11:10:06,2013-02-05 11:10:06,2013-03-02 05:25:40,2028
243,4614,4523,9380,"24 days, 18:17:29",2013-02-05 11:08:11,2013-02-05 11:08:11,2013-03-02 05:25:40,191
511,3155,5298,8964,"24 days, 18:17:34",2013-02-07 09:58:49,2010-02-01 10:32:08,2010-02-26 04:49:42,2175
1516,6286,6716,14518,"24 days, 18:17:40",2013-02-05 11:08:00,2013-02-05 11:08:00,2013-03-02 05:25:40,6774
59,1154,1950,3163,"24 days, 18:17:50",2013-02-05 11:07:50,2013-02-05 11:07:50,2013-03-02 05:25:40,6127
86,3091,3380,6557,"24 days, 18:18:51",2013-02-05 11:06:49,2013-02-05 11:06:49,2013-03-02 05:25:40,6594
17,362,750,1129,"24 days, 18:19:52",2013-02-05 11:05:48,2013-02-05 11:05:48,2013-03-02 05:25:40,9716
25,2124,2454,4603,"24 days, 18:21:39",2013-02-05 11:04:01,2013-02-05 11:04:01,2013-03-02 05:25:40,4325
471,1480,2279,4230,"24 days, 18:22:02",2013-02-05 11:03:38,2013-02-05 11:03:38,2013-03-02 05:25:40,519
9,1949,3308,5266,"24 days, 18:27:06",2013-02-05 10:58:34,2013-02-05 10:58:34,2013-03-02 05:25:40,915
195,459,559,1213,"24 days, 18:28:18",2013-02-05 10:57:22,2013-02-05 10:57:22,2013-03-02 05:25:40,4336
334,1237,1846,3417,"24 days, 18:28:31",2013-02-05 10:57:09,2013-02-05 10:57:09,2013-03-02 05:25:40,3127
561,755,1028,2344,"24 days, 18:28:50",2013-02-05 10:56:50,2013-02-05 10:56:50,2013-03-02 05:25:40,5325
126,1445,2103,3674,"24 days, 18:29:57",2013-02-05 10:55:43,2013-02-05 10:55:43,2013-03-02 05:25:40,1632
772,3621,3920,8313,"24 days, 18:31:51",2013-02-05 10:53:49,2013-02-05 10:53:49,2013-03-02 05:25:40,1511
1127,11987,6417,19531,"24 days, 18:33:42",2013-02-07 01:23:07,2010-03-21 09:35:47,2010-04-15 04:09:29,7345
1208,983,1495,3686,"24 days, 18:34:01",2013-02-05 10:51:39,2013-02-05 10:51:39,2013-03-02 05:25:40,9868
115,4247,4529,8891,"24 days, 18:34:31",2013-02-05 10:51:09,2013-02-05 10:51:09,2013-03-02 05:25:40,1570
62,1280,1816,3158,"24 days, 18:36:14",2013-02-05 10:49:26,2013-02-05 10:49:26,2013-03-02 05:25:40,8849
355,781,1562,2698,"24 days, 18:38:54",2013-02-05 10:46:46,2013-02-05 10:46:46,2013-03-02 05:25:40,9591
358,7462,6970,14790,"24 days, 18:40:30",2013-02-05 10:45:10,2013-02-05 10:45:10,2013-03-02 05:25:40,6796
861,1076,1490,3427,"24 days, 18:40:47",2013-02-05 10:44:53,2013-02-05 10:44:53,2013-03-02 05:25:40,5297
719,2696,3308,6723,"24 days, 18:41:44",2013-02-06 09:49:40,2010-02-01 10:32:08,2010-02-26 05:13:52,1919
760,1962,3633,6355,"24 days, 18:44:30",2013-02-05 10:41:10,2013-02-05 10:41:10,2013-03-02 05:25:40,2438
1007,3916,4349,9272,"24 days, 18:45:50",2013-02-05 10:39:50,2013-02-05 10:39:50,2013-03-02 05:25:40,7514
1464,501,1220,3185,"24 days, 18:47:46",2013-02-05 10:37:54,2013-02-05 10:37:54,2013-03-02 05:25:40,7203
12,232,563,807,"24 days, 18:48:35",2013-02-10 00:29:24,2010-07-06 05:33:17,2010-07-31 00:21:52,4255
185,1558,2746,4489,"24 days, 18:50:00",2013-02-05 10:35:40,2013-02-05 10:35:40,2013-03-02 05:25:40,5984
742,3677,3573,7992,"24 days, 18:51:10",2013-02-05 10:34:30,2013-02-05 10:34:30,2013-03-02 05:25:40,5547
494,9484,7511,17489,"24 days, 18:52:03",2013-02-05 10:33:37,2013-02-05 10:33:37,2013-03-02 05:25:40,8275
1307,1568,1519,4394,"24 days, 18:57:30",2013-02-05 10:28:10,2013-02-05 10:28:10,2013-03-02 05:25:40,3071
482,1066,1464,3012,"24 days, 18:58:05",2013-02-05 10:27:35,2013-02-05 10:27:35,2013-03-02 05:25:40,4272
94,3852,4575,8521,"24 days, 18:58:44",2013-02-05 10:26:56,2013-02-05 10:26:56,2013-03-02 05:25:40,4701
152,516,579,1247,"24 days, 18:59:03",2013-02-05 10:26:37,2013-02-05 10:26:37,2013-03-02 05:25:40,9867
114,2599,3216,5929,"24 days, 18:59:09",2013-02-05 10:26:31,2013-02-05 10:26:31,2013-03-02 05:25:40,5152
930,1078,1632,3640,"24 days, 19:00:46",2013-02-05 10:24:54,2013-02-05 10:24:54,2013-03-02 05:25:40,9071
25,1286,1446,2757,"24 days, 19:01:32",2013-02-05 10:24:08,2013-02-05 10:24:08,2013-03-02 05:25:40,454
1435,2422,2859,6716,"24 days, 19:05:01",2013-02-05 10:20:39,2013-02-05 10:20:39,2013-03-02 05:25:40,6488
662,1661,2674,4997,"24 days, 19:06:00",2013-02-05 10:19:40,2013-02-05 10:19:40,2013-03-02 05:25:40,8057
1589,2659,4431,8679,"24 days, 19:06:19",2013-02-05 10:19:21,2013-02-05 10:19:21,2013-03-02 05:25:40,73
144,838,679,1661,"24 days, 19:10:00",2013-02-05 10:15:40,2013-02-05 10:15:40,2013-03-02 05:25:40,7822
2796,8208,7225,18229,"24 days, 19:10:28",2013-02-05 10:15:12,2013-02-05 10:15:12,2013-03-02 05:25:40,9615
329,4396,3951,8676,"24 days, 19:11:31",2013-02-05 10:14:09,2013-02-05 10:14:09,2013-03-02 05:25:40,5698
189,3911,3994,8094,"24 days, 19:12:44",2013-02-05 10:12:56,2013-02-05 10:12:56,2013-03-02 05:25:40,5705
1180,2959,5130,9269,"24 days, 19:13:52",2013-02-05 10:11:48,2013-02-05 10:11:48,2013-03-02 05:25:40,9922
708,2545,3164,6417,"24 days, 19:17:05",2013-02-05 10:08:35,2013-02-05 10:08:35,2013-03-02 05:25:40,345
124,2480,3190,5794,"24 days, 19:20:57",2013-02-05 10:04:43,2013-02-05 10:04:43,2013-03-02 05:25:40,1270
160,4469,6783,11412,"24 days, 19:23:09",2013-02-06 10:38:48,2010-02-01 10:32:08,2010-02-26 05:55:17,4633
1605,2077,4202,7884,"24 days, 19:23:23",2013-02-05 10:02:17,2013-02-05 10:02:17,2013-03-02 05:25:40,4877
35,4399,5149,9583,"24 days, 19:24:42",2013-02-05 10:00:58,2013-02-05 10:00:58,2013-03-02 05:25:40,8190
1357,5126,6573,13056,"24 days, 19:24:47",2013-02-05 10:00:53,2013-02-05 10:00:53,2013-03-02 05:25:40,870
594,5877,5621,12092,"24 days, 19:24:52",2013-02-05 10:00:48,2013-02-05 10:00:48,2013-03-02 05:25:40,5420
1873,6265,6697,14835,"24 days, 19:25:26",2013-02-05 10:00:14,2013-02-05 10:00:14,2013-03-02 05:25:40,305
1076,518,852,2446,"24 days, 19:29:25",2013-02-05 09:56:15,2013-02-05 09:56:15,2013-03-02 05:25:40,4260
185,1244,1531,2960,"24 days, 19:29:29",2013-02-05 09:56:11,2013-02-05 09:56:11,2013-03-02 05:25:40,1740
399,3297,3801,7497,"24 days, 19:29:42",2013-02-05 09:55:58,2013-02-05 09:55:58,2013-03-02 05:25:40,1377
1341,1236,2439,5016,"24 days, 19:34:32",2013-02-06 09:56:23,2010-02-01 10:32:08,2010-02-26 06:06:40,4595
200,2684,4403,7287,"24 days, 19:36:45",2013-02-05 09:48:55,2013-02-05 09:48:55,2013-03-02 05:25:40,4604
1299,2304,2932,6535,"24 days, 19:37:17",2013-02-05 09:48:23,2013-02-05 09:48:23,2013-03-02 05:25:40,1057
380,1322,1881,3583,"24 days, 19:41:04",2013-02-05 09:44:36,2013-02-05 09:44:36,2013-03-02 05:25:40,5375
547,374,828,1749,"24 days, 19:41:09",2013-02-05 09:44:31,2013-02-05 09:44:31,2013-03-02 05:25:40,3232
141,382,664,1187,"24 days, 19:41:14",2013-02-05 09:44:26,2013-02-05 09:44:26,2013-03-02 05:25:40,9891
626,1311,2042,3979,"24 days, 19:42:46",2013-02-05 09:42:54,2013-02-05 09:42:54,2013-03-02 05:25:40,5493
159,800,971,1930,"24 days, 19:43:54",2013-02-05 09:41:46,2013-02-05 09:41:46,2013-03-02 05:25:40,6240
73,1889,2932,4894,"24 days, 19:44:45",2013-02-05 09:40:55,2013-02-05 09:40:55,2013-03-02 05:25:40,2782
576,653,1226,2455,"24 days, 19:44:55",2013-02-05 09:40:45,2013-02-05 09:40:45,2013-03-02 05:25:40,8155
943,3854,6210,11007,"24 days, 19:48:13",2013-02-05 09:37:27,2013-02-05 09:37:27,2013-03-02 05:25:40,590
444,1809,2051,4304,"24 days, 19:50:30",2013-02-05 09:35:10,2013-02-05 09:35:10,2013-03-02 05:25:40,1593
314,1542,2287,4143,"24 days, 19:52:00",2013-02-05 09:33:40,2013-02-05 09:33:40,2013-03-02 05:25:40,6289
1693,3034,4960,9687,"24 days, 19:52:19",2013-02-05 09:33:21,2013-02-05 09:33:21,2013-03-02 05:25:40,2110
947,3256,4305,8508,"24 days, 19:52:29",2013-02-05 09:33:11,2013-02-05 09:33:11,2013-03-02 05:25:40,4920
406,2389,3078,5873,"24 days, 19:56:00",2013-02-05 09:29:40,2013-02-05 09:29:40,2013-03-02 05:25:40,5896
2391,3972,4597,10960,"24 days, 19:57:03",2013-02-07 03:36:34,2010-02-01 10:32:08,2010-02-26 06:29:11,8515
30,587,1417,2034,"24 days, 19:57:06",2013-02-05 09:28:34,2013-02-05 09:28:34,2013-03-02 05:25:40,4311
33,3070,2946,6049,"24 days, 19:59:17",2013-02-05 09:26:23,2013-02-05 09:26:23,2013-03-02 05:25:40,1122
713,1329,2562,4604,"24 days, 20:00:42",2013-02-05 09:24:58,2013-02-05 09:24:58,2013-03-02 05:25:40,193
3,1458,2029,3490,"24 days, 20:01:07",2013-02-05 11:23:37,2010-02-01 10:32:08,2010-02-26 06:33:15,8342
1018,5734,7051,13803,"24 days, 20:01:53",2013-02-05 09:23:47,2013-02-05 09:23:47,2013-03-02 05:25:40,1013
372,848,1281,2501,"24 days, 20:04:34",2013-02-05 09:21:06,2013-02-05 09:21:06,2013-03-02 05:25:40,1259
483,640,1175,2298,"24 days, 20:08:11",2013-02-05 09:17:29,2013-02-05 09:17:29,2013-03-02 05:25:40,7531
872,6055,6740,13667,"24 days, 20:08:57",2013-02-05 10:31:56,2010-02-01 10:32:08,2010-02-26 06:41:05,3165
727,1630,1620,3977,"24 days, 20:09:31",2013-02-05 09:16:09,2013-02-05 09:16:09,2013-03-02 05:25:40,929
230,5076,7887,13193,"24 days, 20:09:51",2013-02-06 11:05:56,2010-02-01 10:32:08,2010-02-26 06:41:59,76
677,134,590,1401,"24 days, 20:10:40",2013-02-05 09:15:00,2013-02-05 09:15:00,2013-03-02 05:25:40,3098
924,3032,4433,8389,"24 days, 20:11:09",2013-02-05 09:14:31,2013-02-05 09:14:31,2013-03-02 05:25:40,2661
744,403,645,1792,"24 days, 20:11:14",2013-02-05 09:14:26,2013-02-05 09:14:26,2013-03-02 05:25:40,7493
818,969,1358,3145,"24 days, 20:15:31",2013-02-05 09:10:09,2013-02-05 09:10:09,2013-03-02 05:25:40,9753
734,989,1137,2860,"24 days, 20:16:11",2013-02-05 09:09:29,2013-02-05 09:09:29,2013-03-02 05:25:40,4282
289,4348,2768,7405,"24 days, 20:18:27",2013-02-05 09:07:13,2013-02-05 09:07:13,2013-03-02 05:25:40,1723
8,630,933,1571,"24 days, 20:18:45",2013-02-05 09:06:55,2013-02-05 09:06:55,2013-03-02 05:25:40,6055
1947,1606,1902,5455,"24 days, 20:18:53",2013-02-05 09:06:47,2013-02-05 09:06:47,2013-03-02 05:25:40,7473
758,1674,2587,5019,"24 days, 20:20:15",2013-02-05 09:05:25,2013-02-05 09:05:25,2013-03-02 05:25:40,6798
146,994,1390,2530,"24 days, 20:21:30",2013-02-05 09:04:10,2013-02-05 09:04:10,2013-03-02 05:25:40,8214
32,403,1572,2007,"24 days, 20:22:59",2013-02-07 10:37:46,2010-02-01 10:32:08,2010-02-26 06:55:07,8514
758,3264,4279,8301,"24 days, 20:23:59",2013-02-05 09:01:41,2013-02-05 09:01:41,2013-03-02 05:25:40,5709
961,881,1274,3116,"24 days, 20:27:09",2013-02-05 08:58:31,2013-02-05 08:58:31,2013-03-02 05:25:40,3538
402,5932,4762,11096,"24 days, 20:28:48",2013-02-07 05:36:27,2010-02-01 10:32:08,2010-02-26 07:00:56,3470
373,4182,5145,9700,"24 days, 20:33:04",2013-02-06 01:42:54,2010-02-06 03:56:33,2010-03-03 00:29:37,9412
1457,2761,3542,7760,"24 days, 20:34:53",2013-02-05 08:50:47,2013-02-05 08:50:47,2013-03-02 05:25:40,6970
1093,3591,4904,9588,"24 days, 20:35:11",2013-02-05 08:50:29,2013-02-05 08:50:29,2013-03-02 05:25:40,1871
1110,1050,1678,3838,"24 days, 20:36:36",2013-02-05 08:49:04,2013-02-05 08:49:04,2013-03-02 05:25:40,3924
324,1788,2291,4403,"24 days, 20:39:00",2013-02-05 08:46:40,2013-02-05 08:46:40,2013-03-02 05:25:40,2210
52,5980,5416,11448,"24 days, 20:40:00",2013-02-05 08:45:40,2013-02-05 08:45:40,2013-03-02 05:25:40,7133
802,330,503,1635,"24 days, 20:41:30",2013-02-05 08:44:10,2013-02-05 08:44:10,2013-03-02 05:25:40,7295
241,2839,3388,6468,"24 days, 20:42:59",2013-02-05 08:42:41,2013-02-05 08:42:41,2013-03-02 05:25:40,4449
90,706,1228,2024,"24 days, 20:44:38",2013-02-05 08:41:02,2013-02-05 08:41:02,2013-03-02 05:25:40,321
33,2833,2531,5397,"24 days, 20:45:11",2013-02-05 08:40:29,2013-02-05 08:40:29,2013-03-02 05:25:40,286
73,1932,2284,4289,"24 days, 20:45:14",2013-02-05 08:40:26,2013-02-05 08:40:26,2013-03-02 05:25:40,6568
1838,3187,4384,9409,"24 days, 20:46:02",2013-02-05 08:39:38,2013-02-05 08:39:38,2013-03-02 05:25:40,3472
403,1966,2961,5330,"24 days, 20:49:17",2013-02-05 08:36:23,2013-02-05 08:36:23,2013-03-02 05:25:40,2985
47,69,380,496,"24 days, 20:49:37",2013-02-28 06:59:35,2013-02-03 10:09:58,2013-02-28 06:59:35,1999
329,3530,2549,6408,"24 days, 20:49:59",2013-02-05 08:35:41,2013-02-05 08:35:41,2013-03-02 05:25:40,612
337,2980,4356,7673,"24 days, 20:50:11",2013-02-05 08:35:29,2013-02-05 08:35:29,2013-03-02 05:25:40,91
320,887,1312,2519,"24 days, 20:52:09",2013-02-05 08:33:31,2013-02-05 08:33:31,2013-03-02 05:25:40,7504
112,2265,2932,5309,"24 days, 20:52:35",2013-02-05 08:33:05,2013-02-05 08:33:05,2013-03-02 05:25:40,6517
59,2066,4260,6385,"24 days, 20:52:42",2013-02-05 08:32:58,2013-02-05 08:32:58,2013-03-02 05:25:40,3428
725,2518,3252,6495,"24 days, 20:53:41",2013-02-05 08:31:59,2013-02-05 08:31:59,2013-03-02 05:25:40,6361
1334,2659,2352,6345,"24 days, 20:55:32",2013-02-05 08:30:08,2013-02-05 08:30:08,2013-03-02 05:25:40,8537
872,2289,2551,5712,"24 days, 20:56:13",2013-02-05 08:29:27,2013-02-05 08:29:27,2013-03-02 05:25:40,6856
1327,1302,2118,4747,"24 days, 21:02:20",2013-02-05 08:23:20,2013-02-05 08:23:20,2013-03-02 05:25:40,8820
141,1196,1647,2984,"24 days, 21:07:07",2013-02-05 08:18:33,2013-02-05 08:18:33,2013-03-02 05:25:40,3937
1288,1867,1511,4666,"24 days, 21:07:29",2013-02-05 08:18:11,2013-02-05 08:18:11,2013-03-02 05:25:40,6726
193,397,806,1396,"24 days, 21:18:12",2013-02-05 08:07:28,2013-02-05 08:07:28,2013-03-02 05:25:40,6986
414,417,615,1446,"24 days, 21:18:16",2013-02-05 08:07:24,2013-02-05 08:07:24,2013-03-02 05:25:40,444
455,674,1086,2215,"24 days, 21:19:16",2013-02-07 03:10:33,2010-02-01 10:32:08,2010-02-26 07:51:24,3611
1546,981,1788,4315,"24 days, 21:19:30",2013-02-05 08:06:10,2013-02-05 08:06:10,2013-03-02 05:25:40,4978
77,294,694,1065,"24 days, 21:19:38",2013-02-05 08:06:02,2013-02-05 08:06:02,2013-03-02 05:25:40,4680
1138,536,1093,2767,"24 days, 21:21:05",2013-02-05 08:04:35,2013-02-05 08:04:35,2013-03-02 05:25:40,7963
163,1594,1948,3705,"24 days, 21:23:32",2013-02-07 09:19:45,2010-02-01 10:32:08,2010-02-26 07:55:40,5076
253,672,1127,2052,"24 days, 21:24:10",2013-02-05 08:01:30,2013-02-05 08:01:30,2013-03-02 05:25:40,408
409,287,643,1339,"24 days, 21:24:25",2013-02-05 08:01:15,2013-02-05 08:01:15,2013-03-02 05:25:40,5137
344,4990,5156,10490,"24 days, 21:24:30",2013-02-08 04:07:18,2010-02-01 10:32:08,2010-02-26 07:56:38,8686
1569,654,1363,3586,"24 days, 21:30:06",2013-02-05 07:55:34,2013-02-05 07:55:34,2013-03-02 05:25:40,4625
1157,7595,7007,15759,"24 days, 21:31:33",2013-02-05 07:54:07,2013-02-05 07:54:07,2013-03-02 05:25:40,5326
38,8301,8847,17186,"24 days, 21:34:24",2013-02-05 07:51:16,2013-02-05 07:51:16,2013-03-02 05:25:40,5922
365,1974,3721,6060,"24 days, 21:34:30",2013-02-05 07:51:10,2013-02-05 07:51:10,2013-03-02 05:25:40,7343
185,3766,6490,10441,"24 days, 21:35:53",2013-02-07 07:24:19,2010-02-01 10:32:08,2010-02-26 08:08:01,4163
284,3381,3036,6701,"24 days, 21:36:07",2013-02-05 07:49:33,2013-02-05 07:49:33,2013-03-02 05:25:40,4972
1050,961,1894,3905,"24 days, 21:36:46",2013-02-05 07:48:54,2013-02-05 07:48:54,2013-03-02 05:25:40,6128
1163,7142,9101,17406,"24 days, 21:38:07",2013-02-05 07:47:33,2013-02-05 07:47:33,2013-03-02 05:25:40,8808
640,1348,1925,3913,"24 days, 21:41:37",2013-02-05 07:44:03,2013-02-05 07:44:03,2013-03-02 05:25:40,5780
2114,3112,3480,8706,"24 days, 21:41:59",2013-02-05 07:43:41,2013-02-05 07:43:41,2013-03-02 05:25:40,670
1166,1226,1706,4098,"24 days, 21:42:14",2013-02-05 07:43:26,2013-02-05 07:43:26,2013-03-02 05:25:40,6711
868,2564,3338,6770,"24 days, 21:42:58",2013-02-05 07:42:42,2013-02-05 07:42:42,2013-03-02 05:25:40,3074
208,1010,1679,2897,"24 days, 21:43:25",2013-02-05 07:42:15,2013-02-05 07:42:15,2013-03-02 05:25:40,6211
1911,6805,7944,16660,"24 days, 21:46:34",2013-02-05 07:39:06,2013-02-05 07:39:06,2013-03-02 05:25:40,9866
246,2391,2352,4989,"24 days, 21:46:35",2013-02-06 00:49:02,2010-02-22 10:23:01,2010-03-19 08:09:36,9933
922,422,949,2293,"24 days, 21:48:15",2013-02-05 07:37:25,2013-02-05 07:37:25,2013-03-02 05:25:40,5613
139,1687,3176,5002,"24 days, 21:48:41",2013-02-05 07:36:59,2013-02-05 07:36:59,2013-03-02 05:25:40,4649
1805,1057,2463,5325,"24 days, 21:49:33",2013-02-05 07:36:07,2013-02-05 07:36:07,2013-03-02 05:25:40,4136
326,1460,2377,4163,"24 days, 21:52:37",2013-02-05 07:33:03,2013-02-05 07:33:03,2013-03-02 05:25:40,3796
1257,4504,4228,9989,"24 days, 21:56:13",2013-02-05 07:29:27,2013-02-05 07:29:27,2013-03-02 05:25:40,2911
206,2069,3018,5293,"24 days, 22:01:56",2013-02-06 08:03:11,2010-02-01 10:32:08,2010-02-26 08:34:04,5410
364,310,824,1498,"24 days, 22:03:16",2013-02-05 07:22:24,2013-02-05 07:22:24,2013-03-02 05:25:40,4195
138,2161,2318,4617,"24 days, 22:03:53",2013-02-05 07:21:47,2013-02-05 07:21:47,2013-03-02 05:25:40,6991
1471,1090,1984,4545,"24 days, 22:04:27",2013-02-05 07:21:13,2013-02-05 07:21:13,2013-03-02 05:25:40,2915
1529,1885,2203,5617,"24 days, 22:07:22",2013-02-05 07:18:18,2013-02-05 07:18:18,2013-03-02 05:25:40,5699
804,370,952,2126,"24 days, 22:08:31",2013-02-05 07:17:09,2013-02-05 07:17:09,2013-03-02 05:25:40,1316
859,4916,8104,13879,"24 days, 22:09:45",2013-02-05 07:15:55,2013-02-05 07:15:55,2013-03-02 05:25:40,8254
510,330,584,1424,"24 days, 22:10:15",2013-02-05 07:15:25,2013-02-05 07:15:25,2013-03-02 05:25:40,7167
630,3177,4855,8662,"24 days, 22:15:40",2013-02-05 07:10:00,2013-02-05 07:10:00,2013-03-02 05:25:40,6610
1529,2222,3925,7676,"24 days, 22:16:15",2013-02-05 07:09:25,2013-02-05 07:09:25,2013-03-02 05:25:40,64
673,571,736,1980,"24 days, 22:16:41",2013-02-05 07:08:59,2013-02-05 07:08:59,2013-03-02 05:25:40,6066
247,1525,2166,3938,"24 days, 22:16:52",2013-02-05 08:17:06,2010-02-01 10:32:08,2010-02-26 08:49:00,7149
340,422,778,1540,"24 days, 22:19:57",2013-02-05 07:05:43,2013-02-05 07:05:43,2013-03-02 05:25:40,4471
1703,10674,12219,24596,"24 days, 22:22:15",2013-02-07 05:03:47,2010-02-01 10:32:08,2010-02-26 08:54:23,9404
468,1463,1609,3540,"24 days, 22:26:03",2013-02-05 06:59:37,2013-02-05 06:59:37,2013-03-02 05:25:40,7463
1358,4389,5937,11684,"24 days, 22:31:03",2013-02-05 06:54:37,2013-02-05 06:54:37,2013-03-02 05:25:40,6355
250,1435,1367,3052,"24 days, 22:33:09",2013-02-05 06:52:31,2013-02-05 06:52:31,2013-03-02 05:25:40,5037
1075,8617,5365,15057,"24 days, 22:39:38",2013-02-07 11:03:48,2010-02-01 10:32:08,2010-02-26 09:11:46,8095
62,1059,1776,2897,"24 days, 22:39:44",2013-02-05 06:45:56,2013-02-05 06:45:56,2013-03-02 05:25:40,8971
519,4538,5006,10063,"24 days, 22:42:18",2013-02-05 06:43:22,2013-02-05 06:43:22,2013-03-02 05:25:40,398
321,386,1900,2607,"24 days, 22:44:01",2013-02-05 06:41:39,2013-02-05 06:41:39,2013-03-02 05:25:40,1505
286,752,1211,2249,"24 days, 22:44:21",2013-02-05 06:41:19,2013-02-05 06:41:19,2013-03-02 05:25:40,4989
596,4609,5503,10708,"24 days, 22:46:28",2013-02-07 02:01:27,2010-02-01 10:32:08,2010-02-26 09:18:36,1110
0,456,702,1158,"24 days, 22:47:52",2013-02-05 06:37:48,2013-02-05 06:37:48,2013-03-02 05:25:40,1330
91,481,1028,1600,"24 days, 22:48:17",2013-02-05 06:37:23,2013-02-05 06:37:23,2013-03-02 05:25:40,3600
1620,3407,5091,10118,"24 days, 22:51:09",2013-02-05 06:34:31,2013-02-05 06:34:31,2013-03-02 05:25:40,7209
109,1907,3027,5043,"24 days, 22:57:44",2013-02-05 06:27:56,2013-02-05 06:27:56,2013-03-02 05:25:40,9988
401,583,771,1755,"24 days, 22:58:26",2013-02-05 06:27:14,2013-02-05 06:27:14,2013-03-02 05:25:40,1690
337,3140,2762,6239,"24 days, 22:59:36",2013-02-05 06:26:04,2013-02-05 06:26:04,2013-03-02 05:25:40,21
50,8722,7739,16511,"24 days, 23:04:53",2013-02-07 06:39:31,2010-02-01 10:32:08,2010-02-26 09:37:01,5610
940,312,961,2213,"24 days, 23:05:40",2013-02-05 06:20:00,2013-02-05 06:20:00,2013-03-02 05:25:40,5779
127,1380,2198,3705,"24 days, 23:06:34",2013-02-05 06:19:06,2013-02-05 06:19:06,2013-03-02 05:25:40,9118
285,780,1012,2077,"24 days, 23:11:22",2013-02-05 06:14:18,2013-02-05 06:14:18,2013-03-02 05:25:40,4456
888,1888,2305,5081,"24 days, 23:12:05",2013-02-05 10:47:46,2010-02-11 09:26:06,2010-03-08 08:38:11,8422
265,1769,2882,4916,"24 days, 23:19:29",2013-02-08 00:08:44,2010-02-01 10:32:08,2010-02-26 09:51:37,9769
818,2832,3144,6794,"24 days, 23:21:17",2013-02-05 06:04:23,2013-02-05 06:04:23,2013-03-02 05:25:40,3083
868,1309,2440,4617,"24 days, 23:26:44",2013-02-06 09:35:47,2010-02-01 10:32:08,2010-02-26 09:58:52,8476
426,1561,2037,4024,"24 days, 23:27:24",2013-02-05 05:58:16,2013-02-05 05:58:16,2013-03-02 05:25:40,9654
1580,698,1641,3919,"24 days, 23:28:22",2013-02-05 05:57:18,2013-02-05 05:57:18,2013-03-02 05:25:40,1822
40,681,1613,2334,"24 days, 23:28:39",2013-02-05 05:57:01,2013-02-05 05:57:01,2013-03-02 05:25:40,4820
1139,1727,2111,4977,"24 days, 23:30:43",2013-02-05 05:54:57,2013-02-05 05:54:57,2013-03-02 05:25:40,5399
104,1884,1997,3985,"24 days, 23:31:25",2013-02-05 05:54:15,2013-02-05 05:54:15,2013-03-02 05:25:40,200
602,1634,1837,4073,"24 days, 23:31:27",2013-02-05 05:54:13,2013-02-05 05:54:13,2013-03-02 05:25:40,6150
649,2650,3929,7228,"24 days, 23:32:54",2013-02-07 08:01:36,2010-03-01 11:35:40,2010-03-26 11:08:34,7131
720,4992,6985,12697,"24 days, 23:33:53",2013-02-07 01:33:41,2010-02-01 10:32:08,2010-02-26 10:06:01,2221
568,689,1263,2520,"24 days, 23:35:35",2013-02-05 05:50:05,2013-02-05 05:50:05,2013-03-02 05:25:40,9087
76,3569,2953,6598,"24 days, 23:38:55",2013-02-05 05:46:45,2013-02-05 05:46:45,2013-03-02 05:25:40,7040
701,705,1571,2977,"24 days, 23:39:23",2013-02-05 05:46:17,2013-02-05 05:46:17,2013-03-02 05:25:40,4262
481,1010,3176,4667,"24 days, 23:40:23",2013-02-05 05:45:17,2013-02-05 05:45:17,2013-03-02 05:25:40,9408
83,618,1607,2308,"24 days, 23:46:21",2013-02-05 05:39:19,2013-02-05 05:39:19,2013-03-02 05:25:40,6799
116,681,1567,2364,"24 days, 23:47:11",2013-02-07 11:02:13,2010-02-01 10:32:08,2010-02-26 10:19:19,4256
421,170,667,1258,"24 days, 23:51:08",2013-02-05 05:34:32,2013-02-05 05:34:32,2013-03-02 05:25:40,164
1004,1767,3660,6431,"24 days, 23:53:16",2013-02-05 05:32:24,2013-02-05 05:32:24,2013-03-02 05:25:40,2461
553,330,815,1698,"24 days, 23:53:36",2013-02-05 05:32:04,2013-02-05 05:32:04,2013-03-02 05:25:40,632
2489,6218,5564,14271,"24 days, 23:55:13",2013-02-07 08:57:55,2010-02-01 10:32:08,2010-02-26 10:27:21,3302
17,584,1030,1631,"24 days, 23:57:19",2013-02-06 09:37:38,2010-02-01 10:32:08,2010-02-26 10:29:27,8652
1548,3007,5094,9649,"24 days, 23:57:49",2013-02-07 01:13:27,2010-02-01 10:32:08,2010-02-26 10:29:57,8181
221,185,488,894,"24 days, 23:58:24",2013-02-06 11:12:51,2010-02-01 10:32:08,2010-02-26 10:30:32,2408
1357,237,724,2318,"25 days, 0:00:12",2013-02-05 05:25:28,2013-02-05 05:25:28,2013-03-02 05:25:40,1378
766,957,1749,3472,"25 days, 0:02:29",2013-02-05 05:23:11,2013-02-05 05:23:11,2013-03-02 05:25:40,1074
1246,1538,1420,4204,"25 days, 0:03:33",2013-02-05 05:22:07,2013-02-05 05:22:07,2013-03-02 05:25:40,1312
40,3346,4139,7525,"25 days, 0:06:28",2013-02-05 05:19:12,2013-02-05 05:19:12,2013-03-02 05:25:40,9360
16,3001,2457,5474,"25 days, 0:10:53",2013-02-07 06:43:23,2010-02-01 10:32:08,2010-02-26 10:43:01,5356
1928,1225,1913,5066,"25 days, 0:18:54",2013-02-05 05:06:46,2013-02-05 05:06:46,2013-03-02 05:25:40,9588
486,1433,1992,3911,"25 days, 0:20:24",2013-02-07 11:25:35,2010-02-01 10:32:08,2010-02-26 10:52:32,8067
391,1501,1613,3505,"25 days, 0:22:16",2013-02-05 05:03:24,2013-02-05 05:03:24,2013-03-02 05:25:40,8187
1158,305,700,2163,"25 days, 0:22:57",2013-02-05 05:02:43,2013-02-05 05:02:43,2013-03-02 05:25:40,4792
795,2252,2397,5444,"25 days, 0:24:39",2013-02-05 05:01:01,2013-02-05 05:01:01,2013-03-02 05:25:40,6631
832,8138,6895,15865,"25 days, 0:26:25",2013-02-07 00:07:07,2010-02-01 10:32:08,2010-02-26 10:58:33,4708
1510,2945,3605,8060,"25 days, 0:27:03",2013-02-05 04:58:37,2013-02-05 04:58:37,2013-03-02 05:25:40,5216
765,2387,2315,5467,"25 days, 0:28:28",2013-02-05 07:59:11,2010-02-01 10:32:08,2010-02-26 11:00:36,6685
400,3258,3666,7324,"25 days, 0:28:51",2013-02-15 05:30:35,2010-02-01 10:32:08,2010-02-26 11:00:59,7403
232,1091,1577,2900,"25 days, 0:31:18",2013-02-05 04:54:22,2013-02-05 04:54:22,2013-03-02 05:25:40,4683
870,6340,6714,13924,"25 days, 0:31:53",2013-02-05 04:53:47,2013-02-05 04:53:47,2013-03-02 05:25:40,866
1580,971,1438,3989,"25 days, 0:32:23",2013-02-05 04:53:17,2013-02-05 04:53:17,2013-03-02 05:25:40,6940
274,6284,4588,11146,"25 days, 0:33:26",2013-02-05 04:52:14,2013-02-05 04:52:14,2013-03-02 05:25:40,3084
1439,4370,4555,10364,"25 days, 0:34:49",2013-02-05 04:50:51,2013-02-05 04:50:51,2013-03-02 05:25:40,7513
646,1537,2898,5081,"25 days, 0:36:05",2013-02-05 04:49:35,2013-02-05 04:49:35,2013-03-02 05:25:40,2281
507,5436,5489,11432,"25 days, 0:36:15",2013-02-07 06:17:23,2010-02-01 10:32:08,2010-02-26 11:08:23,5085
349,836,1327,2512,"25 days, 0:37:36",2013-02-05 04:48:04,2013-02-05 04:48:04,2013-03-02 05:25:40,7170
402,835,1854,3091,"25 days, 0:39:35",2013-02-06 04:04:51,2010-02-01 10:32:08,2010-02-26 11:11:43,2890
161,361,1106,1628,"25 days, 0:40:54",2013-02-05 04:44:46,2013-02-05 04:44:46,2013-03-02 05:25:40,8609
985,397,856,2238,"25 days, 0:44:59",2013-02-05 04:40:41,2013-02-05 04:40:41,2013-03-02 05:25:40,6788
1096,3181,4523,8800,"25 days, 0:46:44",2013-02-07 10:31:55,2010-02-01 10:32:08,2010-02-26 11:18:52,2423
840,2564,2223,5627,"25 days, 0:49:33",2013-02-07 06:33:16,2010-02-01 10:32:08,2010-02-26 11:21:41,6583
175,1478,2610,4263,"25 days, 0:50:52",2013-02-05 04:34:48,2013-02-05 04:34:48,2013-03-02 05:25:40,4138
131,1442,2310,3883,"25 days, 0:54:18",2013-02-05 11:42:44,2010-02-01 10:32:08,2010-02-26 11:26:26,8637
827,7183,7986,15996,"25 days, 0:54:35",2013-02-06 01:17:28,2010-02-01 10:32:08,2010-02-26 11:26:43,4812
1331,4811,4359,10501,"25 days, 0:54:59",2013-02-05 09:23:16,2010-02-01 10:32:08,2010-02-26 11:27:07,7496
248,1216,1456,2920,"25 days, 0:55:05",2013-02-05 04:30:35,2013-02-05 04:30:35,2013-03-02 05:25:40,8522
21,571,755,1347,"25 days, 0:55:15",2013-02-05 04:30:25,2013-02-05 04:30:25,2013-03-02 05:25:40,3662
1461,1537,1842,4840,"25 days, 0:55:25",2013-02-05 04:30:15,2013-02-05 04:30:15,2013-03-02 05:25:40,5327
1123,2426,3294,6843,"25 days, 0:57:12",2013-02-06 02:44:42,2010-02-01 10:32:08,2010-02-26 11:29:20,896
137,424,1260,1821,"25 days, 0:58:54",2013-02-06 11:31:23,2010-02-01 10:32:08,2010-02-26 11:31:02,2992
173,837,790,1800,"25 days, 1:01:42",2013-02-05 04:23:58,2013-02-05 04:23:58,2013-03-02 05:25:40,931
264,1138,1547,2949,"25 days, 1:04:00",2013-02-07 01:05:08,2010-02-01 10:32:08,2010-02-26 11:36:08,3757
23,2607,2296,4926,"25 days, 1:05:17",2013-02-05 04:20:23,2013-02-05 04:20:23,2013-03-02 05:25:40,6110
530,1944,3132,5606,"25 days, 1:05:45",2013-02-05 04:19:55,2013-02-05 04:19:55,2013-03-02 05:25:40,8119
450,2263,2295,5008,"25 days, 1:06:30",2013-02-05 04:19:10,2013-02-05 04:19:10,2013-03-02 05:25:40,2774
1934,7577,7548,17059,"25 days, 1:08:32",2013-02-17 03:58:05,2010-02-01 10:32:08,2010-02-26 11:40:40,2473
472,1300,2456,4228,"25 days, 1:10:10",2013-02-05 04:15:30,2013-02-05 04:15:30,2013-03-02 05:25:40,3502
639,2227,2563,5429,"25 days, 1:19:30",2013-02-05 04:06:10,2013-02-05 04:06:10,2013-03-02 05:25:40,2238
1034,440,990,2464,"25 days, 1:33:16",2013-02-05 03:52:24,2013-02-05 03:52:24,2013-03-02 05:25:40,1304
1129,1576,1853,4558,"25 days, 1:41:10",2013-02-05 03:44:30,2013-02-05 03:44:30,2013-03-02 05:25:40,147
238,3462,4670,8370,"25 days, 1:43:25",2013-02-05 03:42:15,2013-02-05 03:42:15,2013-03-02 05:25:40,6160
2130,2635,4379,9144,"25 days, 1:44:44",2013-02-05 03:40:56,2013-02-05 03:40:56,2013-03-02 05:25:40,8433
184,617,860,1661,"25 days, 1:46:56",2013-02-05 03:38:44,2013-02-05 03:38:44,2013-03-02 05:25:40,4406
90,1336,2309,3735,"25 days, 1:48:31",2013-02-05 03:37:09,2013-02-05 03:37:09,2013-03-02 05:25:40,7997
477,509,860,1846,"25 days, 1:49:38",2013-02-05 03:36:02,2013-02-05 03:36:02,2013-03-02 05:25:40,3028
37,2334,3189,5560,"25 days, 1:49:55",2013-02-05 03:35:45,2013-02-05 03:35:45,2013-03-02 05:25:40,5486
127,689,918,1734,"25 days, 1:54:38",2013-02-05 03:31:02,2013-02-05 03:31:02,2013-03-02 05:25:40,9738
1296,1006,810,3112,"25 days, 1:58:34",2013-02-05 03:27:06,2013-02-05 03:27:06,2013-03-02 05:25:40,1126
864,3812,4665,9341,"25 days, 2:06:04",2013-02-05 03:19:36,2013-02-05 03:19:36,2013-03-02 05:25:40,9683
1036,1986,2930,5952,"25 days, 2:08:23",2013-02-05 03:17:17,2013-02-05 03:17:17,2013-03-02 05:25:40,1436
307,1657,2185,4149,"25 days, 2:10:36",2013-02-05 03:15:04,2013-02-05 03:15:04,2013-03-02 05:25:40,5463
1668,2354,2529,6551,"25 days, 2:14:20",2013-02-05 03:11:20,2013-02-05 03:11:20,2013-03-02 05:25:40,9637
1155,1108,1638,3901,"25 days, 2:32:12",2013-02-05 02:53:28,2013-02-05 02:53:28,2013-03-02 05:25:40,3424
373,3037,3170,6580,"25 days, 2:33:17",2013-02-05 02:52:23,2013-02-05 02:52:23,2013-03-02 05:25:40,6634
94,1699,2338,4131,"25 days, 2:33:21",2013-02-05 02:52:19,2013-02-05 02:52:19,2013-03-02 05:25:40,947
469,722,1436,2627,"25 days, 2:36:08",2013-02-05 02:49:32,2013-02-05 02:49:32,2013-03-02 05:25:40,2566
2421,1333,2104,5858,"25 days, 2:36:57",2013-02-05 02:48:43,2013-02-05 02:48:43,2013-03-02 05:25:40,5959
198,3860,3988,8046,"25 days, 2:39:02",2013-02-05 02:46:38,2013-02-05 02:46:38,2013-03-02 05:25:40,5513
954,904,1220,3078,"25 days, 2:46:18",2013-02-05 02:39:22,2013-02-05 02:39:22,2013-03-02 05:25:40,8269
291,781,1794,2866,"25 days, 2:46:56",2013-02-05 02:38:44,2013-02-05 02:38:44,2013-03-02 05:25:40,2237
882,953,1333,3168,"25 days, 2:49:00",2013-02-05 02:36:40,2013-02-05 02:36:40,2013-03-02 05:25:40,7790
35,4684,4617,9336,"25 days, 2:50:58",2013-02-05 02:34:42,2013-02-05 02:34:42,2013-03-02 05:25:40,7518
51,209,313,573,"25 days, 2:54:48",2013-02-05 02:30:52,2013-02-05 02:30:52,2013-03-02 05:25:40,4593
711,2453,3634,6798,"25 days, 2:57:15",2013-02-05 02:28:25,2013-02-05 02:28:25,2013-03-02 05:25:40,9351
883,2059,3888,6830,"25 days, 2:59:31",2013-02-05 02:26:09,2013-02-05 02:26:09,2013-03-02 05:25:40,1674
722,329,776,1827,"25 days, 3:03:07",2013-02-05 02:22:33,2013-02-05 02:22:33,2013-03-02 05:25:40,4522
1158,4415,4847,10420,"25 days, 3:06:57",2013-02-05 02:18:43,2013-02-05 02:18:43,2013-03-02 05:25:40,2105
1472,549,1189,3210,"25 days, 3:12:45",2013-02-05 02:12:55,2013-02-05 02:12:55,2013-03-02 05:25:40,5086
1430,4800,6558,12788,"25 days, 3:16:50",2013-02-06 06:09:57,2010-02-20 03:05:42,2010-03-17 06:22:32,8312
131,2999,2410,5540,"25 days, 3:18:03",2013-02-05 02:07:37,2013-02-05 02:07:37,2013-03-02 05:25:40,5024
113,933,1524,2570,"25 days, 3:23:08",2013-02-05 02:02:32,2013-02-05 02:02:32,2013-03-02 05:25:40,5194
29,380,1150,1559,"25 days, 3:24:27",2013-02-05 02:01:13,2013-02-05 02:01:13,2013-03-02 05:25:40,4957
339,1767,1862,3968,"25 days, 3:42:37",2013-02-05 01:43:03,2013-02-05 01:43:03,2013-03-02 05:25:40,311
662,298,748,1708,"25 days, 3:44:34",2013-02-05 01:41:06,2013-02-05 01:41:06,2013-03-02 05:25:40,9711
436,1655,2417,4508,"25 days, 3:48:13",2013-02-05 01:37:27,2013-02-05 01:37:27,2013-03-02 05:25:40,9048
478,428,741,1647,"25 days, 3:56:23",2013-02-05 01:29:17,2013-02-05 01:29:17,2013-03-02 05:25:40,6106
120,3988,5426,9534,"25 days, 3:57:36",2013-02-05 01:28:04,2013-02-05 01:28:04,2013-03-02 05:25:40,6741
267,1654,3109,5030,"25 days, 4:00:33",2013-02-05 01:25:07,2013-02-05 01:25:07,2013-03-02 05:25:40,1993
318,443,702,1463,"25 days, 4:00:55",2013-02-05 01:24:45,2013-02-05 01:24:45,2013-03-02 05:25:40,9034
1050,1860,2938,5848,"25 days, 4:04:35",2013-02-05 01:21:05,2013-02-05 01:21:05,2013-03-02 05:25:40,880
307,2903,5211,8421,"25 days, 4:08:59",2013-02-05 01:16:41,2013-02-05 01:16:41,2013-03-02 05:25:40,3619
333,303,628,1264,"25 days, 4:10:21",2013-02-05 01:15:19,2013-02-05 01:15:19,2013-03-02 05:25:40,7642
635,802,1000,2437,"25 days, 4:11:35",2013-02-05 01:14:05,2013-02-05 01:14:05,2013-03-02 05:25:40,1451
1625,747,1103,3475,"25 days, 4:14:06",2013-02-05 01:11:34,2013-02-05 01:11:34,2013-03-02 05:25:40,7184
165,1225,1976,3366,"25 days, 4:16:16",2013-02-05 01:09:24,2013-02-05 01:09:24,2013-03-02 05:25:40,8706
574,368,641,1583,"25 days, 4:17:03",2013-02-05 01:08:37,2013-02-05 01:08:37,2013-03-02 05:25:40,5351
368,1268,1388,3024,"25 days, 4:20:27",2013-02-05 01:05:13,2013-02-05 01:05:13,2013-03-02 05:25:40,3306
113,2457,3416,5986,"25 days, 4:20:58",2013-02-05 01:04:42,2013-02-05 01:04:42,2013-03-02 05:25:40,6163
535,1748,2515,4798,"25 days, 4:25:26",2013-02-05 01:00:14,2013-02-05 01:00:14,2013-03-02 05:25:40,7695
79,96,308,483,"25 days, 4:30:46",2013-02-05 00:54:54,2013-02-05 00:54:54,2013-03-02 05:25:40,6351
36,1648,1954,3638,"25 days, 4:31:49",2013-02-05 00:53:51,2013-02-05 00:53:51,2013-03-02 05:25:40,4431
36,662,1484,2182,"25 days, 4:42:38",2013-02-05 00:43:02,2013-02-05 00:43:02,2013-03-02 05:25:40,4383
734,279,574,1587,"25 days, 4:46:08",2013-02-05 00:39:32,2013-02-05 00:39:32,2013-03-02 05:25:40,2745
45,3667,4106,7818,"25 days, 4:48:00",2013-02-05 00:37:40,2013-02-05 00:37:40,2013-03-02 05:25:40,3133
343,273,562,1178,"25 days, 4:50:22",2013-02-05 00:35:18,2013-02-05 00:35:18,2013-03-02 05:25:40,9038
1378,1216,1451,4045,"25 days, 4:55:11",2013-02-05 00:30:29,2013-02-05 00:30:29,2013-03-02 05:25:40,6502
133,1399,2222,3754,"25 days, 5:00:52",2013-02-05 00:24:48,2013-02-05 00:24:48,2013-03-02 05:25:40,725
1169,582,1227,2978,"25 days, 5:01:25",2013-02-05 00:24:15,2013-02-05 00:24:15,2013-03-02 05:25:40,7204
531,1361,1042,2934,"25 days, 5:07:18",2013-02-05 00:18:22,2013-02-05 00:18:22,2013-03-02 05:25:40,2959
142,887,1536,2565,"25 days, 5:10:51",2013-02-05 00:14:49,2013-02-05 00:14:49,2013-03-02 05:25:40,8120
808,377,784,1969,"25 days, 5:12:24",2013-02-05 00:13:16,2013-02-05 00:13:16,2013-03-02 05:25:40,8084
690,1055,1352,3097,"25 days, 5:13:12",2013-02-05 00:12:28,2013-02-05 00:12:28,2013-03-02 05:25:40,9613
290,1020,1825,3135,"25 days, 5:13:22",2013-02-05 00:12:18,2013-02-05 00:12:18,2013-03-02 05:25:40,8425
248,198,372,818,"25 days, 5:14:00",2013-02-05 00:11:40,2013-02-05 00:11:40,2013-03-02 05:25:40,5044
409,3517,4381,8307,"25 days, 5:15:49",2013-02-05 00:09:51,2013-02-05 00:09:51,2013-03-02 05:25:40,1250
260,954,1204,2418,"25 days, 6:55:40",2013-02-08 01:01:53,2010-02-23 03:47:01,2010-03-20 10:42:41,700
63,443,714,1220,"25 days, 8:34:53",2013-02-06 09:19:34,2010-03-17 00:32:53,2010-04-11 09:07:46,1107
509,8225,5379,14113,"25 days, 13:33:41",2013-02-07 09:45:48,2010-02-01 10:32:08,2010-02-27 00:05:49,6880
1151,3062,3641,7854,"25 days, 13:59:02",2013-02-08 08:17:30,2010-02-01 10:32:08,2010-02-27 00:31:10,8105
412,4230,4887,9529,"25 days, 14:08:25",2013-02-07 03:26:21,2010-02-01 10:32:08,2010-02-27 00:40:33,930
50,3289,3280,6619,"25 days, 14:10:10",2013-02-07 08:16:13,2010-02-01 10:32:08,2010-02-27 00:42:18,3043
789,4973,4847,10609,"25 days, 14:16:56",2013-02-07 04:48:58,2010-02-01 10:32:08,2010-02-27 00:49:04,5872
537,2730,3439,6706,"25 days, 14:20:10",2013-02-07 08:52:06,2010-02-01 10:32:08,2010-02-27 00:52:18,9758
2499,7573,7380,17452,"25 days, 14:51:20",2013-02-07 10:35:02,2010-02-01 10:32:08,2010-02-27 01:23:28,2481
3235,7152,6160,16547,"25 days, 14:51:47",2013-02-07 03:09:25,2010-02-01 10:32:08,2010-02-27 01:23:55,9973
119,1316,3036,4471,"25 days, 14:52:05",2013-02-07 04:15:05,2010-02-01 10:32:08,2010-02-27 01:24:13,309
7,5614,7027,12648,"25 days, 15:07:22",2013-02-08 07:54:34,2010-02-01 10:32:08,2010-02-27 01:39:30,7735
596,2071,2980,5647,"25 days, 15:19:52",2013-02-06 09:09:34,2010-02-01 10:32:08,2010-02-27 01:52:00,8648
68,1786,2185,4039,"25 days, 15:22:55",2013-02-05 08:21:26,2010-02-01 10:32:08,2010-02-27 01:55:03,1804
1016,2369,2956,6341,"25 days, 15:23:33",2013-02-07 06:17:06,2010-02-01 10:32:08,2010-02-27 01:55:41,7421
499,6644,7734,14877,"25 days, 15:23:35",2013-02-07 00:29:23,2010-02-01 10:32:08,2010-02-27 01:55:43,1370
785,2639,3370,6794,"25 days, 15:52:51",2013-02-06 10:28:10,2010-02-01 10:32:08,2010-02-27 02:24:59,950
1303,1043,2351,4697,"25 days, 16:01:05",2013-02-06 10:43:21,2010-02-01 10:32:08,2010-02-27 02:33:13,7361
141,6179,6051,12371,"25 days, 16:01:55",2013-02-07 07:59:34,2010-02-01 10:32:08,2010-02-27 02:34:03,9462
125,1313,1558,2996,"25 days, 16:10:27",2013-02-05 11:36:20,2010-02-01 10:32:08,2010-02-27 02:42:35,5876
0,408,733,1141,"25 days, 16:28:35",2013-02-05 07:57:38,2010-02-01 10:32:08,2010-02-27 03:00:43,9110
832,604,1458,2894,"25 days, 16:38:16",2013-02-05 08:49:10,2010-02-01 10:32:08,2010-02-27 03:10:24,3543
1136,8200,9212,18548,"25 days, 16:49:49",2013-02-07 07:51:46,2010-02-01 10:32:08,2010-02-27 03:21:57,9460
821,447,926,2194,"25 days, 16:58:28",2013-02-07 01:57:34,2010-02-22 11:16:41,2010-03-20 04:15:09,6280
1297,6396,6730,14423,"25 days, 17:06:39",2013-02-06 07:40:01,2010-02-01 10:32:08,2010-02-27 03:38:47,7476
418,1707,2274,4399,"25 days, 17:17:52",2013-02-06 01:03:21,2010-02-01 10:32:08,2010-02-27 03:50:00,3339
1041,943,1720,3704,"25 days, 17:26:55",2013-02-04 11:58:45,2013-02-04 11:58:45,2013-03-02 05:25:40,8801
143,446,1007,1596,"25 days, 17:32:58",2013-02-04 11:52:42,2013-02-04 11:52:42,2013-03-02 05:25:40,9203
1319,3131,3671,8121,"25 days, 17:40:02",2013-02-07 10:31:27,2010-02-23 07:34:48,2010-03-21 01:14:50,6448
38,882,1098,2018,"25 days, 17:40:21",2013-02-04 11:45:19,2013-02-04 11:45:19,2013-03-02 05:25:40,2386
655,130,253,1038,"25 days, 17:43:00",2013-02-04 11:42:40,2013-02-04 11:42:40,2013-03-02 05:25:40,736
293,1505,2852,4650,"25 days, 17:46:29",2013-02-06 05:37:47,2010-02-01 10:32:08,2010-02-27 04:18:37,4428
853,645,1536,3034,"25 days, 17:48:34",2013-02-04 11:37:06,2013-02-04 11:37:06,2013-03-02 05:25:40,954
25,163,493,681,"25 days, 17:50:49",2013-02-04 11:34:51,2013-02-04 11:34:51,2013-03-02 05:25:40,1035
755,162,103,1020,"25 days, 17:53:47",2013-02-04 11:31:53,2013-02-04 11:31:53,2013-03-02 05:25:40,9871
589,1260,1953,3802,"25 days, 17:56:31",2013-02-04 11:29:09,2013-02-04 11:29:09,2013-03-02 05:25:40,3865
705,235,765,1705,"25 days, 17:57:45",2013-02-07 06:53:48,2010-02-01 10:32:08,2010-02-27 04:29:53,4999
506,988,2016,3510,"25 days, 17:59:08",2013-02-04 11:26:32,2013-02-04 11:26:32,2013-03-02 05:25:40,5260
1046,1298,1999,4343,"25 days, 18:01:13",2013-02-04 11:24:27,2013-02-04 11:24:27,2013-03-02 05:25:40,9528
72,5655,4393,10120,"25 days, 18:06:47",2013-02-07 01:18:16,2010-02-01 10:32:08,2010-02-27 04:38:55,1328
346,628,657,1631,"25 days, 18:13:40",2013-02-04 11:12:00,2013-02-04 11:12:00,2013-03-02 05:25:40,5718
63,650,1170,1883,"25 days, 18:21:51",2013-02-04 11:03:49,2013-02-04 11:03:49,2013-03-02 05:25:40,7166
63,1088,1794,2945,"25 days, 18:29:52",2013-02-04 10:55:48,2013-02-04 10:55:48,2013-03-02 05:25:40,7004
1086,4996,4475,10557,"25 days, 18:31:43",2013-02-04 10:53:57,2013-02-04 10:53:57,2013-03-02 05:25:40,1392
523,259,820,1602,"25 days, 18:32:57",2013-02-06 01:40:52,2010-03-13 11:21:17,2010-04-08 05:54:14,7938
377,2147,3273,5797,"25 days, 18:33:30",2013-02-04 10:52:10,2013-02-04 10:52:10,2013-03-02 05:25:40,5980
624,1605,2520,4749,"25 days, 18:36:36",2013-02-04 10:49:04,2013-02-04 10:49:04,2013-03-02 05:25:40,8761
351,1245,3072,4668,"25 days, 18:40:13",2013-02-08 02:11:36,2010-02-01 10:32:08,2010-02-27 05:12:21,5131
131,263,841,1235,"25 days, 18:48:27",2013-02-04 10:37:13,2013-02-04 10:37:13,2013-03-02 05:25:40,6029
857,706,1220,2783,"25 days, 18:49:18",2013-02-04 10:36:22,2013-02-04 10:36:22,2013-03-02 05:25:40,8283
217,7152,7068,14437,"25 days, 18:54:50",2013-02-07 10:24:52,2010-02-01 10:32:08,2010-02-27 05:26:58,1373
373,1560,1798,3731,"25 days, 19:01:32",2013-02-04 10:24:08,2013-02-04 10:24:08,2013-03-02 05:25:40,7761
506,764,1768,3038,"25 days, 19:02:11",2013-02-04 10:23:29,2013-02-04 10:23:29,2013-03-02 05:25:40,9578
681,912,1203,2796,"25 days, 19:02:47",2013-02-04 10:22:53,2013-02-04 10:22:53,2013-03-02 05:25:40,7921
53,472,1191,1716,"25 days, 19:04:08",2013-02-04 10:21:32,2013-02-04 10:21:32,2013-03-02 05:25:40,1904
1247,57,366,1670,"25 days, 19:05:49",2013-02-05 03:15:55,2010-10-13 09:14:14,2010-11-08 04:20:03,9539
1926,1388,2540,5854,"25 days, 19:06:02",2013-02-04 10:19:38,2013-02-04 10:19:38,2013-03-02 05:25:40,2993
267,3441,3610,7318,"25 days, 19:13:20",2013-02-04 10:12:20,2013-02-04 10:12:20,2013-03-02 05:25:40,1137
60,145,637,842,"25 days, 19:14:48",2013-02-04 10:10:52,2013-02-04 10:10:52,2013-03-02 05:25:40,5514
442,748,1090,2280,"25 days, 19:17:57",2013-02-04 10:07:43,2013-02-04 10:07:43,2013-03-02 05:25:40,1968
507,645,828,1980,"25 days, 19:26:53",2013-02-04 09:58:47,2013-02-04 09:58:47,2013-03-02 05:25:40,6972
404,1763,3058,5225,"25 days, 19:28:46",2013-02-04 09:56:54,2013-02-04 09:56:54,2013-03-02 05:25:40,211
856,357,1334,2547,"25 days, 19:30:22",2013-02-04 09:55:18,2013-02-04 09:55:18,2013-03-02 05:25:40,351
11,227,446,684,"25 days, 19:35:49",2013-02-04 09:49:51,2013-02-04 09:49:51,2013-03-02 05:25:40,8043
699,213,331,1243,"25 days, 19:39:10",2013-02-04 09:46:30,2013-02-04 09:46:30,2013-03-02 05:25:40,6012
25,696,1379,2100,"25 days, 19:40:48",2013-02-04 09:44:52,2013-02-04 09:44:52,2013-03-02 05:25:40,9583
85,289,467,841,"25 days, 19:50:43",2013-02-04 09:34:57,2013-02-04 09:34:57,2013-03-02 05:25:40,4290
487,1267,1610,3364,"25 days, 19:56:47",2013-02-04 09:28:53,2013-02-04 09:28:53,2013-03-02 05:25:40,9945
229,272,733,1234,"25 days, 19:56:52",2013-02-04 09:28:48,2013-02-04 09:28:48,2013-03-02 05:25:40,8983
2104,7610,7954,17668,"25 days, 19:57:36",2013-02-08 11:18:43,2010-02-01 10:32:08,2010-02-27 06:29:44,5380
695,4648,5100,10443,"25 days, 20:02:14",2013-02-04 09:23:26,2013-02-04 09:23:26,2013-03-02 05:25:40,7989
802,3077,4417,8296,"25 days, 20:06:20",2013-02-09 02:02:10,2010-02-01 10:32:08,2010-02-27 06:38:28,2136
733,4712,5404,10849,"25 days, 20:06:22",2013-02-16 00:59:27,2010-02-01 10:32:08,2010-02-27 06:38:30,2492
306,945,1426,2677,"25 days, 20:06:41",2013-02-04 09:18:59,2013-02-04 09:18:59,2013-03-02 05:25:40,6054
1250,84,215,1549,"25 days, 20:09:39",2013-02-04 09:16:01,2013-02-04 09:16:01,2013-03-02 05:25:40,7063
873,946,2644,4463,"25 days, 20:11:32",2013-02-06 01:55:01,2010-02-01 10:32:08,2010-02-27 06:43:40,9749
523,675,1653,2851,"25 days, 20:12:42",2013-02-04 09:12:58,2013-02-04 09:12:58,2013-03-02 05:25:40,3583
472,1601,1750,3823,"25 days, 20:17:01",2013-02-04 09:08:39,2013-02-04 09:08:39,2013-03-02 05:25:40,8492
456,966,1457,2879,"25 days, 20:20:48",2013-02-04 09:04:52,2013-02-04 09:04:52,2013-03-02 05:25:40,3476
187,1717,2109,4013,"25 days, 20:26:43",2013-02-05 08:02:08,2010-02-01 10:32:08,2010-02-27 06:58:51,5602
752,541,1971,3264,"25 days, 20:27:26",2013-02-07 09:04:26,2010-02-01 10:32:08,2010-02-27 06:59:34,5733
619,5229,6075,11923,"25 days, 20:29:53",2013-02-06 01:05:04,2010-02-01 10:32:08,2010-02-27 07:02:01,9149
767,1206,1986,3959,"25 days, 20:30:26",2013-02-04 08:55:14,2013-02-04 08:55:14,2013-03-02 05:25:40,5355
12,328,564,904,"25 days, 20:31:30",2013-02-04 08:54:10,2013-02-04 08:54:10,2013-03-02 05:25:40,706
805,926,1515,3246,"25 days, 20:32:49",2013-02-04 08:52:51,2013-02-04 08:52:51,2013-03-02 05:25:40,995
737,476,1032,2245,"25 days, 20:40:35",2013-02-04 08:45:05,2013-02-04 08:45:05,2013-03-02 05:25:40,7175
1235,1564,1988,4787,"25 days, 20:42:15",2013-02-04 08:43:25,2013-02-04 08:43:25,2013-03-02 05:25:40,2623
1242,222,512,1976,"25 days, 20:46:21",2013-02-04 08:39:19,2013-02-04 08:39:19,2013-03-02 05:25:40,9801
526,3811,5053,9390,"25 days, 20:48:15",2013-02-06 10:22:20,2010-02-01 10:32:08,2010-02-27 07:20:23,182
949,813,1976,3738,"25 days, 20:52:44",2013-02-04 08:32:56,2013-02-04 08:32:56,2013-03-02 05:25:40,9590
320,2941,2446,5707,"25 days, 20:55:44",2013-02-04 08:29:56,2013-02-04 08:29:56,2013-03-02 05:25:40,3986
470,1882,1653,4005,"25 days, 20:56:23",2013-02-04 08:29:17,2013-02-04 08:29:17,2013-03-02 05:25:40,8203
562,421,1198,2181,"25 days, 20:57:18",2013-02-04 08:28:22,2013-02-04 08:28:22,2013-03-02 05:25:40,1818
180,3120,4300,7600,"25 days, 21:02:12",2013-02-07 04:10:31,2010-02-01 10:32:08,2010-02-27 07:34:20,2156
1455,123,580,2158,"25 days, 21:05:15",2013-02-04 08:20:25,2013-02-04 08:20:25,2013-03-02 05:25:40,4859
794,810,1090,2694,"25 days, 21:18:31",2013-02-04 08:07:09,2013-02-04 08:07:09,2013-03-02 05:25:40,4716
1329,3761,3013,8103,"25 days, 21:20:10",2013-02-04 08:05:30,2013-02-04 08:05:30,2013-03-02 05:25:40,2323
279,848,1510,2637,"25 days, 21:29:31",2013-02-04 07:56:09,2013-02-04 07:56:09,2013-03-02 05:25:40,273
266,791,1297,2354,"25 days, 21:36:58",2013-02-04 07:48:42,2013-02-04 07:48:42,2013-03-02 05:25:40,9301
60,1486,2083,3629,"25 days, 21:42:17",2013-02-06 09:22:59,2010-02-01 10:32:08,2010-02-27 08:14:25,2206
508,1393,1734,3635,"25 days, 21:43:41",2013-02-04 07:41:59,2013-02-04 07:41:59,2013-03-02 05:25:40,6894
566,1923,3021,5510,"25 days, 21:45:18",2013-02-04 07:40:22,2013-02-04 07:40:22,2013-03-02 05:25:40,6987
1023,1307,1659,3989,"25 days, 21:47:09",2013-02-04 07:38:31,2013-02-04 07:38:31,2013-03-02 05:25:40,8810
259,3651,3902,7812,"25 days, 21:48:25",2013-02-06 08:29:13,2010-02-01 10:32:08,2010-02-27 08:20:33,5507
539,3191,4614,8344,"25 days, 21:55:17",2013-02-04 07:30:23,2013-02-04 07:30:23,2013-03-02 05:25:40,5637
732,1078,1713,3523,"25 days, 21:57:30",2013-02-04 07:28:10,2013-02-04 07:28:10,2013-03-02 05:25:40,9671
176,796,1173,2145,"25 days, 21:57:32",2013-02-04 10:45:31,2010-02-01 10:32:08,2010-02-27 08:29:40,2969
37,1883,2927,4847,"25 days, 21:57:45",2013-02-06 07:56:32,2010-02-01 10:32:08,2010-02-27 08:29:53,9799
116,560,551,1227,"25 days, 22:01:21",2013-02-04 07:24:19,2013-02-04 07:24:19,2013-03-02 05:25:40,7212
1495,1637,1976,5108,"25 days, 22:06:12",2013-02-04 07:19:28,2013-02-04 07:19:28,2013-03-02 05:25:40,2258
511,9466,7585,17562,"25 days, 22:09:50",2013-02-06 05:51:07,2010-02-01 10:32:08,2010-02-27 08:41:58,8315
747,817,1744,3308,"25 days, 22:11:22",2013-02-04 07:14:18,2013-02-04 07:14:18,2013-03-02 05:25:40,4713
178,843,1453,2474,"25 days, 22:13:03",2013-02-04 07:12:37,2013-02-04 07:12:37,2013-03-02 05:25:40,5198
80,4350,4378,8808,"25 days, 22:16:00",2013-02-20 02:16:03,2010-02-01 10:32:08,2010-02-27 08:48:08,2034
1993,7818,7016,16827,"25 days, 22:17:55",2013-02-07 01:10:27,2010-02-01 10:32:08,2010-02-27 08:50:03,5016
124,2129,2413,4666,"25 days, 22:21:31",2013-02-04 07:04:09,2013-02-04 07:04:09,2013-03-02 05:25:40,485
906,919,1326,3151,"25 days, 22:22:43",2013-02-04 07:02:57,2013-02-04 07:02:57,2013-03-02 05:25:40,2682
87,2575,3096,5758,"25 days, 22:24:07",2013-02-06 07:30:06,2010-03-09 03:55:32,2010-04-04 02:19:39,3778
172,252,686,1110,"25 days, 22:26:49",2013-02-04 06:58:51,2013-02-04 06:58:51,2013-03-02 05:25:40,2917
324,216,511,1051,"25 days, 22:32:46",2013-02-04 06:52:54,2013-02-04 06:52:54,2013-03-02 05:25:40,3094
24,1720,1892,3636,"25 days, 22:32:46",2013-02-04 06:52:54,2013-02-04 06:52:54,2013-03-02 05:25:40,8692
380,717,1392,2489,"25 days, 22:32:56",2013-02-04 06:52:44,2013-02-04 06:52:44,2013-03-02 05:25:40,1214
559,876,1375,2810,"25 days, 22:34:56",2013-02-04 06:50:44,2013-02-04 06:50:44,2013-03-02 05:25:40,1548
1956,2668,3897,8521,"25 days, 22:38:43",2013-02-04 06:46:57,2013-02-04 06:46:57,2013-03-02 05:25:40,6717
69,155,461,685,"25 days, 22:41:28",2013-02-04 06:44:12,2013-02-04 06:44:12,2013-03-02 05:25:40,8022
49,423,553,1025,"25 days, 22:49:14",2013-02-04 06:36:26,2013-02-04 06:36:26,2013-03-02 05:25:40,4278
1322,262,595,2179,"25 days, 22:49:44",2013-02-04 06:35:56,2013-02-04 06:35:56,2013-03-02 05:25:40,467
262,1704,2712,4678,"25 days, 22:50:08",2013-02-04 06:35:32,2013-02-04 06:35:32,2013-03-02 05:25:40,9253
89,1219,1899,3207,"25 days, 22:50:44",2013-02-04 06:34:56,2013-02-04 06:34:56,2013-03-02 05:25:40,4034
187,330,519,1036,"25 days, 23:03:45",2013-02-04 06:21:55,2013-02-04 06:21:55,2013-03-02 05:25:40,1129
524,408,706,1638,"25 days, 23:08:05",2013-02-04 06:17:35,2013-02-04 06:17:35,2013-03-02 05:25:40,9450
2247,3798,3864,9909,"25 days, 23:09:07",2013-02-04 06:16:33,2013-02-04 06:16:33,2013-03-02 05:25:40,8707
735,1363,1350,3448,"25 days, 23:09:54",2013-02-04 06:15:46,2013-02-04 06:15:46,2013-03-02 05:25:40,4000
622,477,941,2040,"25 days, 23:13:51",2013-02-04 06:11:49,2013-02-04 06:11:49,2013-03-02 05:25:40,9060
202,1976,3701,5879,"25 days, 23:14:04",2013-02-07 09:09:04,2010-02-19 07:14:31,2010-03-17 06:28:35,1063
484,3116,3089,6689,"25 days, 23:15:28",2013-02-07 09:49:48,2010-02-01 10:32:08,2010-02-27 09:47:36,3061
781,625,814,2220,"25 days, 23:15:45",2013-02-04 06:09:55,2013-02-04 06:09:55,2013-03-02 05:25:40,8461
608,504,1034,2146,"25 days, 23:16:09",2013-02-04 06:09:31,2013-02-04 06:09:31,2013-03-02 05:25:40,8176
407,1154,1368,2929,"25 days, 23:18:01",2013-02-04 06:07:39,2013-02-04 06:07:39,2013-03-02 05:25:40,7629
12,326,588,926,"25 days, 23:19:23",2013-02-04 06:06:17,2013-02-04 06:06:17,2013-03-02 05:25:40,3157
44,2532,1990,4566,"25 days, 23:25:31",2013-02-06 10:08:38,2010-02-01 10:32:08,2010-02-27 09:57:39,3776
84,560,998,1642,"25 days, 23:26:42",2013-02-04 05:58:58,2013-02-04 05:58:58,2013-03-02 05:25:40,1018
109,5141,6102,11352,"25 days, 23:31:35",2013-02-06 10:34:05,2010-02-01 10:32:08,2010-02-27 10:03:43,5912
159,473,1055,1687,"25 days, 23:32:14",2013-02-04 05:53:26,2013-02-04 05:53:26,2013-03-02 05:25:40,2419
604,1553,3069,5226,"25 days, 23:37:09",2013-02-07 08:39:46,2010-02-01 10:32:08,2010-02-27 10:09:17,1045
62,767,1200,2029,"25 days, 23:50:19",2013-02-05 04:12:28,2010-07-22 10:09:38,2010-08-17 09:59:57,1714
617,4456,6873,11946,"25 days, 23:51:34",2013-02-07 06:21:56,2010-02-01 10:32:08,2010-02-27 10:23:42,6032
763,1938,2287,4988,"25 days, 23:52:12",2013-02-04 05:33:28,2013-02-04 05:33:28,2013-03-02 05:25:40,9487
644,3278,3186,7108,"25 days, 23:53:40",2013-02-06 02:37:31,2010-02-01 10:32:08,2010-02-27 10:25:48,5088
1226,1672,2273,5171,"25 days, 23:55:32",2013-02-04 05:30:08,2013-02-04 05:30:08,2013-03-02 05:25:40,5579
635,539,1417,2591,"25 days, 23:57:32",2013-02-04 05:28:08,2013-02-04 05:28:08,2013-03-02 05:25:40,4552
881,1838,2315,5034,"26 days, 0:00:59",2013-02-04 05:24:41,2013-02-04 05:24:41,2013-03-02 05:25:40,2883
26,1276,1888,3190,"26 days, 0:11:12",2013-02-06 04:56:54,2010-02-27 00:00:01,2010-03-25 00:11:13,120
1400,4311,4729,10440,"26 days, 0:12:26",2013-02-08 09:54:01,2010-02-01 10:32:08,2010-02-27 10:44:34,6569
2,614,1124,1740,"26 days, 0:19:33",2013-02-04 05:06:07,2013-02-04 05:06:07,2013-03-02 05:25:40,3653
134,1099,890,2123,"26 days, 0:27:15",2013-02-04 10:59:28,2010-02-01 10:32:08,2010-02-27 10:59:23,3310
1842,536,1037,3415,"26 days, 0:31:25",2013-02-04 04:54:15,2013-02-04 04:54:15,2013-03-02 05:25:40,6432
332,87,363,782,"26 days, 0:31:34",2013-02-04 04:54:06,2013-02-04 04:54:06,2013-03-02 05:25:40,9483
1872,1447,1798,5117,"26 days, 0:33:17",2013-02-04 04:52:23,2013-02-04 04:52:23,2013-03-02 05:25:40,5408
641,7716,6118,14475,"26 days, 0:36:33",2013-02-09 08:39:56,2010-02-01 10:32:08,2010-02-27 11:08:41,9302
61,5465,6297,11823,"26 days, 0:44:00",2013-02-11 03:14:34,2010-02-10 05:43:11,2010-03-08 06:27:11,7544
1072,1666,2697,5435,"26 days, 0:45:29",2013-02-06 09:31:52,2010-02-01 10:32:08,2010-02-27 11:17:37,5235
789,379,597,1765,"26 days, 0:46:38",2013-02-04 04:39:02,2013-02-04 04:39:02,2013-03-02 05:25:40,9468
425,766,1085,2276,"26 days, 0:47:36",2013-02-04 04:38:04,2013-02-04 04:38:04,2013-03-02 05:25:40,9678
515,1833,2474,4822,"26 days, 0:52:15",2013-02-05 09:17:53,2010-02-01 10:32:08,2010-02-27 11:24:23,1224
1524,2791,3989,8304,"26 days, 0:55:10",2013-02-04 04:30:30,2013-02-04 04:30:30,2013-03-02 05:25:40,3246
85,2570,4886,7541,"26 days, 1:05:44",2013-02-07 08:41:46,2010-02-01 10:32:08,2010-02-27 11:37:52,3674
340,250,955,1545,"26 days, 1:07:21",2013-02-04 04:18:19,2013-02-04 04:18:19,2013-03-02 05:25:40,9592
18,269,713,1000,"26 days, 1:08:03",2013-02-04 04:17:37,2013-02-04 04:17:37,2013-03-02 05:25:40,884
62,295,674,1031,"26 days, 1:11:04",2013-02-04 04:14:36,2013-02-04 04:14:36,2013-03-02 05:25:40,2148
464,441,591,1496,"26 days, 1:13:55",2013-02-04 04:11:45,2013-02-04 04:11:45,2013-03-02 05:25:40,759
110,1018,1181,2309,"26 days, 1:15:15",2013-02-04 04:10:25,2013-02-04 04:10:25,2013-03-02 05:25:40,5344
457,5232,5409,11098,"26 days, 1:15:40",2013-02-06 03:48:02,2010-02-01 10:32:08,2010-02-27 11:47:48,8822
63,661,764,1488,"26 days, 1:21:02",2013-02-05 08:50:39,2010-02-27 05:21:59,2010-03-25 06:43:01,2788
366,315,1094,1775,"26 days, 1:23:02",2013-02-06 08:47:42,2010-02-01 10:32:08,2010-02-27 11:55:10,4676
40,403,655,1098,"26 days, 1:24:37",2013-02-04 04:01:03,2013-02-04 04:01:03,2013-03-02 05:25:40,6690
319,274,416,1009,"26 days, 1:45:59",2013-02-04 03:39:41,2013-02-04 03:39:41,2013-03-02 05:25:40,5553
33,1133,1502,2668,"26 days, 1:50:59",2013-02-04 03:34:41,2013-02-04 03:34:41,2013-03-02 05:25:40,5340
923,2148,3187,6258,"26 days, 1:51:37",2013-02-04 03:34:03,2013-02-04 03:34:03,2013-03-02 05:25:40,3224
540,332,442,1314,"26 days, 1:55:03",2013-02-04 03:30:37,2013-02-04 03:30:37,2013-03-02 05:25:40,144
896,2764,2915,6575,"26 days, 1:59:13",2013-02-06 10:24:54,2010-03-19 02:09:15,2010-04-14 04:08:28,378
167,588,1100,1855,"26 days, 2:13:22",2013-02-05 06:29:07,2010-04-12 02:23:26,2010-05-08 04:36:48,2601
948,579,1561,3088,"26 days, 2:14:51",2013-02-04 03:10:49,2013-02-04 03:10:49,2013-03-02 05:25:40,232
663,1045,1540,3248,"26 days, 2:15:33",2013-02-04 03:10:07,2013-02-04 03:10:07,2013-03-02 05:25:40,8000
1029,375,308,1712,"26 days, 2:31:25",2013-02-04 02:54:15,2013-02-04 02:54:15,2013-03-02 05:25:40,1731
770,628,647,2045,"26 days, 2:33:10",2013-02-04 02:52:30,2013-02-04 02:52:30,2013-03-02 05:25:40,4427
850,440,757,2047,"26 days, 2:37:07",2013-02-04 02:48:33,2013-02-04 02:48:33,2013-03-02 05:25:40,6648
269,71,441,781,"26 days, 2:41:27",2013-02-04 02:44:13,2013-02-04 02:44:13,2013-03-02 05:25:40,5059
1725,2419,2686,6830,"26 days, 2:48:16",2013-02-04 02:37:24,2013-02-04 02:37:24,2013-03-02 05:25:40,5914
8,722,807,1537,"26 days, 2:49:17",2013-02-04 04:50:47,2010-02-24 01:49:10,2010-03-22 04:38:27,105
992,366,576,1934,"26 days, 2:52:01",2013-02-04 02:33:39,2013-02-04 02:33:39,2013-03-02 05:25:40,3156
828,797,1680,3305,"26 days, 2:52:40",2013-02-04 02:33:00,2013-02-04 02:33:00,2013-03-02 05:25:40,8062
1373,107,275,1755,"26 days, 2:53:10",2013-02-04 02:32:30,2013-02-04 02:32:30,2013-03-02 05:25:40,5229
2000,1700,2224,5924,"26 days, 2:55:32",2013-02-04 02:30:08,2013-02-04 02:30:08,2013-03-02 05:25:40,8613
1255,1013,1579,3847,"26 days, 3:13:39",2013-02-07 09:56:03,2010-03-01 01:42:51,2010-03-27 04:56:30,9492
170,530,700,1400,"26 days, 3:17:25",2013-02-04 02:08:15,2013-02-04 02:08:15,2013-03-02 05:25:40,6311
109,466,1079,1654,"26 days, 3:19:38",2013-02-04 02:06:02,2013-02-04 02:06:02,2013-03-02 05:25:40,5003
925,248,934,2107,"26 days, 3:26:27",2013-02-04 01:59:13,2013-02-04 01:59:13,2013-03-02 05:25:40,7702
66,1124,1269,2459,"26 days, 3:36:18",2013-02-06 11:38:38,2010-03-14 03:30:08,2010-04-09 07:06:26,99
42,1585,2469,4096,"26 days, 3:54:39",2013-02-04 01:31:01,2013-02-04 01:31:01,2013-03-02 05:25:40,6306
122,434,1025,1581,"26 days, 3:57:56",2013-02-04 01:27:44,2013-02-04 01:27:44,2013-03-02 05:25:40,2735
600,555,633,1788,"26 days, 4:10:09",2013-02-04 01:15:31,2013-02-04 01:15:31,2013-03-02 05:25:40,5724
96,1077,1619,2792,"26 days, 4:19:12",2013-02-04 01:06:28,2013-02-04 01:06:28,2013-03-02 05:25:40,6599
131,1018,1380,2529,"26 days, 4:34:15",2013-02-04 10:16:51,2010-02-16 05:47:08,2010-03-14 10:21:23,5565
676,101,339,1116,"26 days, 4:45:51",2013-02-04 00:39:49,2013-02-04 00:39:49,2013-03-02 05:25:40,2188
550,803,1260,2613,"26 days, 4:47:00",2013-02-04 00:38:40,2013-02-04 00:38:40,2013-03-02 05:25:40,7972
604,405,844,1853,"26 days, 4:52:51",2013-02-04 00:32:49,2013-02-04 00:32:49,2013-03-02 05:25:40,5765
825,70,327,1222,"26 days, 4:55:04",2013-02-04 00:30:36,2013-02-04 00:30:36,2013-03-02 05:25:40,4178
542,2944,3692,7178,"26 days, 5:04:24",2013-02-04 00:21:16,2013-02-04 00:21:16,2013-03-02 05:25:40,904
1670,1662,2773,6105,"26 days, 6:10:52",2013-02-06 10:45:38,2010-03-01 02:41:01,2010-03-27 08:51:53,7987
698,4433,5291,10422,"26 days, 6:30:46",2013-02-07 00:36:16,2010-02-13 03:05:04,2010-03-11 09:35:50,3605
942,1108,2921,4971,"26 days, 8:13:31",2013-02-05 06:02:19,2010-03-06 01:31:52,2010-04-01 09:45:23,7306
579,443,552,1574,"26 days, 10:24:51",2013-02-06 03:08:05,2010-03-10 00:04:28,2010-04-05 10:29:19,9888
161,8534,10761,19456,"26 days, 13:36:06",2013-02-06 11:49:53,2010-02-01 10:32:08,2010-02-28 00:08:14,9774
16,1486,2327,3829,"26 days, 13:42:01",2013-02-06 10:45:41,2010-02-01 10:32:08,2010-02-28 00:14:09,6344
1712,6208,8632,16552,"26 days, 13:52:36",2013-02-07 07:40:32,2010-02-01 10:32:08,2010-02-28 00:24:44,2450
1691,9341,6151,17183,"26 days, 14:10:24",2013-02-07 04:44:31,2010-02-01 10:32:08,2010-02-28 00:42:32,2817
445,1027,1455,2927,"26 days, 14:31:18",2013-02-06 03:00:20,2010-02-01 10:32:08,2010-02-28 01:03:26,9666
364,757,1352,2473,"26 days, 14:35:53",2013-02-05 01:15:16,2010-02-01 10:32:08,2010-02-28 01:08:01,250
20,579,1029,1628,"26 days, 14:42:26",2013-02-05 05:03:41,2010-02-01 10:32:08,2010-02-28 01:14:34,868
1323,6492,7942,15757,"26 days, 14:55:07",2013-02-07 03:16:31,2010-02-01 10:32:08,2010-02-28 01:27:15,2334
63,3921,5013,8997,"26 days, 15:10:06",2013-02-07 11:02:49,2010-02-01 10:32:08,2010-02-28 01:42:14,3289
1233,4860,6589,12682,"26 days, 15:11:37",2013-02-07 04:41:26,2010-02-01 10:32:08,2010-02-28 01:43:45,1299
645,283,545,1473,"26 days, 15:17:44",2013-02-06 03:18:54,2010-02-01 10:32:08,2010-02-28 01:49:52,9062
508,1729,2003,4240,"26 days, 15:37:55",2013-02-05 08:16:27,2010-02-01 10:32:08,2010-02-28 02:10:03,2235
241,1718,3139,5098,"26 days, 15:39:29",2013-02-06 06:08:34,2010-02-01 10:32:08,2010-02-28 02:11:37,2828
1330,1890,3706,6926,"26 days, 15:54:23",2013-02-05 11:59:32,2010-02-01 10:32:08,2010-02-28 02:26:31,6676
1121,4902,5908,11931,"26 days, 15:55:16",2013-02-06 10:09:32,2010-02-01 10:32:08,2010-02-28 02:27:24,810
1894,5986,9449,17329,"26 days, 15:59:13",2013-02-06 09:57:29,2010-02-01 10:32:08,2010-02-28 02:31:21,6494
1105,1773,2748,5626,"26 days, 16:49:47",2013-02-05 02:38:51,2010-02-01 10:32:08,2010-02-28 03:21:55,11
1056,2632,3275,6963,"26 days, 16:54:31",2013-02-07 00:21:29,2010-02-01 10:32:08,2010-02-28 03:26:39,4543
679,2552,3534,6765,"26 days, 17:05:50",2013-02-07 06:35:49,2010-02-01 10:32:08,2010-02-28 03:37:58,2183
2115,6342,6545,15002,"26 days, 17:08:33",2013-02-06 00:12:04,2010-02-01 10:32:08,2010-02-28 03:40:41,3123
327,538,873,1738,"26 days, 17:12:11",2013-02-05 02:41:30,2010-02-01 10:32:08,2010-02-28 03:44:19,4035
781,919,1238,2938,"26 days, 17:17:12",2013-02-07 06:25:02,2010-02-01 10:32:08,2010-02-28 03:49:20,1073
1510,136,331,1977,"26 days, 17:17:15",2013-02-07 09:04:12,2010-02-01 10:32:08,2010-02-28 03:49:23,50
1965,1797,4097,7859,"26 days, 17:25:23",2013-02-07 02:32:15,2010-02-01 10:32:08,2010-02-28 03:57:31,5154
43,4056,3853,7952,"26 days, 17:29:43",2013-02-09 00:54:41,2010-02-01 10:32:08,2010-02-28 04:01:51,3317
1042,1394,1955,4391,"26 days, 17:32:50",2013-02-03 11:52:50,2013-02-03 11:52:50,2013-03-02 05:25:40,8792
743,56,457,1256,"26 days, 17:42:34",2013-02-03 11:43:06,2013-02-03 11:43:06,2013-03-02 05:25:40,9170
2944,7555,8176,18675,"26 days, 17:43:57",2013-02-07 04:17:28,2010-02-01 10:32:08,2010-02-28 04:16:05,458
830,395,700,1925,"26 days, 17:54:20",2013-02-03 11:31:20,2013-02-03 11:31:20,2013-03-02 05:25:40,5456
350,516,1453,2319,"26 days, 18:04:34",2013-02-03 11:21:06,2013-02-03 11:21:06,2013-03-02 05:25:40,1627
1291,772,1185,3248,"26 days, 18:05:56",2013-02-09 05:52:06,2010-02-01 10:32:08,2010-02-28 04:38:04,4466
4,538,469,1011,"26 days, 18:07:56",2013-02-06 06:08:48,2010-02-01 10:32:08,2010-02-28 04:40:04,3519
412,433,692,1537,"26 days, 18:12:05",2013-02-03 11:13:35,2013-02-03 11:13:35,2013-03-02 05:25:40,772
330,1154,1505,2989,"26 days, 18:19:18",2013-02-03 11:06:22,2013-02-03 11:06:22,2013-03-02 05:25:40,1635
887,382,798,2067,"26 days, 18:23:35",2013-02-03 11:02:05,2013-02-03 11:02:05,2013-03-02 05:25:40,7023
1147,18,198,1363,"26 days, 18:26:53",2013-02-06 04:20:38,2010-02-01 10:32:08,2010-02-28 04:59:01,5395
400,1180,2038,3618,"26 days, 18:30:34",2013-02-03 10:55:06,2013-02-03 10:55:06,2013-03-02 05:25:40,1048
918,2597,2376,5891,"26 days, 18:32:02",2013-02-03 10:53:38,2013-02-03 10:53:38,2013-03-02 05:25:40,2747
259,1020,1524,2803,"26 days, 18:32:44",2013-02-03 10:52:56,2013-02-03 10:52:56,2013-03-02 05:25:40,7737
102,6698,6946,13746,"26 days, 18:34:51",2013-02-06 09:50:00,2010-02-27 11:48:18,2010-03-26 06:23:09,1692
563,417,790,1770,"26 days, 18:41:12",2013-02-04 00:31:53,2010-02-01 10:32:08,2010-02-28 05:13:20,3503
488,1622,2413,4523,"26 days, 18:46:21",2013-02-07 10:04:52,2010-02-01 10:32:08,2010-02-28 05:18:29,3944
47,2978,4291,7316,"26 days, 18:49:44",2013-02-08 00:03:49,2010-02-01 10:32:08,2010-02-28 05:21:52,8523
203,2463,3277,5943,"26 days, 18:53:00",2013-02-08 09:21:24,2010-02-01 10:32:08,2010-02-28 05:25:08,7868
624,168,338,1130,"26 days, 18:55:39",2013-02-03 10:30:01,2013-02-03 10:30:01,2013-03-02 05:25:40,6715
378,2610,3567,6555,"26 days, 18:58:16",2013-02-07 00:51:10,2010-03-04 06:53:28,2010-03-31 01:51:44,6723
12,1878,2516,4406,"26 days, 19:09:11",2013-02-07 05:26:33,2010-02-06 10:41:55,2010-03-05 05:51:06,9493
868,89,565,1522,"26 days, 19:10:01",2013-02-03 10:15:39,2013-02-03 10:15:39,2013-03-02 05:25:40,8530
231,790,1631,2652,"26 days, 19:13:40",2013-02-03 10:12:00,2013-02-03 10:12:00,2013-03-02 05:25:40,1042
114,590,930,1634,"26 days, 19:21:57",2013-02-07 05:43:21,2010-02-01 10:32:08,2010-02-28 05:54:05,8091
893,1619,3571,6083,"26 days, 19:29:35",2013-02-05 02:05:44,2010-02-01 10:32:08,2010-02-28 06:01:43,5681
19,966,1681,2666,"26 days, 19:33:51",2013-02-06 09:47:42,2010-02-01 10:32:08,2010-02-28 06:05:59,8502
1677,613,912,3202,"26 days, 19:36:12",2013-02-03 09:49:28,2013-02-03 09:49:28,2013-03-02 05:25:40,5654
446,1003,1361,2810,"26 days, 19:37:20",2013-02-03 09:48:20,2013-02-03 09:48:20,2013-03-02 05:25:40,2746
221,589,1709,2519,"26 days, 20:01:12",2013-02-07 03:35:44,2010-02-01 10:32:08,2010-02-28 06:33:20,7145
682,973,1781,3436,"26 days, 20:02:51",2013-02-07 10:34:58,2010-02-01 10:32:08,2010-02-28 06:34:59,6206
1489,576,1148,3213,"26 days, 20:07:28",2013-02-03 09:18:12,2013-02-03 09:18:12,2013-03-02 05:25:40,9029
744,3411,3581,7736,"26 days, 20:08:06",2013-02-09 06:56:27,2010-02-01 10:32:08,2010-02-28 06:40:14,6965
386,567,564,1517,"26 days, 20:09:02",2013-02-03 09:16:38,2013-02-03 09:16:38,2013-03-02 05:25:40,4348
25,1418,1580,3023,"26 days, 20:09:08",2013-02-03 09:16:32,2013-02-03 09:16:32,2013-03-02 05:25:40,5404
186,3550,2813,6549,"26 days, 20:15:10",2013-02-03 09:10:30,2013-02-03 09:10:30,2013-03-02 05:25:40,160
815,735,1395,2945,"26 days, 20:22:03",2013-02-03 09:03:37,2013-02-03 09:03:37,2013-03-02 05:25:40,8135
805,5044,4875,10724,"26 days, 20:23:54",2013-02-06 09:22:20,2010-02-01 10:32:08,2010-02-28 06:56:02,7669
1313,40,451,1804,"26 days, 20:23:56",2013-02-03 09:01:44,2013-02-03 09:01:44,2013-03-02 05:25:40,4508
341,700,1275,2316,"26 days, 20:24:27",2013-02-06 09:29:35,2010-02-01 10:32:08,2010-02-28 06:56:35,3529
755,187,521,1463,"26 days, 20:35:22",2013-02-03 08:50:18,2013-02-03 08:50:18,2013-03-02 05:25:40,4501
490,6521,6958,13969,"26 days, 20:43:29",2013-02-07 10:40:04,2010-02-01 10:32:08,2010-02-28 07:15:37,5174
62,1303,1837,3202,"26 days, 20:47:01",2013-02-06 04:35:15,2010-02-01 10:32:08,2010-02-28 07:19:09,6303
1051,4320,7213,12584,"26 days, 20:51:17",2013-02-07 02:13:29,2010-02-01 10:32:08,2010-02-28 07:23:25,4634
611,796,751,2158,"26 days, 20:58:43",2013-02-06 10:51:13,2010-02-01 10:32:08,2010-02-28 07:30:51,7380
298,1624,1788,3710,"26 days, 21:01:06",2013-02-06 11:05:26,2010-02-01 10:32:08,2010-02-28 07:33:14,7966
434,81,296,811,"26 days, 21:02:58",2013-02-07 07:36:55,2010-02-01 10:32:08,2010-02-28 07:35:06,856
550,1129,1507,3186,"26 days, 21:04:52",2013-02-03 08:20:48,2013-02-03 08:20:48,2013-03-02 05:25:40,6564
95,1199,1443,2737,"26 days, 21:31:14",2013-02-03 07:54:26,2013-02-03 07:54:26,2013-03-02 05:25:40,7311
1293,7002,5301,13596,"26 days, 21:31:58",2013-02-06 01:35:46,2010-02-19 10:38:15,2010-03-18 08:10:13,1696
231,2399,3716,6346,"26 days, 21:32:00",2013-02-07 07:24:55,2010-02-01 10:32:08,2010-02-28 08:04:08,4437
627,3364,2819,6810,"26 days, 21:44:14",2013-02-07 03:49:45,2010-02-01 10:32:08,2010-02-28 08:16:22,8976
47,1060,1039,2146,"26 days, 21:44:36",2013-02-03 07:41:04,2013-02-03 07:41:04,2013-03-02 05:25:40,153
1401,498,509,2408,"26 days, 21:51:12",2013-02-03 07:34:28,2013-02-03 07:34:28,2013-03-02 05:25:40,7668
114,787,936,1837,"26 days, 21:54:30",2013-02-06 06:48:53,2010-09-14 03:43:41,2010-10-11 01:38:11,6733
224,244,450,918,"26 days, 22:02:06",2013-02-03 07:23:34,2013-02-03 07:23:34,2013-03-02 05:25:40,9788
273,3305,4046,7624,"26 days, 22:04:27",2013-02-07 05:59:28,2010-02-23 03:21:29,2010-03-22 01:25:56,9524
935,3764,3433,8132,"26 days, 22:08:34",2013-02-06 02:08:15,2010-03-08 02:27:47,2010-04-04 00:36:21,618
1292,5107,5619,12018,"26 days, 22:08:42",2013-02-07 06:10:27,2010-02-01 10:32:08,2010-02-28 08:40:50,8374
344,2600,3027,5971,"26 days, 22:13:33",2013-02-05 00:02:13,2010-02-01 10:32:08,2010-02-28 08:45:41,9692
712,813,1537,3062,"26 days, 22:14:36",2013-02-03 07:11:04,2013-02-03 07:11:04,2013-03-02 05:25:40,168
75,3163,4393,7631,"26 days, 22:37:59",2013-02-12 09:27:15,2010-02-01 10:32:08,2010-02-28 09:10:07,6843
769,480,1101,2350,"26 days, 22:57:49",2013-02-07 02:58:31,2010-04-26 11:15:16,2010-05-23 10:13:05,5021
503,141,434,1078,"26 days, 23:03:51",2013-02-03 06:21:49,2013-02-03 06:21:49,2013-03-02 05:25:40,7073
888,189,843,1920,"26 days, 23:04:33",2013-02-03 06:21:07,2013-02-03 06:21:07,2013-03-02 05:25:40,7449
72,18,253,343,"26 days, 23:17:29",2013-02-03 06:08:11,2013-02-03 06:08:11,2013-03-02 05:25:40,124
439,6249,7292,13980,"26 days, 23:49:04",2013-02-07 08:27:19,2010-03-04 09:42:34,2010-03-31 09:31:38,4013
584,3214,3977,7775,"26 days, 23:52:41",2013-02-06 08:46:30,2010-02-01 10:32:08,2010-02-28 10:24:49,8322
1510,465,1105,3080,"26 days, 23:59:14",2013-02-07 09:08:21,2010-02-01 10:32:08,2010-02-28 10:31:22,3528
1123,3599,4584,9306,"27 days, 0:00:01",2013-02-11 06:58:15,2010-02-01 10:32:08,2010-02-28 10:32:09,2832
5,699,1193,1897,"27 days, 0:05:34",2013-02-03 05:20:06,2013-02-03 05:20:06,2013-03-02 05:25:40,5090
220,771,974,1965,"27 days, 0:09:05",2013-02-03 05:16:35,2013-02-03 05:16:35,2013-03-02 05:25:40,3933
1314,1232,1471,4017,"27 days, 0:20:45",2013-02-07 07:20:40,2010-02-01 10:32:08,2010-02-28 10:52:53,8604
923,665,633,2221,"27 days, 0:27:58",2013-02-03 04:57:42,2013-02-03 04:57:42,2013-03-02 05:25:40,7754
543,3162,3576,7281,"27 days, 0:32:39",2013-02-09 10:00:46,2010-02-01 10:32:08,2010-02-28 11:04:47,4312
1336,5410,6893,13639,"27 days, 0:34:43",2013-02-08 03:29:02,2010-02-01 10:32:08,2010-02-28 11:06:51,1146
956,1320,2473,4749,"27 days, 0:38:50",2013-02-05 08:35:50,2010-02-01 10:32:08,2010-02-28 11:10:58,3928
968,1441,1649,4058,"27 days, 0:55:31",2013-02-03 04:30:09,2013-02-03 04:30:09,2013-03-02 05:25:40,4923
612,384,631,1627,"27 days, 1:05:31",2013-02-03 04:20:09,2013-02-03 04:20:09,2013-03-02 05:25:40,802
998,161,727,1886,"27 days, 1:17:05",2013-02-06 08:10:03,2010-04-24 10:15:00,2010-05-21 11:32:05,9045
1079,874,1244,3197,"27 days, 1:19:03",2013-02-07 11:37:27,2010-02-01 10:32:08,2010-02-28 11:51:11,4635
1305,262,464,2031,"27 days, 1:20:26",2013-02-03 04:05:14,2013-02-03 04:05:14,2013-03-02 05:25:40,5645
175,968,1567,2710,"27 days, 1:21:39",2013-02-05 04:45:19,2010-02-01 10:32:08,2010-02-28 11:53:47,3832
102,702,1113,1917,"27 days, 1:38:54",2013-02-03 03:46:46,2013-02-03 03:46:46,2013-03-02 05:25:40,8779
559,552,1314,2425,"27 days, 1:58:46",2013-02-06 11:32:48,2010-04-10 07:27:49,2010-05-07 09:26:35,1168
1123,724,991,2838,"27 days, 2:10:16",2013-02-03 03:15:24,2013-02-03 03:15:24,2013-03-02 05:25:40,4955
443,607,1193,2243,"27 days, 2:38:52",2013-02-06 10:09:09,2010-03-07 08:48:13,2010-04-03 11:27:05,1589
46,1755,1999,3800,"27 days, 3:08:06",2013-02-04 11:02:48,2010-03-04 06:09:01,2010-03-31 09:17:07,362
1506,666,1145,3317,"27 days, 3:13:57",2013-02-03 02:11:43,2013-02-03 02:11:43,2013-03-02 05:25:40,6314
933,350,593,1876,"27 days, 4:09:59",2013-02-05 05:24:25,2010-03-27 03:30:24,2010-04-23 07:40:23,115
375,1241,1860,3476,"27 days, 4:44:44",2013-02-03 10:47:21,2010-02-22 04:18:58,2010-03-21 09:03:42,4436
132,5379,6049,11560,"27 days, 6:41:04",2013-02-07 08:03:54,2010-02-05 02:40:32,2010-03-04 09:21:36,9030
1215,740,1088,3043,"27 days, 13:32:24",2013-02-05 08:01:44,2010-02-01 10:32:08,2010-03-01 00:04:32,158
256,611,908,1775,"27 days, 13:34:07",2013-02-06 09:03:54,2010-04-09 11:40:35,2010-05-07 01:14:42,717
1082,618,2165,3865,"27 days, 13:38:26",2013-02-07 00:11:56,2010-02-01 10:32:08,2010-03-01 00:10:34,4388
23,1338,3167,4528,"27 days, 14:05:10",2013-02-05 05:11:27,2010-02-01 10:32:08,2010-03-01 00:37:18,7408
851,3812,4801,9464,"27 days, 14:23:10",2013-02-09 08:21:11,2010-02-01 10:32:08,2010-03-01 00:55:18,3392
1584,2532,4301,8417,"27 days, 14:35:32",2013-02-07 06:53:36,2010-02-01 10:32:08,2010-03-01 01:07:40,6906
998,4309,3565,8872,"27 days, 14:56:34",2013-02-09 11:09:23,2010-02-10 11:27:48,2010-03-10 02:24:22,9917
711,5681,7582,13974,"27 days, 14:59:08",2013-02-07 07:50:30,2010-02-01 10:32:08,2010-03-01 01:31:16,4150
859,1704,3016,5579,"27 days, 15:15:15",2013-02-06 03:23:21,2010-02-01 10:32:08,2010-03-01 01:47:23,3752
258,268,530,1056,"27 days, 15:16:51",2013-02-06 08:03:49,2010-02-01 10:32:08,2010-03-01 01:48:59,440
213,5688,4703,10604,"27 days, 15:24:16",2013-02-07 02:55:02,2010-02-01 10:32:08,2010-03-01 01:56:24,2328
805,535,1516,2856,"27 days, 15:38:11",2013-02-05 06:21:21,2010-02-01 10:32:08,2010-03-01 02:10:19,7079
434,4518,5359,10311,"27 days, 16:07:14",2013-02-07 00:24:46,2010-02-01 10:32:08,2010-03-01 02:39:22,3573
243,1045,1239,2527,"27 days, 16:10:46",2013-02-05 09:44:38,2010-02-01 10:32:08,2010-03-01 02:42:54,5766
751,6323,7999,15073,"27 days, 16:17:16",2013-02-07 09:46:35,2010-02-01 10:32:08,2010-03-01 02:49:24,2875
26,1202,1747,2975,"27 days, 16:20:28",2013-02-05 10:00:26,2010-02-01 10:32:08,2010-03-01 02:52:36,3781
670,179,519,1368,"27 days, 16:40:34",2013-02-03 00:10:18,2010-02-01 10:32:08,2010-03-01 03:12:42,1990
352,6803,5538,12693,"27 days, 16:41:11",2013-02-07 07:51:44,2010-02-01 10:32:08,2010-03-01 03:13:19,5244
61,7100,5951,13112,"27 days, 16:45:10",2013-02-11 00:29:15,2010-02-01 10:32:08,2010-03-01 03:17:18,2502
76,7055,8753,15884,"27 days, 16:52:25",2013-02-07 05:02:58,2010-02-15 08:42:21,2010-03-15 01:34:46,9781
1085,7599,7197,15881,"27 days, 16:53:36",2013-02-07 10:48:07,2010-02-01 10:32:08,2010-03-01 03:25:44,5352
463,1097,1141,2701,"27 days, 17:13:24",2013-02-06 03:25:29,2010-02-01 10:32:08,2010-03-01 03:45:32,5256
1054,1618,2393,5065,"27 days, 17:26:13",2013-02-06 11:15:56,2010-02-01 10:32:08,2010-03-01 03:58:21,9525
874,2399,4899,8172,"27 days, 17:29:37",2013-02-07 08:04:08,2010-02-01 10:32:08,2010-03-01 04:01:45,1086
1863,2423,3143,7429,"27 days, 17:44:06",2013-02-06 10:32:38,2010-02-01 10:32:08,2010-03-01 04:16:14,5985
704,5502,5341,11547,"27 days, 17:46:50",2013-02-07 00:55:44,2010-02-01 10:32:08,2010-03-01 04:18:58,6995
14,117,290,421,"27 days, 17:47:12",2013-02-02 11:38:28,2013-02-02 11:38:28,2013-03-02 05:25:40,3198
2018,5097,5960,13075,"27 days, 17:53:25",2013-02-12 00:26:56,2010-02-01 10:32:08,2010-03-01 04:25:33,9567
144,101,186,431,"27 days, 17:54:44",2013-02-05 02:57:42,2010-02-01 10:32:08,2010-03-01 04:26:52,2363
564,3692,3892,8148,"27 days, 17:56:29",2013-02-06 07:30:45,2010-02-01 10:32:08,2010-03-01 04:28:37,4245
46,1777,2703,4526,"27 days, 17:56:43",2013-02-07 07:37:05,2010-02-01 10:32:08,2010-03-01 04:28:51,8670
914,2116,2786,5816,"27 days, 17:58:55",2013-02-05 10:34:26,2010-02-01 10:32:08,2010-03-01 04:31:03,8967
36,5543,6485,12064,"27 days, 18:08:18",2013-02-06 11:01:18,2010-02-01 10:32:08,2010-03-01 04:40:26,8631
153,398,661,1212,"27 days, 18:08:47",2013-02-02 11:16:53,2013-02-02 11:16:53,2013-03-02 05:25:40,4026
635,764,1972,3371,"27 days, 18:19:40",2013-02-08 11:46:38,2010-02-01 10:32:08,2010-03-01 04:51:48,6479
1281,322,710,2313,"27 days, 18:28:29",2013-02-02 10:57:11,2013-02-02 10:57:11,2013-03-02 05:25:40,6122
453,824,1735,3012,"27 days, 18:31:06",2013-02-07 01:14:46,2010-02-01 10:32:08,2010-03-01 05:03:14,2411
809,3609,3863,8281,"27 days, 18:33:27",2013-02-08 05:23:36,2010-02-01 10:32:08,2010-03-01 05:05:35,9947
98,596,467,1161,"27 days, 18:41:26",2013-02-02 10:44:14,2013-02-02 10:44:14,2013-03-02 05:25:40,4794
749,6559,7889,15197,"27 days, 18:48:38",2013-02-08 10:30:06,2010-02-01 10:32:08,2010-03-01 05:20:46,1500
51,370,1101,1522,"27 days, 18:52:05",2013-02-02 10:33:35,2013-02-02 10:33:35,2013-03-02 05:25:40,7098
1586,176,505,2267,"27 days, 18:59:20",2013-02-02 10:26:20,2013-02-02 10:26:20,2013-03-02 05:25:40,3843
1103,4012,4214,9329,"27 days, 19:08:57",2013-02-06 10:19:31,2010-02-01 10:32:08,2010-03-01 05:41:05,9679
1608,7792,6592,15992,"27 days, 19:09:59",2013-02-07 11:06:02,2010-02-01 10:32:08,2010-03-01 05:42:07,2971
829,5270,5811,11910,"27 days, 19:19:51",2013-02-08 09:11:35,2010-02-01 10:32:08,2010-03-01 05:51:59,3063
1246,1315,1281,3842,"27 days, 19:20:29",2013-02-06 04:19:45,2010-03-23 10:38:06,2010-04-20 05:58:35,5744
673,5880,4972,11525,"27 days, 19:27:36",2013-02-06 03:36:48,2010-02-01 10:32:08,2010-03-01 05:59:44,3016
942,5126,5703,11771,"27 days, 19:45:53",2013-02-07 06:06:26,2010-02-01 10:32:08,2010-03-01 06:18:01,1001
730,688,2100,3518,"27 days, 19:46:55",2013-02-06 00:28:37,2010-02-01 10:32:08,2010-03-01 06:19:03,9354
727,1956,2720,5403,"27 days, 19:47:06",2013-02-07 03:02:12,2010-02-27 11:56:42,2010-03-27 07:43:48,357
33,679,1165,1877,"27 days, 19:55:46",2013-02-02 09:29:54,2013-02-02 09:29:54,2013-03-02 05:25:40,1113
597,53,272,922,"27 days, 19:57:21",2013-02-04 11:12:09,2010-02-01 10:32:08,2010-03-01 06:29:29,7017
2380,8223,7815,18418,"27 days, 19:59:23",2013-02-07 09:57:11,2010-02-01 10:32:08,2010-03-01 06:31:31,8012
541,3301,3427,7269,"27 days, 20:00:09",2013-02-06 05:31:09,2010-02-01 10:32:08,2010-03-01 06:32:17,1885
1224,7155,4407,12786,"27 days, 20:00:35",2013-02-06 06:25:22,2010-02-01 10:32:08,2010-03-01 06:32:43,1464
1416,6387,7403,15206,"27 days, 20:10:10",2013-02-07 06:27:34,2010-02-01 10:32:08,2010-03-01 06:42:18,7112
400,323,1042,1765,"27 days, 20:37:53",2013-02-07 01:01:45,2010-02-01 10:32:08,2010-03-01 07:10:01,5132
13,223,861,1097,"27 days, 21:00:27",2013-02-06 02:05:38,2010-02-01 10:32:08,2010-03-01 07:32:35,6374
439,717,1094,2250,"27 days, 21:05:43",2013-02-05 09:49:47,2010-02-01 10:32:08,2010-03-01 07:37:51,9928
808,5495,4757,11060,"27 days, 21:08:26",2013-02-05 05:03:29,2010-02-01 10:32:08,2010-03-01 07:40:34,3039
16,3319,6265,9600,"27 days, 21:22:33",2013-02-09 05:41:41,2010-02-01 10:32:08,2010-03-01 07:54:41,4367
1393,791,1393,3577,"27 days, 21:25:10",2013-02-06 02:24:52,2010-02-01 10:32:08,2010-03-01 07:57:18,9463
402,2097,3983,6482,"27 days, 21:34:12",2013-02-07 07:04:26,2010-02-01 10:32:08,2010-03-01 08:06:20,1106
654,7741,6964,15359,"27 days, 21:49:15",2013-02-07 07:24:36,2010-02-01 10:32:08,2010-03-01 08:21:23,5441
1290,124,210,1624,"27 days, 22:09:49",2013-02-02 07:15:51,2013-02-02 07:15:51,2013-03-02 05:25:40,9420
652,1260,2138,4050,"27 days, 22:23:41",2013-02-07 03:55:55,2010-02-01 10:32:08,2010-03-01 08:55:49,3131
539,297,506,1342,"27 days, 22:34:56",2013-02-03 08:45:46,2010-06-01 05:14:07,2010-06-29 03:49:03,1744
39,3131,5245,8415,"27 days, 22:40:34",2013-02-06 02:32:05,2010-02-01 10:32:08,2010-03-01 09:12:42,5200
390,1750,2796,4936,"27 days, 22:43:01",2013-02-07 06:08:21,2010-02-01 10:32:08,2010-03-01 09:15:09,6803
72,2537,3067,5676,"27 days, 22:46:30",2013-02-06 07:59:41,2010-02-01 10:32:08,2010-03-01 09:18:38,3118
788,113,165,1066,"27 days, 22:48:55",2013-02-02 06:36:45,2013-02-02 06:36:45,2013-03-02 05:25:40,3606
644,215,348,1207,"27 days, 22:59:41",2013-02-05 09:41:25,2010-02-01 10:32:08,2010-03-01 09:31:49,4332
39,1878,3797,5714,"27 days, 23:09:49",2013-02-07 08:37:19,2010-02-23 04:42:20,2010-03-23 03:52:09,9069
45,4277,3101,7423,"27 days, 23:24:47",2013-02-07 11:21:20,2010-02-01 10:32:08,2010-03-01 09:56:55,5328
521,266,648,1435,"27 days, 23:25:42",2013-02-02 05:59:58,2013-02-02 05:59:58,2013-03-02 05:25:40,4152
630,9968,9338,19936,"27 days, 23:31:45",2013-02-07 10:07:40,2010-02-12 11:17:11,2010-03-12 10:48:56,2616
31,1341,2380,3752,"27 days, 23:42:59",2013-02-05 10:32:48,2010-03-10 01:03:00,2010-04-07 00:45:59,8531
1713,7790,7834,17337,"27 days, 23:43:58",2013-02-07 04:42:31,2010-02-01 10:32:08,2010-03-01 10:16:06,1779
48,446,1159,1653,"28 days, 0:00:44",2013-02-06 08:00:23,2010-05-03 01:44:55,2010-05-31 01:45:39,4155
889,809,1517,3215,"28 days, 0:04:06",2013-02-05 02:14:50,2010-02-01 10:32:08,2010-03-01 10:36:14,432
10,243,440,693,"28 days, 0:12:01",2013-02-02 05:13:39,2013-02-02 05:13:39,2013-03-02 05:25:40,526
2506,2886,6005,11397,"28 days, 0:13:10",2013-02-16 07:13:15,2010-02-01 10:32:08,2010-03-01 10:45:18,4247
113,4744,5913,10770,"28 days, 0:24:44",2013-02-06 09:20:52,2010-02-01 10:32:08,2010-03-01 10:56:52,9013
93,7175,7753,15021,"28 days, 0:28:21",2013-02-07 11:45:35,2010-02-01 10:32:08,2010-03-01 11:00:29,5771
1244,614,1121,2979,"28 days, 0:29:05",2013-02-05 06:52:09,2010-02-01 10:32:08,2010-03-01 11:01:13,5142
529,498,741,1768,"28 days, 0:29:39",2013-02-06 06:31:22,2010-05-15 08:33:45,2010-06-12 09:03:24,6149
255,6379,6111,12745,"28 days, 0:32:45",2013-02-07 09:50:44,2010-02-10 10:46:28,2010-03-10 11:19:13,9406
67,231,390,688,"28 days, 0:54:00",2013-02-02 04:31:40,2013-02-02 04:31:40,2013-03-02 05:25:40,6953
1537,6543,6549,14629,"28 days, 1:07:20",2013-02-06 08:58:13,2010-02-01 10:32:08,2010-03-01 11:39:28,1541
344,1469,1890,3703,"28 days, 1:21:03",2013-02-06 03:42:58,2010-03-29 04:14:15,2010-04-26 05:35:18,4747
180,231,601,1012,"28 days, 1:21:49",2013-02-02 04:03:51,2013-02-02 04:03:51,2013-03-02 05:25:40,4266
444,2774,3735,6953,"28 days, 1:47:23",2013-02-12 11:25:45,2010-03-08 02:53:30,2010-04-05 04:40:53,9533
8,290,343,641,"28 days, 1:58:30",2013-02-02 03:27:10,2013-02-02 03:27:10,2013-03-02 05:25:40,4789
130,311,418,859,"28 days, 2:21:46",2013-02-02 03:03:54,2013-02-02 03:03:54,2013-03-02 05:25:40,5466
880,1211,1116,3207,"28 days, 2:25:31",2013-02-02 03:00:09,2013-02-02 03:00:09,2013-03-02 05:25:40,7799
164,292,471,927,"28 days, 2:39:35",2013-02-02 02:46:05,2013-02-02 02:46:05,2013-03-02 05:25:40,6758
664,314,468,1446,"28 days, 3:01:59",2013-02-02 02:23:41,2013-02-02 02:23:41,2013-03-02 05:25:40,8268
503,194,362,1059,"28 days, 3:20:04",2013-02-02 02:05:36,2013-02-02 02:05:36,2013-03-02 05:25:40,5633
626,219,292,1137,"28 days, 3:53:01",2013-02-02 01:32:39,2013-02-02 01:32:39,2013-03-02 05:25:40,8803
1101,5148,4156,10405,"28 days, 5:13:46",2013-02-06 06:30:56,2010-02-26 04:06:32,2010-03-26 09:20:18,6006
242,1807,2738,4787,"28 days, 10:04:57",2013-02-05 10:00:28,2010-02-11 01:37:27,2010-03-11 11:42:24,3057
656,968,1372,2996,"28 days, 13:30:03",2013-02-05 00:58:04,2010-02-01 10:32:08,2010-03-02 00:02:11,1681
61,5302,6657,12020,"28 days, 13:34:07",2013-02-11 09:28:15,2010-02-01 10:32:08,2010-03-02 00:06:15,6641
484,218,422,1124,"28 days, 13:41:04",2013-02-03 04:46:57,2010-02-01 10:32:08,2010-03-02 00:13:12,6245
764,2041,2254,5059,"28 days, 13:41:52",2013-02-06 08:41:36,2010-02-01 10:32:08,2010-03-02 00:14:00,5019
423,2233,4307,6963,"28 days, 13:44:14",2013-02-07 07:04:30,2010-02-01 10:32:08,2010-03-02 00:16:22,9614
433,758,1284,2475,"28 days, 13:48:30",2013-02-07 06:02:25,2010-02-01 10:32:08,2010-03-02 00:20:38,5392
47,689,2153,2889,"28 days, 14:28:03",2013-02-06 07:19:43,2010-02-01 10:32:08,2010-03-02 01:00:11,375
1080,2143,2997,6220,"28 days, 14:29:34",2013-02-06 05:59:17,2010-02-01 10:32:08,2010-03-02 01:01:42,1501
541,921,1502,2964,"28 days, 14:42:46",2013-02-07 00:16:13,2010-02-01 10:32:08,2010-03-02 01:14:54,5096
326,2450,2774,5550,"28 days, 14:49:47",2013-02-04 10:25:29,2010-02-01 10:32:08,2010-03-02 01:21:55,6705
787,4557,4084,9428,"28 days, 15:00:44",2013-02-07 00:34:16,2010-02-01 10:32:08,2010-03-02 01:32:52,6813
2290,3858,4410,10558,"28 days, 15:11:04",2013-02-07 05:12:56,2010-02-01 10:32:08,2010-03-02 01:43:12,9498
1925,8966,7693,18584,"28 days, 15:24:03",2013-02-07 04:27:46,2010-02-01 10:32:08,2010-03-02 01:56:11,2292
165,1485,2458,4108,"28 days, 15:28:05",2013-02-07 02:40:49,2010-02-01 10:32:08,2010-03-02 02:00:13,6383
445,285,538,1268,"28 days, 15:32:04",2013-02-07 08:21:41,2010-02-01 10:32:08,2010-03-02 02:04:12,8412
411,3998,4505,8914,"28 days, 15:35:01",2013-02-07 07:08:53,2010-02-01 10:32:08,2010-03-02 02:07:09,3580
1397,8085,7784,17266,"28 days, 15:35:26",2013-02-06 11:35:51,2010-02-01 10:32:08,2010-03-02 02:07:34,5349
199,5244,6249,11692,"28 days, 15:41:25",2013-02-06 06:39:25,2010-02-01 10:32:08,2010-03-02 02:13:33,2311
2074,7903,7902,17879,"28 days, 16:09:12",2013-02-07 11:55:05,2010-02-01 10:32:08,2010-03-02 02:41:20,5866
160,519,735,1414,"28 days, 16:25:25",2013-02-05 08:25:39,2010-02-01 10:32:08,2010-03-02 02:57:33,7481
1053,5354,5202,11609,"28 days, 16:37:00",2013-02-07 06:49:01,2010-02-01 10:32:08,2010-03-02 03:09:08,7089
179,3166,3061,6406,"28 days, 16:39:26",2013-02-06 09:43:43,2010-02-01 10:32:08,2010-03-02 03:11:34,3035
500,79,201,780,"28 days, 16:41:18",2013-02-05 04:37:57,2011-08-06 09:59:56,2011-09-04 02:41:14,5178
662,5513,4632,10807,"28 days, 16:43:29",2013-02-07 02:00:12,2010-02-01 10:32:08,2010-03-02 03:15:37,6202
86,927,1356,2369,"28 days, 16:47:38",2013-02-07 09:56:48,2010-02-01 10:32:08,2010-03-02 03:19:46,5439
1162,1690,3416,6268,"28 days, 16:48:38",2013-02-05 10:48:46,2010-02-01 10:32:08,2010-03-02 03:20:46,2954
406,2763,4416,7585,"28 days, 16:55:58",2013-02-06 04:15:27,2010-02-01 10:32:08,2010-03-02 03:28:06,3090
807,120,653,1580,"28 days, 17:03:49",2013-02-03 05:41:57,2010-06-16 09:58:44,2010-07-15 03:02:33,3182
1462,973,1745,4180,"28 days, 17:07:33",2013-02-07 03:45:59,2010-02-01 10:32:08,2010-03-02 03:39:41,5740
1694,2943,5007,9644,"28 days, 17:23:33",2013-02-10 00:04:50,2010-02-01 10:32:08,2010-03-02 03:55:41,6977
378,8113,6514,15005,"28 days, 17:34:28",2013-02-07 08:57:38,2010-02-01 10:32:08,2010-03-02 04:06:36,3564
655,2587,2326,5568,"28 days, 17:35:12",2013-02-07 09:12:56,2010-02-13 09:52:24,2010-03-14 03:27:36,8768
1023,131,527,1681,"28 days, 17:42:08",2013-02-01 11:43:32,2013-02-01 11:43:32,2013-03-02 05:25:40,6487
623,1017,1750,3390,"28 days, 17:51:32",2013-02-08 06:01:55,2010-02-01 10:32:08,2010-03-02 04:23:40,81
120,4238,6395,10753,"28 days, 17:54:13",2013-02-07 07:58:59,2010-02-01 10:32:08,2010-03-02 04:26:21,808
1576,3848,5192,10616,"28 days, 17:55:50",2013-02-07 00:55:31,2010-02-01 10:32:08,2010-03-02 04:27:58,1212
2151,4362,5272,11785,"28 days, 18:05:13",2013-02-07 07:52:14,2010-02-01 10:32:08,2010-03-02 04:37:21,7279
617,302,483,1402,"28 days, 18:06:52",2013-02-01 11:18:48,2013-02-01 11:18:48,2013-03-02 05:25:40,8676
555,2258,3615,6428,"28 days, 18:10:08",2013-02-10 05:40:50,2010-02-01 10:32:08,2010-03-02 04:42:16,8886
27,618,704,1349,"28 days, 18:20:03",2013-02-06 11:33:05,2010-02-01 10:32:08,2010-03-02 04:52:11,6691
493,352,658,1503,"28 days, 18:23:00",2013-02-01 11:02:40,2013-02-01 11:02:40,2013-03-02 05:25:40,534
81,364,626,1071,"28 days, 18:28:59",2013-02-04 04:45:48,2010-02-01 10:32:08,2010-03-02 05:01:07,5188
563,2005,3370,5938,"28 days, 18:29:05",2013-02-07 08:02:05,2010-02-01 10:32:08,2010-03-02 05:01:13,1288
1189,4407,3576,9172,"28 days, 18:33:18",2013-02-08 05:09:17,2010-02-01 10:32:08,2010-03-02 05:05:26,5643
143,409,1117,1669,"28 days, 18:46:59",2013-02-06 00:59:02,2010-02-01 10:32:08,2010-03-02 05:19:07,7607
2556,7292,6377,16225,"28 days, 19:05:45",2013-02-06 11:32:29,2010-02-01 10:32:08,2010-03-02 05:37:53,8102
523,5309,4030,9862,"28 days, 19:07:56",2013-02-07 03:03:19,2010-02-01 10:32:08,2010-03-02 05:40:04,5534
168,208,347,723,"28 days, 19:09:25",2013-02-03 09:26:43,2010-02-01 10:32:08,2010-03-02 05:41:33,3308
46,524,824,1394,"28 days, 19:18:17",2013-02-05 04:45:25,2010-04-10 05:33:12,2010-05-09 00:51:29,5749
376,516,539,1431,"28 days, 19:37:59",2013-02-05 05:20:52,2010-03-27 06:31:13,2010-04-25 02:09:12,9340
202,6244,5843,12289,"28 days, 19:44:02",2013-02-06 08:52:54,2010-02-01 10:32:08,2010-03-02 06:16:10,2981
1456,10455,7338,19249,"28 days, 19:44:09",2013-02-07 06:57:55,2010-02-01 10:32:08,2010-03-02 06:16:17,0
76,593,824,1493,"28 days, 19:47:54",2013-02-03 08:04:02,2010-05-05 07:00:21,2010-06-03 02:48:15,1728
122,1166,1373,2661,"28 days, 19:57:41",2013-02-04 07:20:29,2010-02-01 10:32:08,2010-03-02 06:29:49,1680
987,4533,5092,10612,"28 days, 20:06:30",2013-02-06 01:36:31,2010-02-01 10:32:08,2010-03-02 06:38:38,9516
243,46,202,491,"28 days, 20:06:47",2013-02-04 03:39:54,2010-10-15 09:27:38,2010-11-13 05:34:25,3507
755,3813,3499,8067,"28 days, 20:08:13",2013-02-07 05:58:04,2010-03-22 09:25:16,2010-04-20 05:33:29,8256
320,3397,4983,8700,"28 days, 20:13:13",2013-02-06 08:09:20,2010-02-01 10:32:08,2010-03-02 06:45:21,6949
697,630,1418,2745,"28 days, 20:14:46",2013-02-04 05:35:59,2010-02-01 10:32:08,2010-03-02 06:46:54,1357
549,1020,1039,2608,"28 days, 20:17:40",2013-02-07 01:59:33,2010-02-01 10:32:08,2010-03-02 06:49:48,5264
59,2739,4005,6803,"28 days, 20:19:31",2013-02-07 00:19:41,2010-02-01 10:32:08,2010-03-02 06:51:39,4584
64,3431,3992,7487,"28 days, 20:20:18",2013-02-07 07:23:35,2010-02-01 10:32:08,2010-03-02 06:52:26,6462
293,655,1758,2706,"28 days, 20:24:36",2013-02-05 04:27:42,2010-02-01 10:32:08,2010-03-02 06:56:44,9732
64,4870,5598,10532,"28 days, 20:28:00",2013-02-06 05:06:58,2010-02-01 10:32:08,2010-03-02 07:00:08,5110
33,5197,6811,12041,"28 days, 20:28:36",2013-02-06 06:38:17,2010-02-01 10:32:08,2010-03-02 07:00:44,5528
394,336,959,1689,"28 days, 20:31:23",2013-02-01 08:54:17,2013-02-01 08:54:17,2013-03-02 05:25:40,6771
802,939,1408,3149,"28 days, 20:35:58",2013-02-05 05:14:28,2010-02-01 10:32:08,2010-03-02 07:08:06,3460
963,6621,6376,13960,"28 days, 20:37:59",2013-02-06 09:08:43,2010-02-01 10:32:08,2010-03-02 07:10:07,7065
79,498,1254,1831,"28 days, 20:46:21",2013-02-06 02:23:34,2010-02-01 10:32:08,2010-03-02 07:18:29,6353
1114,95,455,1664,"28 days, 20:46:22",2013-02-06 05:52:36,2010-02-01 10:32:08,2010-03-02 07:18:30,3669
910,6687,7033,14630,"28 days, 20:52:52",2013-02-06 04:53:31,2010-02-01 10:32:08,2010-03-02 07:25:00,2375
264,1188,1886,3338,"28 days, 21:25:41",2013-02-06 10:52:55,2010-02-22 11:47:47,2010-03-23 09:13:28,3966
890,2561,1669,5120,"28 days, 21:32:52",2013-02-05 10:45:55,2010-02-01 10:32:08,2010-03-02 08:05:00,3143
282,1580,2333,4195,"28 days, 21:37:03",2013-02-05 08:19:05,2010-02-01 10:32:08,2010-03-02 08:09:11,3780
519,1659,1665,3843,"28 days, 21:38:28",2013-02-06 10:14:36,2010-02-01 10:32:08,2010-03-02 08:10:36,2053
47,2050,3082,5179,"28 days, 22:11:36",2013-02-07 02:36:13,2010-02-01 10:32:08,2010-03-02 08:43:44,6253
2045,3821,3577,9443,"28 days, 22:18:54",2013-02-06 01:52:00,2010-02-01 10:32:08,2010-03-02 08:51:02,2895
183,1703,3256,5142,"28 days, 22:24:18",2013-02-06 06:13:54,2010-02-01 10:32:08,2010-03-02 08:56:26,292
2871,7004,6983,16858,"28 days, 22:24:57",2013-02-07 06:13:09,2010-02-01 10:32:08,2010-03-02 08:57:05,7287
414,1047,1577,3038,"28 days, 22:33:45",2013-02-04 11:46:13,2010-02-01 10:32:08,2010-03-02 09:05:53,8249
910,6548,6937,14395,"28 days, 22:35:04",2013-02-06 02:10:40,2010-02-01 10:32:08,2010-03-02 09:07:12,9625
826,1308,1695,3829,"28 days, 22:35:50",2013-02-06 10:13:13,2010-02-01 10:32:08,2010-03-02 09:07:58,5205
1522,1259,1939,4720,"28 days, 22:39:32",2013-02-05 10:51:30,2010-02-01 10:32:08,2010-03-02 09:11:40,7967
1252,233,470,1955,"28 days, 22:42:58",2013-02-03 01:58:42,2010-02-01 10:32:08,2010-03-02 09:15:06,8891
333,2440,2761,5534,"28 days, 22:47:16",2013-02-07 01:39:02,2010-02-01 10:32:08,2010-03-02 09:19:24,5458
352,6792,5595,12739,"28 days, 22:55:02",2013-02-06 11:22:03,2010-02-01 10:32:08,2010-03-02 09:27:10,9376
103,2884,7528,10515,"28 days, 22:56:00",2013-02-07 06:18:19,2010-02-01 10:32:08,2010-03-02 09:28:08,4434
39,167,231,437,"28 days, 23:21:28",2013-02-01 06:04:12,2013-02-01 06:04:12,2013-03-02 05:25:40,9580
199,1641,2406,4246,"28 days, 23:34:38",2013-02-06 03:20:26,2010-02-01 10:32:08,2010-03-02 10:06:46,3100
67,4744,3314,8125,"28 days, 23:37:59",2013-02-06 02:16:36,2010-02-01 10:32:08,2010-03-02 10:10:07,6411
30,333,656,1019,"28 days, 23:41:29",2013-02-03 01:36:34,2010-06-07 03:15:24,2010-07-06 02:56:53,9241
1991,6083,6526,14600,"29 days, 0:04:43",2013-02-06 11:03:11,2010-02-01 10:32:08,2010-03-02 10:36:51,3547
74,582,867,1523,"29 days, 0:09:11",2013-02-01 05:16:29,2013-02-01 05:16:29,2013-03-02 05:25:40,9334
1369,5840,6355,13564,"29 days, 0:13:57",2013-02-06 11:38:34,2010-02-01 10:32:08,2010-03-02 10:46:05,3558
409,4370,3601,8380,"29 days, 0:25:47",2013-02-08 00:43:14,2010-02-01 10:32:08,2010-03-02 10:57:55,7585
160,1614,3114,4888,"29 days, 0:25:53",2013-02-07 03:51:52,2010-02-01 10:32:08,2010-03-02 10:58:01,3899
181,1257,2244,3682,"29 days, 0:32:46",2013-02-07 08:42:45,2010-02-01 10:32:08,2010-03-02 11:04:54,7303
1547,366,515,2428,"29 days, 0:36:38",2013-02-01 04:49:02,2013-02-01 04:49:02,2013-03-02 05:25:40,3741
262,917,1777,2956,"29 days, 0:41:45",2013-02-05 08:28:14,2010-02-01 10:32:08,2010-03-02 11:13:53,2222
607,2323,3300,6230,"29 days, 0:42:22",2013-02-07 05:02:29,2010-02-01 10:32:08,2010-03-02 11:14:30,4472
24,688,749,1461,"29 days, 0:48:00",2013-02-04 02:05:06,2010-02-23 01:34:02,2010-03-24 02:22:02,1081
1505,6078,6887,14470,"29 days, 0:51:36",2013-02-18 02:04:58,2010-02-01 10:32:08,2010-03-02 11:23:44,7389
219,1407,1622,3248,"29 days, 0:52:56",2013-02-06 11:36:16,2010-03-19 05:39:39,2010-04-17 06:32:35,5622
604,4160,4696,9460,"29 days, 0:58:33",2013-02-07 09:45:12,2010-02-21 03:00:39,2010-03-22 03:59:12,7471
412,399,818,1629,"29 days, 1:06:48",2013-02-03 11:30:15,2010-02-01 10:32:08,2010-03-02 11:38:56,1867
57,299,644,1000,"29 days, 1:14:55",2013-02-04 11:43:06,2010-02-01 10:32:08,2010-03-02 11:47:03,2830
711,1238,1811,3760,"29 days, 1:18:23",2013-02-06 06:52:16,2010-02-01 10:32:08,2010-03-02 11:50:31,2280
22,667,807,1496,"29 days, 2:03:28",2013-02-01 03:22:12,2013-02-01 03:22:12,2013-03-02 05:25:40,8106
146,67,305,518,"29 days, 2:41:57",2013-02-03 03:12:38,2010-09-27 07:32:28,2010-10-26 10:14:25,7545
768,205,473,1446,"29 days, 3:09:45",2013-02-01 02:15:55,2013-02-01 02:15:55,2013-03-02 05:25:40,9336
270,957,1448,2675,"29 days, 4:03:17",2013-02-03 07:02:00,2010-02-17 00:31:50,2010-03-18 04:35:07,7379
204,587,865,1656,"29 days, 4:28:23",2013-02-01 00:57:17,2013-02-01 00:57:17,2013-03-02 05:25:40,1673
494,748,1053,2295,"29 days, 4:47:02",2013-02-05 11:12:43,2010-03-08 04:22:25,2010-04-06 09:09:27,5277
61,932,761,1754,"29 days, 4:53:01",2013-02-25 08:19:25,2010-03-30 05:22:23,2010-04-28 10:15:24,5938
721,70,444,1235,"29 days, 4:54:00",2013-02-01 00:31:40,2013-02-01 00:31:40,2013-03-02 05:25:40,5807
13,2703,2565,5281,"29 days, 8:29:47",2013-02-04 06:11:16,2010-02-25 02:12:05,2010-03-26 10:41:52,4574
1493,789,998,3280,"29 days, 10:05:23",2013-02-04 04:52:54,2010-02-14 00:30:48,2010-03-15 10:36:11,8992
824,814,1406,3044,"29 days, 13:45:05",2013-02-06 01:31:39,2010-02-01 10:32:08,2010-03-03 00:17:13,7258
903,5643,5025,11571,"29 days, 13:49:15",2013-02-15 01:43:22,2010-02-01 10:32:08,2010-03-03 00:21:23,1115
270,4143,4971,9384,"29 days, 14:03:44",2013-02-07 01:22:29,2010-02-01 10:32:08,2010-03-03 00:35:52,7087
709,5927,6854,13490,"29 days, 14:08:51",2013-02-06 03:21:18,2010-02-01 10:32:08,2010-03-03 00:40:59,8390
61,4787,5261,10109,"29 days, 14:09:26",2013-02-07 00:12:07,2010-02-01 10:32:08,2010-03-03 00:41:34,9153
844,1264,2534,4642,"29 days, 14:11:52",2013-02-03 11:32:58,2010-02-01 10:32:08,2010-03-03 00:44:00,2731
31,8467,7408,15906,"29 days, 14:21:37",2013-02-07 02:22:36,2010-02-01 10:32:08,2010-03-03 00:53:45,5271
530,6048,6779,13357,"29 days, 14:21:47",2013-02-09 03:26:29,2010-02-01 10:32:08,2010-03-03 00:53:55,8229
960,158,479,1597,"29 days, 14:22:01",2013-02-03 02:04:25,2010-02-01 10:32:08,2010-03-03 00:54:09,2607
719,3019,3496,7234,"29 days, 14:30:39",2013-02-06 08:46:11,2010-02-01 10:32:08,2010-03-03 01:02:47,3173
346,1389,1825,3560,"29 days, 14:31:05",2013-02-06 02:55:05,2010-02-01 10:32:08,2010-03-03 01:03:13,4571
791,380,547,1718,"29 days, 14:31:18",2013-02-06 07:56:18,2010-02-01 10:32:08,2010-03-03 01:03:26,9997
325,1513,2331,4169,"29 days, 15:04:39",2013-02-04 01:08:00,2010-02-01 10:32:08,2010-03-03 01:36:47,7952
308,1081,2343,3732,"29 days, 15:11:51",2013-02-07 03:28:35,2010-02-01 10:32:08,2010-03-03 01:43:59,1544
61,3766,3532,7359,"29 days, 15:14:17",2013-02-07 09:43:54,2010-02-01 10:32:08,2010-03-03 01:46:25,5125
450,2087,2950,5487,"29 days, 15:26:13",2013-02-09 06:31:15,2010-02-01 10:32:08,2010-03-03 01:58:21,4751
941,225,378,1544,"29 days, 15:29:45",2013-02-05 02:55:15,2010-03-06 09:26:51,2010-04-05 00:56:36,6318
100,800,1434,2334,"29 days, 15:30:51",2013-02-05 11:39:19,2010-02-01 10:32:08,2010-03-03 02:02:59,5316
37,159,287,483,"29 days, 15:35:58",2013-02-03 07:42:22,2010-02-01 10:32:08,2010-03-03 02:08:06,7276
218,171,690,1079,"29 days, 15:47:28",2013-02-06 04:24:46,2010-02-01 10:32:08,2010-03-03 02:19:36,2683
1706,3576,3015,8297,"29 days, 15:50:31",2013-02-05 02:54:06,2010-02-01 10:32:08,2010-03-03 02:22:39,5667
145,788,1231,2164,"29 days, 15:59:37",2013-02-06 07:25:45,2010-02-01 10:32:08,2010-03-03 02:31:45,9033
1056,4959,3778,9793,"29 days, 15:59:59",2013-02-11 11:44:48,2010-02-01 10:32:08,2010-03-03 02:32:07,6692
2519,6170,5788,14477,"29 days, 16:00:30",2013-02-07 07:45:35,2010-02-17 10:13:25,2010-03-19 02:13:55,6992
168,4312,4108,8588,"29 days, 16:08:49",2013-02-07 04:49:57,2010-02-01 10:32:08,2010-03-03 02:40:57,7406
957,4922,4908,10787,"29 days, 16:18:31",2013-02-06 01:42:24,2010-02-01 10:32:08,2010-03-03 02:50:39,5833
1388,4866,3791,10045,"29 days, 16:21:53",2013-02-07 07:01:36,2010-02-01 10:32:08,2010-03-03 02:54:01,5948
998,4300,6122,11420,"29 days, 16:26:07",2013-02-06 11:22:59,2010-02-01 10:32:08,2010-03-03 02:58:15,169
975,173,241,1389,"29 days, 16:37:10",2013-02-04 09:45:56,2010-02-01 10:32:08,2010-03-03 03:09:18,4376
1617,4101,5158,10876,"29 days, 16:42:23",2013-02-06 05:18:17,2010-02-01 10:32:08,2010-03-03 03:14:31,7750
362,1360,2675,4397,"29 days, 16:48:53",2013-02-06 02:25:28,2010-02-01 10:32:08,2010-03-03 03:21:01,3239
79,3644,4428,8151,"29 days, 17:05:15",2013-02-05 05:31:19,2010-02-01 10:32:08,2010-03-03 03:37:23,6405
137,298,479,914,"29 days, 17:23:14",2013-02-06 03:47:13,2010-02-01 10:32:08,2010-03-03 03:55:22,5909
198,180,445,823,"29 days, 17:27:40",2013-01-31 11:58:00,2013-01-31 11:58:00,2013-03-02 05:25:40,6786
69,726,1084,1879,"29 days, 17:33:36",2013-02-05 10:37:03,2010-02-01 10:32:08,2010-03-03 04:05:44,6415
59,250,790,1099,"29 days, 17:47:43",2013-02-06 10:15:17,2010-02-01 10:32:08,2010-03-03 04:19:51,5783
631,1027,1650,3308,"29 days, 17:49:46",2013-02-07 08:01:42,2010-03-03 08:55:10,2010-04-02 02:44:56,3078
74,1630,2342,4046,"29 days, 17:56:41",2013-02-05 06:52:33,2010-02-01 10:32:08,2010-03-03 04:28:49,2071
282,582,1135,1999,"29 days, 18:13:14",2013-02-06 02:03:14,2010-02-01 10:32:08,2010-03-03 04:45:22,5806
486,5773,6202,12461,"29 days, 18:24:59",2013-02-07 01:58:07,2010-02-01 10:32:08,2010-03-03 04:57:07,6409
2037,2649,3867,8553,"29 days, 18:52:08",2013-02-15 03:02:38,2010-02-01 10:32:08,2010-03-03 05:24:16,9216
676,372,1407,2455,"29 days, 18:56:53",2013-02-05 01:25:08,2010-02-28 10:05:34,2010-03-30 05:02:27,2381
1187,6186,8288,15661,"29 days, 19:35:02",2013-02-07 10:35:41,2010-02-01 10:32:08,2010-03-03 06:07:10,8435
316,4263,6103,10682,"29 days, 19:38:19",2013-02-07 08:40:29,2010-02-01 10:32:08,2010-03-03 06:10:27,9409
1223,5638,3568,10429,"29 days, 19:48:56",2013-02-06 05:01:18,2010-02-01 10:32:08,2010-03-03 06:21:04,8554
197,2353,2532,5082,"29 days, 19:58:05",2013-02-07 01:29:20,2010-02-01 10:32:08,2010-03-03 06:30:13,1721
1564,555,761,2880,"29 days, 20:03:28",2013-02-05 06:30:07,2010-02-01 10:32:08,2010-03-03 06:35:36,6595
2839,5986,5762,14587,"29 days, 20:06:43",2013-02-07 05:16:59,2010-02-01 10:32:08,2010-03-03 06:38:51,8814
1001,33,219,1253,"29 days, 20:08:48",2013-01-31 09:16:52,2013-01-31 09:16:52,2013-03-02 05:25:40,5549
1460,5794,6768,14022,"29 days, 20:18:21",2013-02-07 08:25:37,2010-02-01 10:32:08,2010-03-03 06:50:29,2565
308,6651,6440,13399,"29 days, 20:27:24",2013-02-06 10:37:50,2010-02-01 10:32:08,2010-03-03 06:59:32,6994
156,81,346,583,"29 days, 20:27:39",2013-02-05 06:39:23,2010-09-07 05:08:57,2010-10-07 01:36:36,3984
262,917,1459,2638,"29 days, 20:27:46",2013-02-04 10:00:57,2010-02-01 10:32:08,2010-03-03 06:59:54,5521
548,3015,4264,7827,"29 days, 20:30:28",2013-02-07 06:03:17,2010-02-01 10:32:08,2010-03-03 07:02:36,5073
451,4587,4266,9304,"29 days, 20:35:25",2013-02-07 04:23:35,2010-02-01 10:32:08,2010-03-03 07:07:33,5870
762,8024,7634,16420,"29 days, 20:38:34",2013-02-07 02:23:55,2010-02-26 04:05:59,2010-03-28 00:44:33,1293
791,3015,4677,8483,"29 days, 20:38:51",2013-02-07 05:23:01,2010-02-01 10:32:08,2010-03-03 07:10:59,8617
137,4859,6371,11367,"29 days, 20:55:43",2013-02-07 00:24:15,2010-02-01 10:32:08,2010-03-03 07:27:51,7516
974,6563,7819,15356,"29 days, 20:57:28",2013-02-07 06:49:39,2010-02-01 10:32:08,2010-03-03 07:29:36,7050
307,434,741,1482,"29 days, 21:05:49",2013-01-31 08:19:51,2013-01-31 08:19:51,2013-03-02 05:25:40,2820
575,6067,7615,14257,"29 days, 21:07:17",2013-02-08 08:33:52,2010-02-01 10:32:08,2010-03-03 07:39:25,6529
662,295,528,1485,"29 days, 21:15:33",2013-02-03 03:53:09,2010-02-26 11:13:05,2010-03-28 08:28:38,5988
1325,0,17,1342,"29 days, 21:18:50",2013-01-31 08:06:50,2013-01-31 08:06:50,2013-03-02 05:25:40,7766
626,86,211,923,"29 days, 21:20:26",2013-01-31 08:05:14,2013-01-31 08:05:14,2013-03-02 05:25:40,2301
1019,374,544,1937,"29 days, 21:21:21",2013-01-31 08:04:19,2013-01-31 08:04:19,2013-03-02 05:25:40,2763
2044,3159,4296,9499,"29 days, 21:23:15",2013-02-08 00:13:27,2010-02-01 10:32:08,2010-03-03 07:55:23,8680
90,1391,1823,3304,"29 days, 21:32:11",2013-02-07 08:14:54,2010-02-01 10:32:08,2010-03-03 08:04:19,6431
628,150,516,1294,"29 days, 21:37:53",2013-01-31 07:47:47,2013-01-31 07:47:47,2013-03-02 05:25:40,6643
1252,4865,4061,10178,"29 days, 21:44:11",2013-02-08 10:37:40,2010-02-01 10:32:08,2010-03-03 08:16:19,5337
1260,1492,2377,5129,"29 days, 21:48:26",2013-02-05 05:31:49,2010-02-01 10:32:08,2010-03-03 08:20:34,4011
902,2600,5293,8795,"29 days, 21:53:43",2013-02-06 08:53:23,2010-02-01 10:32:08,2010-03-03 08:25:51,5588
1641,8789,7609,18039,"29 days, 21:54:32",2013-02-07 07:00:49,2010-02-01 10:32:08,2010-03-03 08:26:40,844
664,181,336,1181,"29 days, 21:55:19",2013-01-31 07:30:21,2013-01-31 07:30:21,2013-03-02 05:25:40,6707
466,6118,5617,12201,"29 days, 22:03:04",2013-02-07 07:23:49,2010-02-01 10:32:08,2010-03-03 08:35:12,6227
1035,1220,1841,4096,"29 days, 22:06:18",2013-02-05 06:55:22,2010-02-01 10:32:08,2010-03-03 08:38:26,8564
723,2864,3651,7238,"29 days, 22:15:43",2013-02-07 00:21:49,2010-02-01 10:32:08,2010-03-03 08:47:51,9823
43,2899,4544,7486,"29 days, 22:23:10",2013-02-07 01:19:34,2010-02-01 10:32:08,2010-03-03 08:55:18,2172
42,3768,3755,7565,"29 days, 22:28:54",2013-02-06 03:45:58,2010-02-01 10:32:08,2010-03-03 09:01:02,7745
16,277,708,1001,"29 days, 22:29:31",2013-02-04 07:09:02,2010-02-01 10:32:08,2010-03-03 09:01:39,6902
408,6336,6052,12796,"29 days, 22:33:48",2013-02-07 04:39:23,2010-02-01 10:32:08,2010-03-03 09:05:56,9032
132,2137,3411,5680,"29 days, 22:34:06",2013-02-04 06:28:04,2010-02-01 10:32:08,2010-03-03 09:06:14,8807
430,2334,4050,6814,"29 days, 22:57:52",2013-02-06 05:10:51,2010-02-01 10:32:08,2010-03-03 09:30:00,7169
121,1401,1868,3390,"29 days, 23:12:15",2013-02-06 05:59:48,2010-03-11 05:40:38,2010-04-10 04:52:53,9229
659,2679,4397,7735,"29 days, 23:21:33",2013-02-06 09:40:04,2010-03-02 08:43:06,2010-04-01 08:04:39,6722
483,989,1590,3062,"29 days, 23:23:09",2013-02-06 11:52:05,2010-02-01 10:32:08,2010-03-03 09:55:17,5053
1376,4603,7051,13030,"29 days, 23:32:27",2013-02-07 08:48:17,2010-02-01 10:32:08,2010-03-03 10:04:35,7484
114,2325,2961,5400,"29 days, 23:33:24",2013-02-06 09:25:57,2010-02-01 10:32:08,2010-03-03 10:05:32,5768
167,153,194,514,"29 days, 23:43:40",2013-02-05 03:44:35,2012-07-07 00:29:24,2012-08-06 00:13:04,8050
491,4714,5342,10547,"30 days, 0:06:29",2013-02-10 02:29:54,2010-02-01 10:32:08,2010-03-03 10:38:37,7154
175,282,487,944,"30 days, 0:12:39",2013-01-31 05:13:01,2013-01-31 05:13:01,2013-03-02 05:25:40,3219
604,446,800,1850,"30 days, 0:20:33",2013-01-31 05:05:07,2013-01-31 05:05:07,2013-03-02 05:25:40,6873
1557,4157,3927,9641,"30 days, 0:33:37",2013-02-07 05:27:28,2010-02-01 10:32:08,2010-03-03 11:05:45,417
830,1754,2157,4741,"30 days, 0:37:54",2013-02-03 08:10:33,2010-02-01 10:32:08,2010-03-03 11:10:02,2500
1187,912,1568,3667,"30 days, 0:50:33",2013-02-05 02:40:19,2010-02-01 10:32:08,2010-03-03 11:22:41,7998
83,1415,2586,4084,"30 days, 0:52:51",2013-02-06 10:29:17,2010-02-01 10:32:08,2010-03-03 11:24:59,8335
51,571,913,1535,"30 days, 0:55:19",2013-02-05 09:36:30,2010-02-01 10:32:08,2010-03-03 11:27:27,3305
1513,5772,7322,14607,"30 days, 0:58:44",2013-02-09 02:59:59,2010-02-01 10:32:08,2010-03-03 11:30:52,5557
1009,3033,3335,7377,"30 days, 1:05:21",2013-02-05 11:16:01,2010-02-01 10:32:08,2010-03-03 11:37:29,2620
17,1079,2160,3256,"30 days, 1:08:58",2013-02-06 07:03:23,2010-02-01 10:32:08,2010-03-03 11:41:06,5997
14,598,1173,1785,"30 days, 1:12:03",2013-02-04 03:11:30,2010-03-29 09:25:07,2010-04-28 10:37:10,5140
488,57,305,850,"30 days, 1:22:43",2013-02-01 00:32:22,2011-01-31 07:03:53,2011-03-02 08:26:36,4271
294,5315,5314,10923,"30 days, 1:24:50",2013-02-07 02:41:34,2010-02-01 10:32:08,2010-03-03 11:56:58,7675
19,233,792,1044,"30 days, 1:25:56",2013-02-04 04:27:26,2010-05-21 07:37:59,2010-06-20 09:03:55,3188
122,73,430,625,"30 days, 2:07:10",2013-02-05 05:12:15,2010-10-26 03:52:07,2010-11-25 05:59:17,9644
2,147,192,341,"30 days, 3:59:36",2013-01-31 01:26:04,2013-01-31 01:26:04,2013-03-02 05:25:40,5844
1004,911,1443,3358,"30 days, 4:06:19",2013-02-06 00:15:42,2010-04-01 03:51:01,2010-05-01 07:57:20,2833
338,5714,5387,11439,"30 days, 4:14:52",2013-02-06 05:56:29,2010-02-07 05:12:33,2010-03-09 09:27:25,9263
55,116,423,594,"30 days, 5:06:16",2013-02-06 06:58:38,2010-03-03 01:57:04,2010-04-02 07:03:20,5008
32,1175,2292,3499,"30 days, 5:30:59",2013-02-06 07:29:32,2010-03-01 05:13:31,2010-03-31 10:44:30,4053
59,919,1415,2393,"30 days, 5:57:51",2013-02-06 05:30:15,2010-02-10 05:21:11,2010-03-12 11:19:02,8415
504,2174,1146,3824,"30 days, 13:28:08",2013-02-02 11:51:23,2010-02-01 10:32:08,2010-03-04 00:00:16,7775
1413,2051,1775,5239,"30 days, 13:29:11",2013-02-05 11:50:15,2010-04-16 11:53:09,2010-05-17 01:22:20,6779
1238,1501,2346,5085,"30 days, 13:31:12",2013-02-07 02:18:18,2010-02-01 10:32:08,2010-03-04 00:03:20,6347
312,1420,1721,3453,"30 days, 13:34:41",2013-02-06 07:22:27,2010-02-01 10:32:08,2010-03-04 00:06:49,604
617,486,825,1928,"30 days, 13:54:46",2013-02-04 11:25:06,2010-02-01 10:32:08,2010-03-04 00:26:54,5786
109,1227,1503,2839,"30 days, 13:55:04",2013-02-03 08:58:29,2010-02-01 10:32:08,2010-03-04 00:27:12,639
149,946,1056,2151,"30 days, 13:55:15",2013-02-07 09:05:22,2010-02-01 10:32:08,2010-03-04 00:27:23,7124
1747,4106,5328,11181,"30 days, 14:14:59",2013-02-07 10:21:13,2010-02-01 10:32:08,2010-03-04 00:47:07,7563
133,2301,2070,4504,"30 days, 14:20:30",2013-02-07 10:25:14,2010-02-01 10:32:08,2010-03-04 00:52:38,7013
27,3762,4547,8336,"30 days, 14:35:09",2013-02-07 08:58:47,2010-02-01 10:32:08,2010-03-04 01:07:17,726
2686,7714,6325,16725,"30 days, 14:35:48",2013-02-07 07:29:21,2010-02-01 10:32:08,2010-03-04 01:07:56,4093
770,1589,2652,5011,"30 days, 14:36:12",2013-02-06 03:30:39,2010-02-01 10:32:08,2010-03-04 01:08:20,7786
546,448,984,1978,"30 days, 14:36:38",2013-02-07 03:01:45,2010-04-22 10:47:39,2010-05-23 01:24:17,7155
1292,208,414,1914,"30 days, 14:54:34",2013-02-03 02:02:54,2010-02-01 10:32:08,2010-03-04 01:26:42,1205
1403,2487,2930,6820,"30 days, 14:56:00",2013-02-06 07:23:20,2010-02-01 10:32:08,2010-03-04 01:28:08,1708
23,9153,5664,14840,"30 days, 15:07:42",2013-02-07 07:24:41,2010-02-01 10:32:08,2010-03-04 01:39:50,8209
675,5914,7299,13888,"30 days, 15:26:57",2013-02-07 07:45:05,2010-02-01 10:32:08,2010-03-04 01:59:05,7088
1343,3821,5646,10810,"30 days, 15:28:37",2013-02-10 11:43:39,2010-02-01 10:32:08,2010-03-04 02:00:45,2545
962,5533,7358,13853,"30 days, 15:36:47",2013-02-07 10:48:38,2010-02-01 10:32:08,2010-03-04 02:08:55,2634
472,166,803,1441,"30 days, 15:43:11",2013-02-06 05:30:58,2010-02-01 10:32:08,2010-03-04 02:15:19,4132
1635,3950,4262,9847,"30 days, 16:11:33",2013-02-07 00:57:09,2010-02-01 10:32:08,2010-03-04 02:43:41,6393
209,3736,4526,8471,"30 days, 16:11:53",2013-02-06 11:22:36,2010-02-01 10:32:08,2010-03-04 02:44:01,7855
1282,6591,8289,16162,"30 days, 16:21:07",2013-02-07 07:40:31,2010-02-01 10:32:08,2010-03-04 02:53:15,7277
943,1018,1280,3241,"30 days, 16:29:31",2013-02-06 06:29:51,2010-04-11 08:55:47,2010-05-12 01:25:18,7838
537,403,803,1743,"30 days, 16:31:42",2013-02-07 04:45:51,2010-02-01 10:32:08,2010-03-04 03:03:50,6185
899,2717,3860,7476,"30 days, 16:43:41",2013-02-06 08:51:28,2010-02-01 10:32:08,2010-03-04 03:15:49,6386
1844,7757,5989,15590,"30 days, 16:50:45",2013-02-07 05:29:13,2010-02-01 10:32:08,2010-03-04 03:22:53,8114
752,2661,3767,7180,"30 days, 16:53:00",2013-02-06 07:44:35,2010-02-01 10:32:08,2010-03-04 03:25:08,2672
322,739,1792,2853,"30 days, 16:56:59",2013-02-06 07:57:25,2010-02-01 10:32:08,2010-03-04 03:29:07,7391
1593,584,1063,3240,"30 days, 16:59:50",2013-02-03 07:42:11,2010-02-01 10:32:08,2010-03-04 03:31:58,2884
850,1115,1501,3466,"30 days, 17:04:38",2013-02-06 11:29:37,2010-02-01 10:32:08,2010-03-04 03:36:46,6130
565,950,1554,3069,"30 days, 17:05:43",2013-02-05 10:57:12,2010-02-01 10:32:08,2010-03-04 03:37:51,6912
889,1843,3526,6258,"30 days, 17:09:28",2013-02-05 03:07:18,2010-02-01 10:32:08,2010-03-04 03:41:36,8664
983,778,1793,3554,"30 days, 17:36:49",2013-02-05 10:07:49,2010-02-01 10:32:08,2010-03-04 04:08:57,6596
938,5150,6289,12377,"30 days, 17:52:35",2013-02-07 03:20:27,2010-02-01 10:32:08,2010-03-04 04:24:43,1237
143,1041,2160,3344,"30 days, 17:58:01",2013-02-05 06:19:50,2010-02-01 10:32:08,2010-03-04 04:30:09,9385
452,131,1018,1601,"30 days, 18:24:22",2013-01-30 11:01:18,2013-01-30 11:01:18,2013-03-02 05:25:40,1742
320,4800,5886,11006,"30 days, 18:31:43",2013-02-07 03:38:32,2010-02-01 10:32:08,2010-03-04 05:03:51,5500
354,116,174,644,"30 days, 18:40:43",2013-01-30 10:44:57,2013-01-30 10:44:57,2013-03-02 05:25:40,8228
893,1174,1925,3992,"30 days, 18:45:02",2013-02-07 05:01:43,2010-02-01 10:32:08,2010-03-04 05:17:10,7130
344,3980,3873,8197,"30 days, 18:48:06",2013-02-10 00:30:30,2010-02-01 10:32:08,2010-03-04 05:20:14,6915
297,5515,6910,12722,"30 days, 18:48:36",2013-02-07 02:44:53,2010-02-19 10:08:47,2010-03-22 04:57:23,405
319,204,415,938,"30 days, 18:50:09",2013-01-31 06:40:15,2010-03-13 11:36:15,2010-04-13 06:26:24,2109
942,1768,2843,5553,"30 days, 18:56:01",2013-02-06 04:53:38,2010-02-01 10:32:08,2010-03-04 05:28:09,48
939,2887,4702,8528,"30 days, 18:57:23",2013-02-06 11:20:24,2010-02-11 11:32:17,2010-03-14 06:29:40,8848
49,891,1359,2299,"30 days, 19:10:55",2013-02-06 00:29:37,2010-02-01 10:32:08,2010-03-04 05:43:03,3556
58,193,418,669,"30 days, 19:16:41",2013-02-06 11:29:21,2010-04-26 06:48:53,2010-05-27 02:05:34,2605
821,1069,2217,4107,"30 days, 19:26:18",2013-02-06 06:33:26,2010-02-01 10:32:08,2010-03-04 05:58:26,3993
1240,4282,5012,10534,"30 days, 19:26:48",2013-02-07 07:40:58,2010-02-01 10:32:08,2010-03-04 05:58:56,3792
803,348,506,1657,"30 days, 19:32:06",2013-02-05 00:01:51,2010-02-01 10:32:08,2010-03-04 06:04:14,6548
366,236,469,1071,"30 days, 19:34:41",2013-01-30 09:50:59,2013-01-30 09:50:59,2013-03-02 05:25:40,2802
1760,1499,2631,5890,"30 days, 19:36:32",2013-02-05 00:18:11,2010-02-01 10:32:08,2010-03-04 06:08:40,900
606,1906,2642,5154,"30 days, 20:00:19",2013-02-06 09:04:02,2010-02-01 10:32:08,2010-03-04 06:32:27,6270
180,1768,2579,4527,"30 days, 20:10:50",2013-02-05 10:51:42,2010-02-01 10:32:08,2010-03-04 06:42:58,253
269,874,1923,3066,"30 days, 20:13:28",2013-02-07 01:33:18,2010-02-01 10:32:08,2010-03-04 06:45:36,6553
35,298,727,1060,"30 days, 20:15:21",2013-02-06 01:37:53,2010-02-01 10:32:08,2010-03-04 06:47:29,6903
869,763,1562,3194,"30 days, 20:16:53",2013-02-06 10:30:31,2010-02-01 10:32:08,2010-03-04 06:49:01,9569
304,423,777,1504,"30 days, 20:19:20",2013-02-03 03:07:04,2010-02-01 10:32:08,2010-03-04 06:51:28,66
29,200,229,458,"30 days, 20:33:51",2013-02-02 09:23:58,2010-06-12 08:52:11,2010-07-13 05:26:02,6013
555,1755,2939,5249,"30 days, 20:57:27",2013-02-06 09:31:45,2010-02-01 10:32:08,2010-03-04 07:29:35,3454
963,859,1643,3465,"30 days, 21:01:28",2013-02-05 05:13:33,2010-02-01 10:32:08,2010-03-04 07:33:36,3433
1573,4045,5919,11537,"30 days, 21:04:06",2013-02-06 10:32:46,2010-02-01 10:32:08,2010-03-04 07:36:14,6390
104,2750,2956,5810,"30 days, 21:15:00",2013-02-06 10:52:00,2010-02-01 10:32:08,2010-03-04 07:47:08,7349
1068,6539,8836,16443,"30 days, 21:57:12",2013-02-07 11:57:08,2010-02-01 10:32:08,2010-03-04 08:29:20,8404
310,5404,5284,10998,"30 days, 22:12:08",2013-02-07 09:22:49,2010-02-01 10:32:08,2010-03-04 08:44:16,962
281,2457,2377,5115,"30 days, 22:23:00",2013-02-08 10:30:02,2010-02-01 10:32:08,2010-03-04 08:55:08,6862
1231,1184,2011,4426,"30 days, 22:40:57",2013-02-07 00:09:33,2010-02-01 10:32:08,2010-03-04 09:13:05,7633
222,3737,3391,7350,"30 days, 22:45:51",2013-02-05 11:33:03,2010-03-15 09:48:04,2010-04-15 08:33:55,500
1113,369,446,1928,"30 days, 22:46:14",2013-02-01 10:58:16,2010-02-27 02:08:02,2010-03-30 00:54:16,4276
893,456,636,1985,"30 days, 22:50:26",2013-02-05 03:19:06,2010-02-01 10:32:08,2010-03-04 09:22:34,6831
181,8303,7112,15596,"30 days, 23:09:36",2013-02-07 01:05:56,2010-02-01 10:32:08,2010-03-04 09:41:44,6561
888,245,568,1701,"30 days, 23:12:56",2013-02-06 05:21:07,2010-02-01 10:32:08,2010-03-04 09:45:04,1865
479,2379,4386,7244,"30 days, 23:14:42",2013-02-07 03:11:45,2010-02-01 10:32:08,2010-03-04 09:46:50,6861
40,57,156,253,"30 days, 23:38:22",2013-02-05 04:14:07,2012-05-13 05:00:33,2012-06-13 04:38:55,2211
199,350,457,1006,"30 days, 23:42:03",2013-02-03 04:27:20,2010-02-01 10:32:08,2010-03-04 10:14:11,453
2237,6794,5698,14729,"30 days, 23:48:34",2013-02-07 03:08:27,2010-02-01 10:32:08,2010-03-04 10:20:42,2327
192,727,1134,2053,"30 days, 23:49:42",2013-02-07 06:09:59,2010-02-11 09:27:08,2010-03-14 09:16:50,9627
119,4135,5315,9569,"31 days, 0:07:30",2013-02-07 08:42:48,2010-02-01 10:32:08,2010-03-04 10:39:38,3466
1447,3,75,1525,"31 days, 0:10:42",2013-02-03 11:52:22,2010-02-01 10:32:08,2010-03-04 10:42:50,6748
302,987,1529,2818,"31 days, 0:18:11",2013-02-06 10:02:09,2010-02-01 10:32:08,2010-03-04 10:50:19,3095
833,5032,5878,11743,"31 days, 0:18:51",2013-02-07 00:44:22,2010-02-01 10:32:08,2010-03-04 10:50:59,9951
885,6781,7321,14987,"31 days, 0:21:59",2013-02-07 07:02:11,2010-02-01 10:32:08,2010-03-04 10:54:07,9797
1154,223,231,1608,"31 days, 0:22:00",2013-02-01 03:48:07,2010-02-01 10:32:08,2010-03-04 10:54:08,5646
285,171,308,764,"31 days, 0:22:08",2013-02-02 08:32:39,2010-08-27 02:35:59,2010-09-27 02:58:07,7021
830,2017,3019,5866,"31 days, 0:33:04",2013-02-07 00:37:41,2010-02-01 10:32:08,2010-03-04 11:05:12,1912
952,1918,2935,5805,"31 days, 0:42:08",2013-02-06 11:19:21,2010-02-01 10:32:08,2010-03-04 11:14:16,2293
1089,6200,6487,13776,"31 days, 0:47:01",2013-02-05 10:47:13,2010-02-01 10:32:08,2010-03-04 11:19:09,1595
2013,6075,5997,14085,"31 days, 0:51:37",2013-02-11 06:45:55,2010-02-01 10:32:08,2010-03-04 11:23:45,2409
1034,1783,2955,5772,"31 days, 0:53:40",2013-02-06 06:21:27,2010-02-01 10:32:08,2010-03-04 11:25:48,2987
191,436,1166,1793,"31 days, 0:57:23",2013-02-06 10:39:55,2010-04-10 00:15:47,2010-05-11 01:13:10,7488
946,2210,2250,5406,"31 days, 1:02:27",2013-02-04 11:50:59,2010-02-01 10:32:08,2010-03-04 11:34:35,3199
488,6566,7300,14354,"31 days, 1:06:50",2013-02-07 10:43:16,2010-02-01 10:32:08,2010-03-04 11:38:58,5306
1290,332,370,1992,"31 days, 1:24:11",2013-02-07 04:37:35,2010-02-01 10:32:08,2010-03-04 11:56:19,7609
1058,2,103,1163,"31 days, 1:25:30",2013-01-30 04:00:10,2013-01-30 04:00:10,2013-03-02 05:25:40,1549
798,897,1614,3309,"31 days, 1:26:53",2013-02-04 08:04:45,2010-03-09 00:13:59,2010-04-09 01:40:52,4510
788,2128,2235,5151,"31 days, 1:27:32",2013-02-06 06:09:36,2010-02-01 10:32:08,2010-03-04 11:59:40,3996
1144,237,375,1756,"31 days, 2:04:19",2013-01-30 03:21:21,2013-01-30 03:21:21,2013-03-02 05:25:40,1465
122,139,292,553,"31 days, 2:09:20",2013-01-30 03:16:20,2013-01-30 03:16:20,2013-03-02 05:25:40,9377
136,755,951,1842,"31 days, 2:21:25",2013-02-07 07:36:13,2010-06-14 04:43:57,2010-07-15 07:05:22,1977
8,21,197,226,"31 days, 2:26:04",2013-01-30 02:59:36,2013-01-30 02:59:36,2013-03-02 05:25:40,7316
1306,1,42,1349,"31 days, 4:28:11",2013-01-30 00:57:29,2013-01-30 00:57:29,2013-03-02 05:25:40,3627
1350,3257,2974,7581,"31 days, 8:59:37",2013-02-06 03:48:43,2010-02-07 01:22:07,2010-03-10 10:21:44,1629
86,1272,1688,3046,"31 days, 10:51:37",2013-02-06 06:49:52,2010-03-02 00:09:12,2010-04-02 11:00:49,4316
794,3779,4632,9205,"31 days, 13:29:44",2013-02-06 07:04:36,2010-02-01 10:32:08,2010-03-05 00:01:52,5625
641,2093,2452,5186,"31 days, 13:45:13",2013-02-06 05:18:40,2010-02-01 10:32:08,2010-03-05 00:17:21,192
555,853,1332,2740,"31 days, 13:55:13",2013-02-04 08:59:59,2010-02-01 10:32:08,2010-03-05 00:27:21,6453
1378,356,573,2307,"31 days, 13:57:25",2013-02-07 07:49:44,2010-02-01 10:32:08,2010-03-05 00:29:33,6255
662,2984,3591,7237,"31 days, 14:03:00",2013-02-06 11:18:18,2010-02-01 10:32:08,2010-03-05 00:35:08,3027
127,1204,1302,2633,"31 days, 14:04:36",2013-02-03 05:43:07,2010-02-01 10:32:08,2010-03-05 00:36:44,2368
1238,1852,2748,5838,"31 days, 14:07:22",2013-02-10 09:27:07,2010-02-01 10:32:08,2010-03-05 00:39:30,8578
7,715,1758,2480,"31 days, 14:25:33",2013-02-05 10:48:32,2010-02-01 10:32:08,2010-03-05 00:57:41,6174
663,1294,1951,3908,"31 days, 14:26:57",2013-02-06 05:10:07,2010-02-01 10:32:08,2010-03-05 00:59:05,8052
756,1372,2601,4729,"31 days, 14:40:57",2013-02-05 06:46:39,2010-02-01 10:32:08,2010-03-05 01:13:05,3706
976,3981,3829,8786,"31 days, 14:43:09",2013-02-07 05:38:56,2010-02-01 10:32:08,2010-03-05 01:15:17,3941
490,418,615,1523,"31 days, 14:46:11",2013-02-02 07:08:44,2010-02-01 10:32:08,2010-03-05 01:18:19,3206
139,1572,2203,3914,"31 days, 14:58:51",2013-02-06 10:55:23,2010-02-01 10:32:08,2010-03-05 01:30:59,9339
1595,6784,6321,14700,"31 days, 15:02:53",2013-02-07 01:33:02,2010-02-01 10:32:08,2010-03-05 01:35:01,3900
493,879,1737,3109,"31 days, 15:03:31",2013-02-05 08:11:35,2010-02-01 10:32:08,2010-03-05 01:35:39,1992
443,1682,2644,4769,"31 days, 15:06:01",2013-02-07 04:09:50,2010-02-01 10:32:08,2010-03-05 01:38:09,6282
704,3683,5290,9677,"31 days, 15:16:55",2013-02-06 10:50:42,2010-02-01 10:32:08,2010-03-05 01:49:03,5028
33,415,589,1037,"31 days, 15:26:16",2013-02-03 06:40:52,2010-02-01 10:32:08,2010-03-05 01:58:24,2536
149,584,1089,1822,"31 days, 15:29:31",2013-02-06 05:29:45,2010-02-01 10:32:08,2010-03-05 02:01:39,2413
858,6065,5515,12438,"31 days, 15:37:02",2013-02-07 06:01:12,2010-02-01 10:32:08,2010-03-05 02:09:10,8332
1406,6228,4981,12615,"31 days, 15:44:56",2013-02-12 11:52:50,2010-02-01 10:32:08,2010-03-05 02:17:04,2417
176,741,1289,2206,"31 days, 15:46:48",2013-02-05 06:32:19,2010-02-01 10:32:08,2010-03-05 02:18:56,3033
1047,2038,3172,6257,"31 days, 15:46:50",2013-02-07 07:26:08,2010-02-01 10:32:08,2010-03-05 02:18:58,5429
491,5427,5862,11780,"31 days, 16:00:10",2013-02-07 00:12:51,2010-02-01 10:32:08,2010-03-05 02:32:18,3955
36,1981,2450,4467,"31 days, 16:01:19",2013-02-06 09:30:27,2010-02-01 10:32:08,2010-03-05 02:33:27,6198
429,1197,1802,3428,"31 days, 16:21:37",2013-02-04 02:28:14,2010-02-01 10:32:08,2010-03-05 02:53:45,3097
1549,2670,4109,8328,"31 days, 16:24:19",2013-02-06 06:56:32,2010-02-01 10:32:08,2010-03-05 02:56:27,6789
385,9244,8049,17678,"31 days, 16:29:41",2013-02-06 08:59:46,2010-02-01 10:32:08,2010-03-05 03:01:49,4750
108,522,873,1503,"31 days, 16:38:12",2013-02-04 06:46:41,2010-02-17 09:51:08,2010-03-21 02:29:20,8794
2016,2835,7638,12489,"31 days, 16:48:07",2013-02-06 01:13:29,2010-02-01 10:32:08,2010-03-05 03:20:15,4283
647,1179,1610,3436,"31 days, 16:54:46",2013-02-06 09:37:17,2010-02-01 10:32:08,2010-03-05 03:26:54,7369
475,882,1182,2539,"31 days, 16:54:50",2013-02-05 06:52:29,2010-02-19 11:09:54,2010-03-23 04:04:44,7101
1166,28,179,1373,"31 days, 16:59:54",2013-02-07 11:12:53,2010-11-07 10:36:42,2010-12-09 03:36:36,6941
262,2656,3492,6410,"31 days, 17:16:50",2013-02-06 01:13:25,2010-02-01 10:32:08,2010-03-05 03:48:58,8908
308,2370,3249,5927,"31 days, 17:35:37",2013-02-07 01:18:47,2010-02-01 10:32:08,2010-03-05 04:07:45,7589
642,7115,7322,15079,"31 days, 17:38:27",2013-02-07 10:12:08,2010-02-01 10:32:08,2010-03-05 04:10:35,9223
196,1846,2530,4572,"31 days, 17:44:37",2013-02-05 10:51:21,2010-02-01 10:32:08,2010-03-05 04:16:45,3003
2529,4924,5200,12653,"31 days, 17:51:11",2013-02-07 10:22:10,2010-02-01 10:32:08,2010-03-05 04:23:19,9316
23,175,443,641,"31 days, 17:53:22",2013-01-31 10:29:56,2010-02-01 10:32:08,2010-03-05 04:25:30,4420
454,2485,2407,5346,"31 days, 17:58:56",2013-02-07 08:33:08,2010-02-01 10:32:08,2010-03-05 04:31:04,9695
1756,3613,4503,9872,"31 days, 18:02:37",2013-02-06 10:00:42,2010-02-01 10:32:08,2010-03-05 04:34:45,8406
1111,2128,3006,6245,"31 days, 18:05:48",2013-02-06 09:36:01,2010-02-01 10:32:08,2010-03-05 04:37:56,9101
102,1073,2606,3781,"31 days, 18:05:59",2013-02-07 04:57:02,2010-02-01 10:32:08,2010-03-05 04:38:07,5670
294,7316,7972,15582,"31 days, 18:18:41",2013-02-10 08:28:32,2010-02-01 10:32:08,2010-03-05 04:50:49,7951
514,3208,1831,5553,"31 days, 18:24:38",2013-02-10 05:56:28,2010-02-01 10:32:08,2010-03-05 04:56:46,2592
702,3622,3315,7639,"31 days, 18:25:14",2013-02-11 05:57:28,2010-02-01 10:32:08,2010-03-05 04:57:22,9828
876,1726,1958,4560,"31 days, 18:34:05",2013-02-05 08:39:56,2010-02-01 10:32:08,2010-03-05 05:06:13,281
424,1444,1814,3682,"31 days, 18:34:09",2013-02-06 07:39:20,2010-02-01 10:32:08,2010-03-05 05:06:17,8806
911,9,55,975,"31 days, 18:41:19",2013-01-31 05:43:45,2010-02-01 10:32:08,2010-03-05 05:13:27,299
99,2155,2778,5032,"31 days, 18:49:56",2013-02-05 04:16:35,2010-02-01 10:32:08,2010-03-05 05:22:04,6769
16,1648,3605,5269,"31 days, 19:04:34",2013-02-06 11:16:02,2010-02-01 10:32:08,2010-03-05 05:36:42,3859
276,274,1288,1838,"31 days, 19:08:48",2013-02-05 05:04:49,2010-02-20 05:55:42,2010-03-24 01:04:30,8732
724,2467,4634,7825,"31 days, 19:09:57",2013-02-06 00:29:36,2010-02-01 10:32:08,2010-03-05 05:42:05,3367
205,1673,3703,5581,"31 days, 19:20:57",2013-02-06 11:47:12,2010-02-01 10:32:08,2010-03-05 05:53:05,3492
140,2173,3749,6062,"31 days, 19:25:33",2013-02-07 10:32:47,2010-02-01 10:32:08,2010-03-05 05:57:41,3125
1339,3909,4094,9342,"31 days, 19:34:15",2013-02-07 05:23:12,2010-02-01 10:32:08,2010-03-05 06:06:23,7173
1339,6903,6907,15149,"31 days, 19:41:10",2013-02-06 11:16:21,2010-02-01 10:32:08,2010-03-05 06:13:18,6790
508,223,573,1304,"31 days, 19:49:25",2013-02-05 10:33:04,2010-02-01 10:32:08,2010-03-05 06:21:33,3153
278,8533,6353,15164,"31 days, 19:53:46",2013-02-06 11:14:38,2010-02-01 10:32:08,2010-03-05 06:25:54,7532
1977,6461,9018,17456,"31 days, 20:04:43",2013-02-07 02:24:54,2010-02-01 10:32:08,2010-03-05 06:36:51,7710
1146,2020,2285,5451,"31 days, 20:05:31",2013-02-07 07:13:48,2010-02-01 10:32:08,2010-03-05 06:37:39,6744
1160,1818,3057,6035,"31 days, 20:08:24",2013-02-07 01:03:10,2010-02-01 10:32:08,2010-03-05 06:40:32,3481
1163,136,414,1713,"31 days, 20:09:33",2013-01-29 09:16:07,2013-01-29 09:16:07,2013-03-02 05:25:40,2819
16,419,611,1046,"31 days, 20:25:32",2013-02-06 08:16:32,2010-02-01 10:32:08,2010-03-05 06:57:40,9937
240,3768,4509,8517,"31 days, 20:27:48",2013-02-07 00:49:05,2010-02-01 10:32:08,2010-03-05 06:59:56,6334
1126,836,1542,3504,"31 days, 20:43:29",2013-02-07 02:26:11,2010-02-01 10:32:08,2010-03-05 07:15:37,197
748,6602,5966,13316,"31 days, 20:54:12",2013-02-07 09:42:03,2010-02-01 10:32:08,2010-03-05 07:26:20,2628
524,227,680,1431,"31 days, 21:08:14",2013-02-06 06:39:09,2010-02-01 10:32:08,2010-03-05 07:40:22,3004
1448,3373,3425,8246,"31 days, 21:11:35",2013-02-07 06:22:55,2010-02-01 10:32:08,2010-03-05 07:43:43,2261
589,152,374,1115,"31 days, 21:13:31",2013-02-03 06:20:03,2010-02-01 10:32:08,2010-03-05 07:45:39,3186
1452,683,1050,3185,"31 days, 21:22:35",2013-02-11 06:20:32,2010-02-01 10:32:08,2010-03-05 07:54:43,1170
329,61,183,573,"31 days, 21:40:42",2013-01-29 08:58:53,2010-02-01 10:32:08,2010-03-05 08:12:50,2063
82,368,517,967,"31 days, 21:46:31",2013-02-02 08:54:18,2010-02-01 10:32:08,2010-03-05 08:18:39,2262
467,68,339,874,"31 days, 22:06:37",2013-02-01 11:34:48,2010-11-04 04:10:37,2010-12-06 02:17:14,7218
839,611,822,2272,"31 days, 22:11:17",2013-02-03 09:43:56,2010-05-17 05:05:09,2010-06-18 03:16:26,748
1266,3113,4122,8501,"31 days, 22:29:12",2013-02-06 02:18:15,2010-02-01 10:32:08,2010-03-05 09:01:20,9965
255,782,1334,2371,"31 days, 22:31:58",2013-02-07 00:39:05,2010-02-01 10:32:08,2010-03-05 09:04:06,6365
124,758,1010,1892,"31 days, 22:37:08",2013-02-04 07:45:10,2010-02-01 10:32:08,2010-03-05 09:09:16,1928
1098,58,144,1300,"31 days, 22:38:29",2013-02-03 02:16:14,2010-06-12 01:38:45,2010-07-14 00:17:14,2345
277,1711,2060,4048,"31 days, 22:49:11",2013-02-07 00:11:20,2010-02-01 10:32:08,2010-03-05 09:21:19,6030
1327,19,17,1363,"31 days, 22:50:03",2013-02-01 11:51:00,2010-02-01 10:32:08,2010-03-05 09:22:11,9771
971,4494,6427,11892,"31 days, 22:56:15",2013-02-07 11:42:55,2010-02-01 10:32:08,2010-03-05 09:28:23,9724
55,407,512,974,"31 days, 22:56:26",2013-01-29 06:29:14,2013-01-29 06:29:14,2013-03-02 05:25:40,9743
1169,4035,3967,9171,"31 days, 23:01:10",2013-02-06 11:46:58,2010-02-01 10:32:08,2010-03-05 09:33:18,7122
709,12,106,827,"31 days, 23:15:16",2013-02-04 04:07:29,2010-04-27 06:08:54,2010-05-29 05:24:10,8076
1083,2355,3733,7171,"31 days, 23:18:42",2013-02-06 02:26:08,2010-02-01 10:32:08,2010-03-05 09:50:50,4546
516,3312,3314,7142,"31 days, 23:25:14",2013-02-07 05:40:18,2010-02-01 10:32:08,2010-03-05 09:57:22,6031
1478,1215,1952,4645,"31 days, 23:45:23",2013-02-05 05:31:00,2010-02-01 10:32:08,2010-03-05 10:17:31,7810
249,2995,3313,6557,"31 days, 23:49:24",2013-02-09 08:29:20,2010-02-01 10:32:08,2010-03-05 10:21:32,2436
51,3421,6354,9826,"31 days, 23:55:09",2013-02-07 04:06:27,2010-02-01 10:32:08,2010-03-05 10:27:17,6269
77,777,930,1784,"32 days, 0:04:28",2013-02-07 08:13:28,2010-02-01 10:32:08,2010-03-05 10:36:36,1448
1441,685,949,3075,"32 days, 0:05:59",2013-02-05 08:21:28,2010-02-01 10:32:08,2010-03-05 10:38:07,2624
2324,2961,3995,9280,"32 days, 0:08:21",2013-02-06 00:16:01,2010-02-01 10:32:08,2010-03-05 10:40:29,7581
1108,1574,3270,5952,"32 days, 0:22:04",2013-02-15 10:29:56,2010-02-01 10:32:08,2010-03-05 10:54:12,2800
721,175,678,1574,"32 days, 0:28:32",2013-02-05 07:37:04,2010-02-01 10:32:08,2010-03-05 11:00:40,9773
1060,2,43,1105,"32 days, 0:47:52",2013-02-04 09:18:51,2010-06-16 06:30:47,2010-07-18 07:18:39,9674
423,9246,7237,16906,"32 days, 0:47:55",2013-02-07 09:01:28,2010-02-01 10:32:08,2010-03-05 11:20:03,1807
122,991,1708,2821,"32 days, 1:11:47",2013-02-06 00:29:31,2010-02-01 10:32:08,2010-03-05 11:43:55,6528
1476,1061,1923,4460,"32 days, 1:15:47",2013-02-06 04:13:06,2010-02-01 10:32:08,2010-03-05 11:47:55,9723
1407,110,559,2076,"32 days, 1:20:09",2013-02-04 01:19:37,2010-02-01 10:32:08,2010-03-05 11:52:17,7692
782,2596,2325,5703,"32 days, 1:22:27",2013-02-06 04:24:16,2010-02-01 10:32:08,2010-03-05 11:54:35,2948
898,661,1231,2790,"32 days, 1:25:08",2013-02-02 09:57:56,2010-02-01 10:32:08,2010-03-05 11:57:16,7535
189,139,216,544,"32 days, 1:28:56",2013-01-29 03:56:44,2013-01-29 03:56:44,2013-03-02 05:25:40,5080
642,579,814,2035,"32 days, 2:08:43",2013-02-07 11:50:13,2010-03-21 00:50:31,2010-04-22 02:59:14,2865
475,13,98,586,"32 days, 2:11:16",2013-01-29 03:14:24,2013-01-29 03:14:24,2013-03-02 05:25:40,1639
47,754,1184,1985,"32 days, 2:28:27",2013-02-07 00:37:44,2010-05-19 07:59:59,2010-06-20 10:28:26,740
207,149,324,680,"32 days, 2:39:23",2013-01-29 02:46:17,2013-01-29 02:46:17,2013-03-02 05:25:40,171
1734,2878,3608,8220,"32 days, 4:13:12",2013-02-07 01:31:10,2010-02-26 00:36:52,2010-03-30 04:50:04,6704
417,3363,3329,7109,"32 days, 4:34:49",2013-02-06 02:18:45,2010-02-17 00:40:58,2010-03-21 05:15:47,3427
209,344,497,1050,"32 days, 5:13:40",2013-01-29 00:12:00,2013-01-29 00:12:00,2013-03-02 05:25:40,7509
272,3511,3897,7680,"32 days, 5:42:36",2013-02-06 07:00:24,2010-03-09 00:07:23,2010-04-10 05:49:59,9224
738,2597,3131,6466,"32 days, 5:56:29",2013-02-05 09:42:32,2010-03-04 00:38:43,2010-04-05 06:35:12,8447
5,17,121,143,"32 days, 7:06:20",2013-02-03 10:48:33,2011-08-19 01:22:51,2011-09-20 08:29:11,3613
1350,4050,4320,9720,"32 days, 8:15:11",2013-02-06 11:07:36,2010-02-21 01:42:25,2010-03-25 09:57:36,3809
1023,9140,7600,17763,"32 days, 8:32:01",2013-02-07 10:52:21,2010-02-26 03:23:25,2010-03-30 11:55:26,3532
138,1514,1916,3568,"32 days, 9:24:18",2013-02-06 09:02:28,2010-04-06 02:00:46,2010-05-08 11:25:04,5691
510,4659,6191,11360,"32 days, 13:34:31",2013-02-10 05:20:15,2010-02-01 10:32:08,2010-03-06 00:06:39,9382
355,6698,7015,14068,"32 days, 13:47:06",2013-02-07 07:40:12,2010-02-01 10:32:08,2010-03-06 00:19:14,4216
1150,4344,4871,10365,"32 days, 13:48:05",2013-02-06 11:53:28,2010-02-01 10:32:08,2010-03-06 00:20:13,1725
194,3303,3808,7305,"32 days, 13:52:18",2013-02-06 04:21:02,2010-02-01 10:32:08,2010-03-06 00:24:26,7880
1433,1598,2643,5674,"32 days, 13:53:12",2013-02-06 10:50:07,2010-02-01 10:32:08,2010-03-06 00:25:20,8673
337,4992,4696,10025,"32 days, 13:55:15",2013-02-07 04:51:20,2010-02-01 10:32:08,2010-03-06 00:27:23,1456
735,3621,5029,9385,"32 days, 14:04:39",2013-02-07 04:21:13,2010-02-01 10:32:08,2010-03-06 00:36:47,5767
2378,4789,5533,12700,"32 days, 14:04:58",2013-02-05 09:49:58,2010-02-01 10:32:08,2010-03-06 00:37:06,5011
543,1907,1785,4235,"32 days, 14:15:05",2013-02-04 09:36:05,2010-02-01 10:32:08,2010-03-06 00:47:13,7794
1211,8716,6373,16300,"32 days, 14:18:09",2013-02-06 04:39:58,2010-02-01 10:32:08,2010-03-06 00:50:17,3373
146,7910,6528,14584,"32 days, 14:23:20",2013-02-07 11:11:59,2010-02-01 10:32:08,2010-03-06 00:55:28,9954
1209,956,1321,3486,"32 days, 14:41:07",2013-02-07 03:11:50,2010-02-01 10:32:08,2010-03-06 01:13:15,5299
1387,984,1022,3393,"32 days, 14:47:30",2013-02-07 01:03:19,2010-02-01 10:32:08,2010-03-06 01:19:38,7117
250,5966,6409,12625,"32 days, 14:52:39",2013-02-06 08:34:56,2010-02-01 10:32:08,2010-03-06 01:24:47,6829
1180,267,862,2309,"32 days, 15:08:22",2013-02-01 10:01:20,2010-02-01 10:32:08,2010-03-06 01:40:30,6057
229,424,791,1444,"32 days, 15:14:55",2013-02-06 04:18:51,2010-02-01 10:32:08,2010-03-06 01:47:03,8284
1214,2858,3179,7251,"32 days, 15:16:04",2013-02-06 08:22:00,2010-02-01 10:32:08,2010-03-06 01:48:12,6297
1683,6606,9267,17556,"32 days, 15:21:42",2013-02-08 07:19:33,2010-02-01 10:32:08,2010-03-06 01:53:50,3499
267,701,1034,2002,"32 days, 15:22:46",2013-02-04 10:20:36,2010-02-01 10:32:08,2010-03-06 01:54:54,4784
155,1349,1779,3283,"32 days, 15:25:51",2013-02-04 09:30:37,2010-02-01 10:32:08,2010-03-06 01:57:59,867
369,1719,3441,5529,"32 days, 15:50:55",2013-02-06 11:39:47,2010-02-01 10:32:08,2010-03-06 02:23:03,6042
110,567,1128,1805,"32 days, 15:51:45",2013-02-03 09:18:11,2010-02-01 10:32:08,2010-03-06 02:23:53,9235
380,122,204,706,"32 days, 16:10:48",2013-02-03 00:44:11,2010-02-01 10:32:08,2010-03-06 02:42:56,3296
1564,4649,4522,10735,"32 days, 16:15:37",2013-02-08 01:00:04,2010-02-01 10:32:08,2010-03-06 02:47:45,2506
254,2468,3435,6157,"32 days, 16:22:02",2013-02-07 06:11:15,2010-02-01 10:32:08,2010-03-06 02:54:10,6217
690,1180,1808,3678,"32 days, 16:22:13",2013-02-06 01:46:28,2010-02-01 10:32:08,2010-03-06 02:54:21,6934
38,929,1666,2633,"32 days, 16:27:43",2013-02-06 07:15:48,2010-02-01 10:32:08,2010-03-06 02:59:51,6745
503,5100,4717,10320,"32 days, 16:33:37",2013-02-07 07:27:21,2010-02-01 10:32:08,2010-03-06 03:05:45,8166
66,582,1514,2162,"32 days, 16:45:07",2013-02-06 09:34:27,2010-02-01 10:32:08,2010-03-06 03:17:15,1175
1415,5068,5058,11541,"32 days, 16:45:22",2013-02-06 11:52:21,2010-02-01 10:32:08,2010-03-06 03:17:30,2283
378,3673,4128,8179,"32 days, 16:47:55",2013-02-07 06:30:39,2010-02-01 10:32:08,2010-03-06 03:20:03,7491
1287,6261,5274,12822,"32 days, 16:54:11",2013-02-07 02:52:11,2010-02-01 10:32:08,2010-03-06 03:26:19,5308
993,124,327,1444,"32 days, 16:54:56",2013-02-02 06:56:51,2010-07-16 09:19:06,2010-08-18 02:14:02,5248
344,1843,3863,6050,"32 days, 17:03:47",2013-02-05 10:03:45,2010-02-01 10:32:08,2010-03-06 03:35:55,3361
264,6268,6226,12758,"32 days, 17:14:58",2013-02-07 10:36:22,2010-02-01 10:32:08,2010-03-06 03:47:06,1130
1046,693,946,2685,"32 days, 17:28:13",2013-02-04 00:59:50,2010-02-01 10:32:08,2010-03-06 04:00:21,9396
24,3668,5340,9032,"32 days, 17:36:48",2013-02-06 02:33:46,2010-02-01 10:32:08,2010-03-06 04:08:56,5066
1154,1835,1900,4889,"32 days, 17:53:44",2013-02-06 04:57:07,2010-02-01 10:32:08,2010-03-06 04:25:52,333
1476,5073,6600,13149,"32 days, 17:59:41",2013-02-06 10:20:50,2010-02-01 10:32:08,2010-03-06 04:31:49,4061
688,8855,9949,19492,"32 days, 18:16:24",2013-02-07 02:41:49,2010-02-01 10:32:08,2010-03-06 04:48:32,2023
1678,5887,5704,13269,"32 days, 18:19:50",2013-02-07 09:57:20,2010-02-01 10:32:08,2010-03-06 04:51:58,9555
1356,7167,6900,15423,"32 days, 18:22:38",2013-02-07 07:43:03,2010-02-01 10:32:08,2010-03-06 04:54:46,7221
426,7144,5113,12683,"32 days, 18:27:51",2013-02-07 10:16:46,2010-02-01 10:32:08,2010-03-06 04:59:59,6670
1252,1381,2125,4758,"32 days, 18:44:05",2013-02-06 00:14:49,2010-02-01 10:32:08,2010-03-06 05:16:13,4993
338,2370,3394,6102,"32 days, 18:49:48",2013-02-14 11:55:22,2010-02-01 10:32:08,2010-03-06 05:21:56,9388
780,322,724,1826,"32 days, 18:54:53",2013-02-04 11:55:54,2010-02-01 10:32:08,2010-03-06 05:27:01,4166
1375,2790,3367,7532,"32 days, 18:55:02",2013-02-06 11:26:18,2010-02-01 10:32:08,2010-03-06 05:27:10,3193
516,4796,5579,10891,"32 days, 18:59:31",2013-02-15 00:52:14,2010-02-01 10:32:08,2010-03-06 05:31:39,2551
66,443,696,1205,"32 days, 19:01:02",2013-02-02 10:41:38,2010-02-01 10:32:08,2010-03-06 05:33:10,2289
1444,6908,9306,17658,"32 days, 19:03:38",2013-02-07 04:34:57,2010-02-01 10:32:08,2010-03-06 05:35:46,9453
708,1327,2080,4115,"32 days, 19:14:59",2013-02-06 04:26:26,2010-02-01 10:32:08,2010-03-06 05:47:07,9117
45,1093,1123,2261,"32 days, 19:14:59",2013-02-05 04:43:14,2010-02-01 10:32:08,2010-03-06 05:47:07,1470
236,1210,2076,3522,"32 days, 19:23:01",2013-02-07 10:08:24,2010-02-01 10:32:08,2010-03-06 05:55:09,732
900,1249,2073,4222,"32 days, 19:47:08",2013-02-06 05:20:54,2010-02-01 10:32:08,2010-03-06 06:19:16,5453
798,1707,2214,4719,"32 days, 20:10:54",2013-02-05 00:29:48,2010-02-01 10:32:08,2010-03-06 06:43:02,3001
412,397,514,1323,"32 days, 20:21:14",2013-02-06 09:53:07,2010-02-01 10:32:08,2010-03-06 06:53:22,9485
946,4287,6701,11934,"32 days, 20:31:29",2013-02-09 08:21:41,2010-02-01 10:32:08,2010-03-06 07:03:37,9037
872,4094,4456,9422,"32 days, 20:34:26",2013-02-06 09:38:40,2010-02-01 10:32:08,2010-03-06 07:06:34,448
336,7074,8888,16298,"32 days, 20:38:15",2013-02-07 07:14:12,2010-02-01 10:32:08,2010-03-06 07:10:23,1485
722,7161,6202,14085,"32 days, 20:39:11",2013-02-06 06:37:25,2010-02-01 10:32:08,2010-03-06 07:11:19,9200
494,6748,8116,15358,"32 days, 20:40:20",2013-02-06 11:50:40,2010-02-01 10:32:08,2010-03-06 07:12:28,8032
968,1497,2866,5331,"32 days, 20:41:51",2013-02-04 03:30:44,2010-02-01 10:32:08,2010-03-06 07:13:59,7459
324,151,375,850,"32 days, 21:26:18",2013-01-28 07:59:22,2013-01-28 07:59:22,2013-03-02 05:25:40,3222
66,1368,2200,3634,"32 days, 21:30:19",2013-02-05 11:21:09,2010-02-01 10:32:08,2010-03-06 08:02:27,9772
665,8,168,841,"32 days, 21:31:45",2013-02-01 04:26:32,2010-02-28 03:12:20,2010-04-02 00:44:05,3515
866,2425,3219,6510,"32 days, 21:42:32",2013-02-07 04:59:18,2010-02-13 04:53:02,2010-03-18 02:35:34,8042
535,1784,3274,5593,"32 days, 21:46:28",2013-02-04 10:38:04,2010-02-01 10:32:08,2010-03-06 08:18:36,1821
2064,6766,5640,14470,"32 days, 21:48:56",2013-02-07 06:29:28,2010-02-01 10:32:08,2010-03-06 08:21:04,6551
2106,5732,5723,13561,"32 days, 21:59:15",2013-02-06 06:17:30,2010-02-01 10:32:08,2010-03-06 08:31:23,3425
1480,8,78,1566,"32 days, 22:00:13",2013-01-28 07:25:27,2013-01-28 07:25:27,2013-03-02 05:25:40,5143
1143,1373,1901,4417,"32 days, 22:13:04",2013-02-07 08:01:11,2010-02-01 10:32:08,2010-03-06 08:45:12,2772
44,3573,3371,6988,"32 days, 22:13:14",2013-02-07 05:13:45,2010-02-01 10:32:08,2010-03-06 08:45:22,7546
355,308,1238,1901,"32 days, 22:22:07",2013-02-06 03:49:50,2010-02-01 10:32:08,2010-03-06 08:54:15,1184
279,1061,758,2098,"32 days, 22:22:13",2013-02-05 06:34:39,2010-02-01 10:32:08,2010-03-06 08:54:21,6179
844,7190,7936,15970,"32 days, 22:45:56",2013-02-11 02:05:31,2010-02-01 10:32:08,2010-03-06 09:18:04,5115
1134,3136,2742,7012,"32 days, 22:46:00",2013-02-15 09:30:24,2010-02-01 10:32:08,2010-03-06 09:18:08,8497
1688,5524,5510,12722,"32 days, 22:59:19",2013-02-08 05:35:04,2010-02-01 10:32:08,2010-03-06 09:31:27,3379
932,1630,3109,5671,"32 days, 23:10:58",2013-02-06 09:06:32,2010-02-01 10:32:08,2010-03-06 09:43:06,3923
181,195,751,1127,"32 days, 23:28:03",2013-02-02 01:51:00,2010-02-01 10:32:08,2010-03-06 10:00:11,6377
506,1799,1851,4156,"32 days, 23:29:44",2013-02-09 05:57:41,2010-02-14 05:35:45,2010-03-19 05:05:29,8726
643,644,1511,2798,"32 days, 23:39:03",2013-02-13 03:39:47,2010-02-19 06:29:53,2010-03-24 06:08:56,6847
148,81,199,428,"32 days, 23:44:44",2013-02-02 07:49:54,2010-03-02 02:46:45,2010-04-04 02:31:29,2806
1139,686,1515,3340,"32 days, 23:53:03",2013-02-03 06:19:35,2010-02-13 01:24:49,2010-03-18 01:17:52,9884
1644,5414,6895,13953,"32 days, 23:53:08",2013-02-07 06:48:10,2010-02-01 10:32:08,2010-03-06 10:25:16,2367
882,2029,1979,4890,"33 days, 0:06:01",2013-02-06 05:22:31,2010-02-01 10:32:08,2010-03-06 10:38:09,8174
236,401,261,898,"33 days, 0:07:19",2013-02-03 07:22:00,2010-02-01 10:32:08,2010-03-06 10:39:27,5898
365,2261,3518,6144,"33 days, 0:13:39",2013-02-07 04:28:59,2010-02-01 10:32:08,2010-03-06 10:45:47,5067
553,1682,1532,3767,"33 days, 0:22:15",2013-02-04 08:16:44,2010-02-01 10:32:08,2010-03-06 10:54:23,9171
353,2073,3375,5801,"33 days, 0:29:50",2013-02-06 08:22:25,2010-03-30 02:11:34,2010-05-02 02:41:24,8542
1369,0,47,1416,"33 days, 0:30:35",2013-02-02 06:27:42,2010-02-01 10:32:08,2010-03-06 11:02:43,1068
368,6043,6405,12816,"33 days, 0:47:02",2013-02-06 07:52:25,2010-02-01 10:32:08,2010-03-06 11:19:10,2359
889,3522,4484,8895,"33 days, 0:59:14",2013-02-07 05:04:54,2010-02-01 10:32:08,2010-03-06 11:31:22,8139
362,6108,6062,12532,"33 days, 1:07:24",2013-02-09 02:38:34,2010-02-01 10:32:08,2010-03-06 11:39:32,8379
156,6263,5541,11960,"33 days, 1:10:36",2013-02-06 10:37:42,2010-02-01 10:32:08,2010-03-06 11:42:44,6948
907,869,1725,3501,"33 days, 1:19:54",2013-02-03 09:54:36,2010-02-01 10:32:08,2010-03-06 11:52:02,2930
183,4412,4435,9030,"33 days, 1:20:34",2013-02-06 03:22:10,2010-02-01 10:32:08,2010-03-06 11:52:42,5562
198,709,1527,2434,"33 days, 1:26:00",2013-02-07 05:01:42,2010-02-01 10:32:08,2010-03-06 11:58:08,8375
397,76,325,798,"33 days, 2:40:31",2013-02-04 08:48:00,2010-05-09 05:58:03,2010-06-11 08:38:34,8185
734,192,408,1334,"33 days, 3:28:34",2013-01-28 01:57:06,2013-01-28 01:57:06,2013-03-02 05:25:40,8866
188,1163,1795,3146,"33 days, 3:38:35",2013-02-07 09:54:18,2010-02-25 04:58:37,2010-03-30 08:37:12,3146
356,6672,6759,13787,"33 days, 10:35:29",2013-02-07 06:20:33,2010-02-20 00:47:19,2010-03-25 11:22:48,1538
1429,875,2007,4311,"33 days, 13:31:51",2013-02-04 07:17:12,2010-02-01 10:32:08,2010-03-07 00:03:59,8870
1135,1873,2343,5351,"33 days, 13:40:43",2013-02-07 07:48:13,2010-03-06 10:45:09,2010-04-09 00:25:52,5642
1129,33,161,1323,"33 days, 13:42:43",2013-02-03 06:26:56,2010-07-18 11:51:40,2010-08-21 01:34:23,4900
273,5273,5493,11039,"33 days, 14:09:09",2013-02-07 11:11:26,2010-02-01 10:32:08,2010-03-07 00:41:17,2657
764,181,302,1247,"33 days, 14:15:37",2013-02-05 06:44:47,2010-02-01 10:32:08,2010-03-07 00:47:45,7587
322,2324,3192,5838,"33 days, 14:29:23",2013-02-04 06:15:16,2010-02-01 10:32:08,2010-03-07 01:01:31,9321
104,160,563,827,"33 days, 14:47:19",2013-02-04 10:27:00,2010-02-01 10:32:08,2010-03-07 01:19:27,8685
371,1605,1597,3573,"33 days, 14:48:47",2013-02-15 07:01:06,2010-02-01 10:32:08,2010-03-07 01:20:55,7882
383,622,1151,2156,"33 days, 15:09:10",2013-02-05 05:13:18,2010-02-01 10:32:08,2010-03-07 01:41:18,7454
1573,3752,4341,9666,"33 days, 15:11:49",2013-02-06 10:09:03,2010-02-01 10:32:08,2010-03-07 01:43:57,8078
1336,2244,3533,7113,"33 days, 15:12:56",2013-02-07 10:34:08,2010-02-01 10:32:08,2010-03-07 01:45:04,6807
869,764,1265,2898,"33 days, 15:18:12",2013-02-07 01:10:36,2010-02-01 10:32:08,2010-03-07 01:50:20,8938
980,3852,2848,7680,"33 days, 15:41:10",2013-02-08 10:46:30,2010-02-01 10:32:08,2010-03-07 02:13:18,6686
1583,7063,8276,16922,"33 days, 15:45:34",2013-02-08 10:57:41,2010-02-01 10:32:08,2010-03-07 02:17:42,2414
2071,3622,4364,10057,"33 days, 16:01:57",2013-02-06 09:16:26,2010-02-01 10:32:08,2010-03-07 02:34:05,9213
194,4611,4442,9247,"33 days, 16:03:50",2013-02-06 11:36:48,2010-02-01 10:32:08,2010-03-07 02:35:58,2608
1198,4980,4128,10306,"33 days, 16:07:41",2013-02-07 05:05:14,2010-02-01 10:32:08,2010-03-07 02:39:49,7260
335,11110,7332,18777,"33 days, 16:12:00",2013-02-07 08:40:25,2010-02-01 10:32:08,2010-03-07 02:44:08,1729
935,3499,3777,8211,"33 days, 16:15:57",2013-02-08 07:41:51,2010-02-01 10:32:08,2010-03-07 02:48:05,2997
129,713,1075,1917,"33 days, 16:30:45",2013-02-06 07:42:23,2010-02-01 10:32:08,2010-03-07 03:02:53,2161
124,2269,3038,5431,"33 days, 16:31:19",2013-02-07 02:21:06,2010-02-01 10:32:08,2010-03-07 03:03:27,9047
20,609,1007,1636,"33 days, 16:31:22",2013-02-06 09:01:15,2010-02-01 10:32:08,2010-03-07 03:03:30,5455
180,308,714,1202,"33 days, 16:45:06",2013-02-02 00:33:27,2010-02-01 10:32:08,2010-03-07 03:17:14,8682
360,2771,3270,6401,"33 days, 16:49:56",2013-02-25 00:35:09,2010-02-01 10:32:08,2010-03-07 03:22:04,7216
48,5411,6022,11481,"33 days, 16:52:51",2013-02-07 01:37:28,2010-02-01 10:32:08,2010-03-07 03:24:59,9704
396,1329,1427,3152,"33 days, 16:56:56",2013-02-07 03:20:28,2010-02-01 10:32:08,2010-03-07 03:29:04,1007
1701,3299,5739,10739,"33 days, 16:58:25",2013-02-07 08:24:03,2010-02-01 10:32:08,2010-03-07 03:30:33,2816
22,1177,1539,2738,"33 days, 17:01:14",2013-02-05 11:56:17,2010-02-01 10:32:08,2010-03-07 03:33:22,5877
541,794,1017,2352,"33 days, 17:01:34",2013-02-04 09:27:41,2010-02-01 10:32:08,2010-03-07 03:33:42,5359
19,5140,6527,11686,"33 days, 17:04:00",2013-02-07 08:21:20,2010-02-01 10:32:08,2010-03-07 03:36:08,1163
2234,1822,2652,6708,"33 days, 17:17:52",2013-02-07 11:03:33,2010-02-01 10:32:08,2010-03-07 03:50:00,3286
922,1260,1296,3478,"33 days, 17:42:14",2013-02-05 00:24:42,2010-02-01 10:32:08,2010-03-07 04:14:22,5111
490,6946,7048,14484,"33 days, 17:57:29",2013-02-07 07:59:54,2010-02-01 10:32:08,2010-03-07 04:29:37,8292
1788,8391,7723,17902,"33 days, 18:04:33",2013-02-07 05:44:32,2010-02-01 10:32:08,2010-03-07 04:36:41,9159
1263,391,306,1960,"33 days, 18:15:01",2013-01-27 11:10:39,2013-01-27 11:10:39,2013-03-02 05:25:40,8872
1030,3308,3902,8240,"33 days, 18:33:37",2013-02-05 04:19:53,2010-02-01 10:32:08,2010-03-07 05:05:45,8635
357,3012,4005,7374,"33 days, 18:41:12",2013-02-06 00:52:04,2010-02-01 10:32:08,2010-03-07 05:13:20,4074
1218,5774,5948,12940,"33 days, 18:45:17",2013-02-06 08:29:51,2010-03-03 07:40:01,2010-04-06 02:25:18,6326
1085,105,238,1428,"33 days, 18:45:24",2013-02-02 10:50:20,2010-02-01 10:32:08,2010-03-07 05:17:32,5236
626,3342,3345,7313,"33 days, 19:26:37",2013-02-07 05:48:57,2010-02-01 10:32:08,2010-03-07 05:58:45,3227
495,554,2240,3289,"33 days, 19:38:30",2013-02-06 09:58:41,2010-03-04 08:48:16,2010-04-07 04:26:46,4689
1398,610,841,2849,"33 days, 19:42:31",2013-02-03 02:31:01,2010-02-01 10:32:08,2010-03-07 06:14:39,9543
553,3817,3471,7841,"33 days, 19:57:37",2013-02-06 07:53:17,2010-02-01 10:32:08,2010-03-07 06:29:45,8287
469,422,1150,2041,"33 days, 20:03:26",2013-02-04 09:22:06,2010-02-01 10:32:08,2010-03-07 06:35:34,5390
73,1634,2488,4195,"33 days, 20:08:11",2013-02-07 07:38:32,2010-02-01 10:32:08,2010-03-07 06:40:19,196
262,3345,3051,6658,"33 days, 20:22:58",2013-02-06 09:48:47,2010-02-01 10:32:08,2010-03-07 06:55:06,8805
136,790,1347,2273,"33 days, 20:26:18",2013-02-06 09:45:06,2010-02-01 10:32:08,2010-03-07 06:58:26,6784
728,5065,4853,10646,"33 days, 20:28:27",2013-02-07 02:01:43,2010-02-01 10:32:08,2010-03-07 07:00:35,2138
23,7882,6851,14756,"33 days, 20:33:55",2013-02-07 01:10:44,2010-02-01 10:32:08,2010-03-07 07:06:03,2246
1667,7681,3806,13154,"33 days, 20:34:20",2013-02-09 08:08:09,2010-02-01 10:32:08,2010-03-07 07:06:28,6619
252,1778,2081,4111,"33 days, 20:35:55",2013-02-07 07:04:49,2010-02-01 10:32:08,2010-03-07 07:08:03,617
53,3444,2894,6391,"33 days, 20:47:24",2013-02-06 08:28:25,2010-02-01 10:32:08,2010-03-07 07:19:32,151
189,1736,1975,3900,"33 days, 20:50:17",2013-02-06 01:39:12,2010-02-01 10:32:08,2010-03-07 07:22:25,6041
1570,5678,5352,12600,"33 days, 20:55:28",2013-02-05 07:16:23,2010-02-01 10:32:08,2010-03-07 07:27:36,9455
1082,2742,3575,7399,"33 days, 21:21:31",2013-02-07 03:40:10,2010-02-01 10:32:08,2010-03-07 07:53:39,903
708,411,566,1685,"33 days, 21:21:35",2013-02-07 06:04:19,2010-02-01 10:32:08,2010-03-07 07:53:43,2178
7,728,873,1608,"33 days, 21:26:16",2013-02-05 03:51:05,2010-02-01 10:32:08,2010-03-07 07:58:24,9402
649,969,1435,3053,"33 days, 21:28:06",2013-02-13 05:37:32,2010-02-01 10:32:08,2010-03-07 08:00:14,2491
266,1883,2642,4791,"33 days, 21:39:06",2013-02-06 11:38:13,2010-02-01 10:32:08,2010-03-07 08:11:14,2645
618,3074,5339,9031,"33 days, 21:49:22",2013-02-06 07:42:45,2010-02-01 10:32:08,2010-03-07 08:21:30,2147
72,7793,7798,15663,"33 days, 21:49:47",2013-02-08 04:57:47,2010-02-01 10:32:08,2010-03-07 08:21:55,1388
193,3037,3506,6736,"33 days, 21:51:17",2013-02-06 06:48:15,2010-02-01 10:32:08,2010-03-07 08:23:25,7177
386,5401,7639,13426,"33 days, 21:52:39",2013-02-07 09:28:52,2010-02-01 10:32:08,2010-03-07 08:24:47,5529
37,102,394,533,"33 days, 21:53:07",2013-02-04 01:31:41,2010-02-01 10:32:08,2010-03-07 08:25:15,8437
85,1580,1494,3159,"33 days, 22:18:08",2013-02-06 10:40:56,2010-02-01 10:32:08,2010-03-07 08:50:16,2730
1442,5534,7340,14316,"33 days, 22:23:29",2013-02-06 05:30:12,2010-02-01 10:32:08,2010-03-07 08:55:37,5394
180,6181,5112,11473,"33 days, 22:28:21",2013-02-07 06:31:42,2010-02-01 10:32:08,2010-03-07 09:00:29,3488
1947,8382,8074,18403,"33 days, 22:45:12",2013-02-07 10:37:31,2010-02-01 10:32:08,2010-03-07 09:17:20,3455
32,1747,2401,4180,"33 days, 23:05:14",2013-02-06 03:30:36,2010-02-01 10:32:08,2010-03-07 09:37:22,6454
2344,5475,5162,12981,"33 days, 23:14:06",2013-02-06 08:09:39,2010-02-01 10:32:08,2010-03-07 09:46:14,3259
30,62,357,449,"33 days, 23:32:29",2013-01-27 05:53:11,2013-01-27 05:53:11,2013-03-02 05:25:40,3805
1471,2929,4392,8792,"33 days, 23:39:18",2013-02-06 06:04:38,2010-02-01 10:32:08,2010-03-07 10:11:26,2991
656,795,1365,2816,"33 days, 23:58:58",2013-02-06 11:31:52,2010-02-01 10:32:08,2010-03-07 10:31:06,2599
839,21,124,984,"33 days, 23:59:28",2013-01-28 03:21:55,2010-06-08 03:57:00,2010-07-12 03:56:28,5763
512,524,1080,2116,"34 days, 0:01:22",2013-02-06 09:08:11,2010-03-26 11:48:47,2010-04-29 11:50:09,307
277,948,1156,2381,"34 days, 0:06:01",2013-02-05 02:38:35,2010-02-01 10:32:08,2010-03-07 10:38:09,5061
104,2915,3480,6499,"34 days, 0:21:05",2013-02-07 06:48:29,2010-02-01 10:32:08,2010-03-07 10:53:13,2022
1308,4386,3879,9573,"34 days, 0:22:17",2013-02-06 04:20:40,2010-02-01 10:32:08,2010-03-07 10:54:25,3021
81,1408,3394,4883,"34 days, 0:22:53",2013-02-07 06:53:28,2010-02-01 10:32:08,2010-03-07 10:55:01,6747
789,1906,2598,5293,"34 days, 0:36:43",2013-02-06 09:16:08,2010-02-01 10:32:08,2010-03-07 11:08:51,2850
1433,90,285,1808,"34 days, 0:37:35",2013-02-05 00:27:44,2010-02-01 10:32:08,2010-03-07 11:09:43,5858
40,7004,6939,13983,"34 days, 0:42:08",2013-02-06 04:19:06,2010-02-01 10:32:08,2010-03-07 11:14:16,6425
626,173,361,1160,"34 days, 0:45:45",2013-02-05 09:40:23,2010-02-01 10:32:08,2010-03-07 11:17:53,5176
238,3936,3688,7862,"34 days, 0:48:47",2013-02-06 11:42:26,2010-02-01 10:32:08,2010-03-07 11:20:55,9465
255,910,1432,2597,"34 days, 0:53:42",2013-02-07 07:11:07,2010-03-14 07:20:15,2010-04-17 08:13:57,1271
1058,1084,1393,3535,"34 days, 0:55:58",2013-02-05 02:12:39,2010-02-01 10:32:08,2010-03-07 11:28:06,9446
2075,2826,3192,8093,"34 days, 1:04:16",2013-02-07 00:58:33,2010-02-01 10:32:08,2010-03-07 11:36:24,6955
246,7057,6858,14161,"34 days, 1:05:34",2013-02-07 09:49:19,2010-02-01 10:32:08,2010-03-07 11:37:42,2547
697,986,2041,3724,"34 days, 1:11:47",2013-02-04 04:21:52,2010-02-01 10:32:08,2010-03-07 11:43:55,5741
1415,2795,3294,7504,"34 days, 1:19:32",2013-02-13 09:04:54,2010-02-01 10:32:08,2010-03-07 11:51:40,5452
101,7805,6682,14588,"34 days, 13:28:40",2013-02-06 09:23:10,2010-02-01 10:32:08,2010-03-08 00:00:48,4088
864,737,2588,4189,"34 days, 13:30:56",2013-02-07 09:27:12,2010-02-01 10:32:08,2010-03-08 00:03:04,6776
1605,5921,5639,13165,"34 days, 13:32:19",2013-02-06 02:23:42,2010-02-01 10:32:08,2010-03-08 00:04:27,1902
102,7629,7840,15571,"34 days, 13:47:40",2013-02-06 11:57:12,2010-02-01 10:32:08,2010-03-08 00:19:48,2965
3096,3916,4188,11200,"34 days, 13:55:58",2013-02-07 04:56:05,2010-02-01 10:32:08,2010-03-08 00:28:06,2752
171,242,535,948,"34 days, 14:01:05",2013-02-01 05:15:58,2010-02-01 10:32:08,2010-03-08 00:33:13,3452
52,1407,1636,3095,"34 days, 14:04:15",2013-02-04 08:25:44,2010-02-01 10:32:08,2010-03-08 00:36:23,3961
671,3285,3840,7796,"34 days, 14:14:05",2013-02-06 01:43:48,2010-02-01 10:32:08,2010-03-08 00:46:13,1459
383,1005,1605,2993,"34 days, 14:20:42",2013-02-06 08:55:54,2010-02-01 10:32:08,2010-03-08 00:52:50,5917
730,4,58,792,"34 days, 14:23:26",2013-02-06 07:49:20,2011-09-18 11:47:27,2011-10-23 02:10:53,6220
968,6088,3480,10536,"34 days, 14:30:15",2013-02-06 03:35:25,2010-02-01 10:32:08,2010-03-08 01:02:23,481
1349,2859,2092,6300,"34 days, 14:44:34",2013-02-04 01:19:01,2010-02-01 10:32:08,2010-03-08 01:16:42,9881
511,1845,2888,5244,"34 days, 14:55:49",2013-02-06 01:07:05,2010-02-01 10:32:08,2010-03-08 01:27:57,8931
337,6540,5640,12517,"34 days, 14:56:00",2013-02-07 00:53:34,2010-02-01 10:32:08,2010-03-08 01:28:08,2671
4,1974,2555,4533,"34 days, 14:57:15",2013-02-18 05:18:27,2010-02-01 10:32:08,2010-03-08 01:29:23,8127
2174,5373,4719,12266,"34 days, 14:57:35",2013-02-07 00:49:57,2010-02-01 10:32:08,2010-03-08 01:29:43,4477
1188,2526,2083,5797,"34 days, 15:00:22",2013-02-07 03:01:23,2010-02-01 10:32:08,2010-03-08 01:32:30,5250
661,610,1086,2357,"34 days, 15:10:25",2013-02-07 03:52:46,2010-02-01 10:32:08,2010-03-08 01:42:33,6294
389,593,503,1485,"34 days, 15:15:20",2013-02-05 07:32:12,2010-02-01 10:32:08,2010-03-08 01:47:28,72
1125,3709,4139,8973,"34 days, 15:16:44",2013-02-06 10:07:01,2010-02-01 10:32:08,2010-03-08 01:48:52,9119
141,57,156,354,"34 days, 15:17:01",2013-01-30 05:38:18,2010-04-10 10:31:59,2010-05-15 01:49:00,7487
1348,6543,7453,15344,"34 days, 15:24:23",2013-02-07 00:21:18,2010-02-01 10:32:08,2010-03-08 01:56:31,8464
449,3004,4655,8108,"34 days, 15:35:31",2013-02-07 02:05:08,2010-02-01 10:32:08,2010-03-08 02:07:39,2505
226,470,1220,1916,"34 days, 15:46:32",2013-02-04 05:08:58,2010-02-01 10:32:08,2010-03-08 02:18:40,6086
186,220,844,1250,"34 days, 15:50:10",2013-02-05 08:52:41,2010-02-01 10:32:08,2010-03-08 02:22:18,3337
445,2768,3627,6840,"34 days, 15:53:20",2013-02-05 10:27:50,2010-02-01 10:32:08,2010-03-08 02:25:28,9551
852,1542,2218,4612,"34 days, 16:11:04",2013-02-07 06:26:27,2010-02-01 10:32:08,2010-03-08 02:43:12,5853
388,169,769,1326,"34 days, 16:13:44",2013-01-31 02:33:04,2010-02-01 10:32:08,2010-03-08 02:45:52,9245
108,1789,2028,3925,"34 days, 16:18:07",2013-02-07 03:09:11,2010-02-01 10:32:08,2010-03-08 02:50:15,6134
701,2358,3328,6387,"34 days, 16:19:51",2013-02-05 07:36:09,2010-02-01 10:32:08,2010-03-08 02:51:59,7599
1076,273,599,1948,"34 days, 16:25:30",2013-02-04 00:50:49,2010-02-01 10:32:08,2010-03-08 02:57:38,7978
809,1928,2960,5697,"34 days, 16:42:51",2013-02-08 01:30:44,2010-02-01 10:32:08,2010-03-08 03:14:59,3493
114,1646,2938,4698,"34 days, 16:43:47",2013-02-06 08:01:34,2010-02-01 10:32:08,2010-03-08 03:15:55,6197
1126,586,929,2641,"34 days, 16:51:09",2013-02-07 03:35:05,2010-02-01 10:32:08,2010-03-08 03:23:17,5323
174,288,793,1255,"34 days, 16:56:34",2013-02-03 09:26:40,2010-02-01 10:32:08,2010-03-08 03:28:42,9499
924,1269,2675,4868,"34 days, 16:57:18",2013-02-07 06:34:34,2010-02-01 10:32:08,2010-03-08 03:29:26,8221
1282,8305,7136,16723,"34 days, 17:05:31",2013-02-07 05:45:47,2010-02-01 10:32:08,2010-03-08 03:37:39,240
83,82,374,539,"34 days, 17:14:24",2013-01-31 10:56:31,2010-02-01 10:32:08,2010-03-08 03:46:32,3067
273,225,648,1146,"34 days, 17:35:23",2013-02-03 09:30:11,2010-02-01 10:32:08,2010-03-08 04:07:31,9812
1425,524,629,2578,"34 days, 17:40:13",2013-02-03 05:53:11,2010-02-01 10:32:08,2010-03-08 04:12:21,1308
539,1385,2089,4013,"34 days, 17:50:17",2013-02-06 08:48:27,2010-02-01 10:32:08,2010-03-08 04:22:25,8782
6,1825,3264,5095,"34 days, 17:54:09",2013-02-05 10:42:08,2010-02-01 10:32:08,2010-03-08 04:26:17,7034
99,828,1565,2492,"34 days, 17:59:19",2013-02-07 07:37:17,2010-02-01 10:32:08,2010-03-08 04:31:27,4554
62,957,1889,2908,"34 days, 18:10:31",2013-02-04 10:24:32,2010-02-01 10:32:08,2010-03-08 04:42:39,3566
1291,1581,2531,5403,"34 days, 18:29:24",2013-02-05 01:50:25,2010-02-01 10:32:08,2010-03-08 05:01:32,9875
695,105,184,984,"34 days, 18:31:18",2013-01-30 07:15:43,2010-02-01 10:32:08,2010-03-08 05:03:26,2279
376,4205,5274,9855,"34 days, 18:34:51",2013-02-07 10:18:12,2010-02-01 10:32:08,2010-03-08 05:06:59,6208
66,6674,5248,11988,"34 days, 18:36:56",2013-02-07 10:42:50,2010-02-01 10:32:08,2010-03-08 05:09:04,9112
1101,1949,2780,5830,"34 days, 18:39:23",2013-02-06 11:42:40,2010-02-01 10:32:08,2010-03-08 05:11:31,3435
343,6325,9788,16456,"34 days, 18:41:46",2013-02-08 00:22:26,2010-02-01 10:32:08,2010-03-08 05:13:54,8602
21,1669,1807,3497,"34 days, 18:54:46",2013-02-05 03:44:16,2010-02-01 10:32:08,2010-03-08 05:26:54,9932
180,2983,3597,6760,"34 days, 19:03:21",2013-02-06 08:42:44,2010-02-01 10:32:08,2010-03-08 05:35:29,9702
556,1221,1616,3393,"34 days, 19:07:07",2013-02-06 09:24:15,2010-02-01 10:32:08,2010-03-08 05:39:15,5715
751,309,869,1929,"34 days, 19:15:53",2013-02-04 06:16:22,2010-02-01 10:32:08,2010-03-08 05:48:01,5861
759,998,1480,3237,"34 days, 19:19:06",2013-02-06 02:00:33,2010-02-01 10:32:08,2010-03-08 05:51:14,3323
1037,601,1240,2878,"34 days, 19:27:46",2013-02-05 02:15:07,2010-02-01 10:32:08,2010-03-08 05:59:54,5469
28,2321,3382,5731,"34 days, 19:31:00",2013-02-05 10:45:22,2010-02-01 10:32:08,2010-03-08 06:03:08,8246
195,2268,2997,5460,"34 days, 19:32:52",2013-02-07 06:19:32,2010-02-01 10:32:08,2010-03-08 06:05:00,1591
729,2416,3743,6888,"34 days, 19:47:14",2013-02-06 10:26:36,2010-02-01 10:32:08,2010-03-08 06:19:22,3121
12,866,1285,2163,"34 days, 19:50:00",2013-02-05 10:40:08,2010-02-01 10:32:08,2010-03-08 06:22:08,5546
1255,132,235,1622,"34 days, 19:50:13",2013-02-02 11:53:05,2010-02-01 10:32:08,2010-03-08 06:22:21,2773
165,1080,1585,2830,"34 days, 19:54:59",2013-02-06 01:37:25,2010-02-01 10:32:08,2010-03-08 06:27:07,1910
876,4433,6538,11847,"34 days, 20:00:25",2013-02-07 09:27:44,2010-02-01 10:32:08,2010-03-08 06:32:33,9304
7,2283,2699,4989,"34 days, 20:20:22",2013-02-07 01:34:12,2010-02-01 10:32:08,2010-03-08 06:52:30,6839
269,3643,4601,8513,"34 days, 20:21:32",2013-02-06 09:51:17,2010-02-01 10:32:08,2010-03-08 06:53:40,1683
740,1680,2552,4972,"34 days, 20:27:19",2013-02-04 04:25:30,2010-02-01 10:32:08,2010-03-08 06:59:27,1569
402,858,1412,2672,"34 days, 20:40:51",2013-02-07 05:18:06,2010-02-01 10:32:08,2010-03-08 07:12:59,2400
213,6053,5776,12042,"34 days, 20:53:31",2013-02-07 10:45:36,2010-02-01 10:32:08,2010-03-08 07:25:39,1839
1283,757,952,2992,"34 days, 20:54:37",2013-02-07 03:21:22,2010-02-01 10:32:08,2010-03-08 07:26:45,328
716,3317,3827,7860,"34 days, 21:05:22",2013-02-11 01:52:24,2010-02-01 10:32:08,2010-03-08 07:37:30,1967
1076,7721,6461,15258,"34 days, 21:07:12",2013-02-07 08:30:42,2010-02-01 10:32:08,2010-03-08 07:39:20,6419
1402,10284,8365,20051,"34 days, 21:11:59",2013-02-07 07:03:13,2010-02-01 10:32:08,2010-03-08 07:44:07,5144
2009,2737,4942,9688,"34 days, 21:16:18",2013-02-06 00:33:41,2010-02-01 10:32:08,2010-03-08 07:48:26,6515
1103,804,959,2866,"34 days, 21:26:04",2013-02-06 11:34:38,2010-05-08 10:19:50,2010-06-12 07:45:54,5577
806,1330,1557,3693,"34 days, 21:29:35",2013-02-06 09:11:41,2010-02-01 10:32:08,2010-03-08 08:01:43,7213
88,1820,3322,5230,"34 days, 21:34:09",2013-02-10 06:55:07,2010-02-01 10:32:08,2010-03-08 08:06:17,6560
51,366,1082,1499,"34 days, 21:35:30",2013-02-06 04:11:52,2010-02-01 10:32:08,2010-03-08 08:07:38,2919
1665,5641,6186,13492,"34 days, 21:40:18",2013-02-06 11:15:02,2010-02-26 09:21:51,2010-04-02 07:02:09,4405
745,959,1813,3517,"34 days, 21:53:14",2013-02-04 04:55:00,2010-02-01 10:32:08,2010-03-08 08:25:22,3766
674,1037,1195,2906,"34 days, 21:54:09",2013-02-07 03:16:02,2010-02-01 10:32:08,2010-03-08 08:26:17,1889
587,7411,5721,13719,"34 days, 21:58:20",2013-02-09 10:54:36,2010-02-01 10:32:08,2010-03-08 08:30:28,3990
887,486,922,2295,"34 days, 22:03:56",2013-02-04 06:08:37,2010-02-01 10:32:08,2010-03-08 08:36:04,8889
234,1231,2020,3485,"34 days, 22:22:17",2013-02-07 05:47:48,2010-02-01 10:32:08,2010-03-08 08:54:25,6867
966,1124,2543,4633,"34 days, 22:23:11",2013-02-05 01:34:16,2010-02-01 10:32:08,2010-03-08 08:55:19,6132
1251,1356,2004,4611,"34 days, 22:26:11",2013-02-06 11:21:10,2010-02-01 10:32:08,2010-03-08 08:58:19,761
13,160,578,751,"34 days, 22:28:23",2013-02-05 04:20:21,2010-02-01 10:32:08,2010-03-08 09:00:31,3615
694,252,497,1443,"34 days, 22:42:16",2013-02-07 01:08:16,2010-02-08 07:15:19,2010-03-15 05:57:35,8376
238,1025,1185,2448,"34 days, 22:44:08",2013-02-07 00:51:42,2010-02-01 10:32:08,2010-03-08 09:16:16,3371
1388,8411,7303,17102,"34 days, 22:45:13",2013-02-06 06:37:20,2010-02-01 10:32:08,2010-03-08 09:17:21,2388
1421,2918,3462,7801,"34 days, 22:45:30",2013-02-06 11:59:34,2010-02-01 10:32:08,2010-03-08 09:17:38,876
437,6193,5669,12299,"34 days, 22:50:08",2013-02-06 08:37:40,2010-02-01 10:32:08,2010-03-08 09:22:16,1619
696,272,252,1220,"34 days, 22:57:10",2013-01-30 06:31:33,2010-02-01 10:32:08,2010-03-08 09:29:18,2068
343,1783,2899,5025,"34 days, 22:58:58",2013-02-07 02:13:59,2010-02-01 10:32:08,2010-03-08 09:31:06,9370
231,178,202,611,"34 days, 23:00:23",2013-02-06 05:26:12,2010-02-01 10:32:08,2010-03-08 09:32:31,3672
53,1720,2163,3936,"34 days, 23:14:21",2013-02-06 11:03:03,2010-02-01 10:32:08,2010-03-08 09:46:29,3765
1532,4823,6253,12608,"34 days, 23:15:42",2013-02-06 08:16:59,2010-02-01 10:32:08,2010-03-08 09:47:50,8398
1654,1538,2216,5408,"34 days, 23:15:43",2013-02-08 00:32:11,2010-02-01 10:32:08,2010-03-08 09:47:51,744
142,4978,4604,9724,"34 days, 23:16:38",2013-02-05 04:52:33,2010-02-01 10:32:08,2010-03-08 09:48:46,5712
982,1113,1285,3380,"34 days, 23:25:17",2013-02-06 07:35:50,2010-02-01 10:32:08,2010-03-08 09:57:25,3303
27,288,431,746,"34 days, 23:40:11",2013-02-03 04:01:00,2010-02-01 10:32:08,2010-03-08 10:12:19,8528
224,378,544,1146,"34 days, 23:40:46",2013-02-06 03:08:39,2010-02-01 10:32:08,2010-03-08 10:12:54,8219
23,3317,3437,6777,"34 days, 23:53:28",2013-02-05 03:16:53,2010-02-01 10:32:08,2010-03-08 10:25:36,894
412,1028,1701,3141,"35 days, 0:00:46",2013-02-05 07:23:22,2010-02-01 10:32:08,2010-03-08 10:32:54,7385
102,4292,5297,9691,"35 days, 0:02:45",2013-02-07 05:14:04,2010-02-01 10:32:08,2010-03-08 10:34:53,8153
36,242,489,767,"35 days, 0:05:34",2013-02-05 11:56:04,2010-05-07 09:15:05,2010-06-11 09:20:39,2719
102,1560,2093,3755,"35 days, 0:06:39",2013-02-06 08:28:19,2010-02-01 10:32:08,2010-03-08 10:38:47,9901
1394,152,157,1703,"35 days, 0:08:17",2013-02-02 10:15:07,2010-02-01 10:32:08,2010-03-08 10:40:25,9628
56,1253,1730,3039,"35 days, 0:22:09",2013-02-06 05:07:51,2010-02-01 10:32:08,2010-03-08 10:54:17,3501
333,288,583,1204,"35 days, 0:26:49",2013-02-02 05:07:44,2010-02-15 11:19:52,2010-03-22 11:46:41,3804
396,3,102,501,"35 days, 0:32:20",2013-02-06 04:58:51,2012-05-18 03:06:10,2012-06-22 03:38:30,5106
321,2273,2655,5249,"35 days, 0:37:48",2013-02-05 11:45:10,2010-02-01 10:32:08,2010-03-08 11:09:56,1855
73,4061,4539,8673,"35 days, 0:42:23",2013-02-06 10:28:12,2010-02-01 10:32:08,2010-03-08 11:14:31,2874
14,162,627,803,"35 days, 0:43:07",2013-02-06 11:58:10,2010-02-01 10:32:08,2010-03-08 11:15:15,2811
34,4422,6022,10478,"35 days, 0:50:49",2013-02-12 03:16:06,2010-02-01 10:32:08,2010-03-08 11:22:57,2011
787,135,186,1108,"35 days, 0:54:44",2013-01-31 09:18:34,2010-02-01 10:32:08,2010-03-08 11:26:52,5835
1456,0,11,1467,"35 days, 1:01:29",2013-01-26 04:24:11,2013-01-26 04:24:11,2013-03-02 05:25:40,3111
1679,6427,5504,13610,"35 days, 1:03:10",2013-02-07 08:38:18,2010-02-01 10:32:08,2010-03-08 11:35:18,2454
65,5686,7405,13156,"35 days, 1:03:57",2013-02-07 11:40:55,2010-02-01 10:32:08,2010-03-08 11:36:05,913
310,3803,5235,9348,"35 days, 1:05:22",2013-02-10 02:05:33,2010-02-01 10:32:08,2010-03-08 11:37:30,5482
14,181,172,367,"35 days, 1:07:36",2013-02-05 09:16:50,2010-02-01 10:32:08,2010-03-08 11:39:44,2202
102,455,824,1381,"35 days, 1:08:07",2013-02-03 06:00:56,2010-02-01 10:32:08,2010-03-08 11:40:15,5799
664,5751,4437,10852,"35 days, 1:14:42",2013-02-06 08:45:35,2010-02-01 10:32:08,2010-03-08 11:46:50,9092
482,2800,3296,6578,"35 days, 1:15:59",2013-02-05 11:27:22,2010-02-01 10:32:08,2010-03-08 11:48:07,532
836,75,592,1503,"35 days, 2:28:18",2013-02-07 01:07:46,2010-07-16 03:35:02,2010-08-20 06:03:20,7165
1529,2139,3320,6988,"35 days, 3:45:32",2013-02-07 07:49:42,2010-02-16 03:02:55,2010-03-23 06:48:27,8367
658,2255,3166,6079,"35 days, 13:29:21",2013-02-07 03:08:05,2010-02-01 10:32:08,2010-03-09 00:01:29,3360
706,4583,3402,8691,"35 days, 13:32:02",2013-02-05 10:17:05,2010-02-01 10:32:08,2010-03-09 00:04:10,8981
145,2034,3184,5363,"35 days, 13:32:27",2013-02-24 09:30:41,2010-02-01 10:32:08,2010-03-09 00:04:35,1844
81,4606,5340,10027,"35 days, 13:48:14",2013-02-07 01:57:53,2010-02-01 10:32:08,2010-03-09 00:20:22,8832
461,1375,2095,3931,"35 days, 14:01:23",2013-02-05 07:24:35,2010-02-01 10:32:08,2010-03-09 00:33:31,3388
391,141,255,787,"35 days, 14:09:43",2013-02-05 10:11:52,2010-02-01 10:32:08,2010-03-09 00:41:51,8764
20,1420,2964,4404,"35 days, 14:17:55",2013-02-06 07:52:35,2010-02-01 10:32:08,2010-03-09 00:50:03,8109
684,1268,2352,4304,"35 days, 14:20:32",2013-02-06 00:20:20,2010-02-01 10:32:08,2010-03-09 00:52:40,6981
1297,175,591,2063,"35 days, 14:36:38",2013-02-04 01:24:32,2010-02-01 10:32:08,2010-03-09 01:08:46,3998
624,2871,4109,7604,"35 days, 14:41:31",2013-02-07 10:04:35,2010-02-01 10:32:08,2010-03-09 01:13:39,6232
326,3545,5285,9156,"35 days, 14:45:39",2013-02-07 08:23:30,2010-02-01 10:32:08,2010-03-09 01:17:47,9501
1033,2867,2591,6491,"35 days, 14:58:50",2013-02-07 07:40:48,2010-02-01 10:32:08,2010-03-09 01:30:58,2319
956,1853,2470,5279,"35 days, 15:13:39",2013-02-06 05:12:43,2010-02-01 10:32:08,2010-03-09 01:45:47,6139
354,2473,1916,4743,"35 days, 15:19:54",2013-02-23 00:08:08,2010-02-01 10:32:08,2010-03-09 01:52:02,1226
1667,1841,2854,6362,"35 days, 15:26:51",2013-02-04 08:44:06,2010-02-01 10:32:08,2010-03-09 01:58:59,1896
412,1578,1822,3812,"35 days, 15:37:30",2013-02-07 06:23:06,2010-02-01 10:32:08,2010-03-09 02:09:38,3129
289,296,358,943,"35 days, 15:41:44",2013-02-02 06:06:12,2010-02-01 10:32:08,2010-03-09 02:13:52,6094
1693,4215,5505,11413,"35 days, 15:49:22",2013-02-06 01:09:19,2010-02-01 10:32:08,2010-03-09 02:21:30,1795
1276,0,3,1279,"35 days, 16:15:08",2013-01-29 07:15:06,2010-02-01 10:32:08,2010-03-09 02:47:16,8264
545,2032,2552,5129,"35 days, 16:17:22",2013-02-05 07:00:36,2010-02-01 10:32:08,2010-03-09 02:49:30,9818
152,7922,6967,15041,"35 days, 16:18:09",2013-02-07 05:41:04,2010-02-01 10:32:08,2010-03-09 02:50:17,3263
1217,365,1215,2797,"35 days, 16:27:58",2013-02-05 10:57:38,2010-02-01 10:32:08,2010-03-09 03:00:06,9534
257,3796,4938,8991,"35 days, 16:28:51",2013-02-07 05:06:36,2010-02-01 10:32:08,2010-03-09 03:00:59,7955
45,697,1296,2038,"35 days, 16:48:53",2013-02-05 02:16:04,2010-02-01 10:32:08,2010-03-09 03:21:01,6343
244,2316,4289,6849,"35 days, 16:58:55",2013-02-06 09:08:19,2010-02-01 10:32:08,2010-03-09 03:31:03,581
830,83,427,1340,"35 days, 17:13:14",2013-02-04 08:38:33,2010-02-01 10:32:08,2010-03-09 03:45:22,1200
946,9688,9405,20039,"35 days, 17:15:35",2013-02-07 09:36:13,2010-02-01 10:32:08,2010-03-09 03:47:43,3512
1194,1513,1674,4381,"35 days, 17:29:28",2013-02-06 00:32:08,2010-02-01 10:32:08,2010-03-09 04:01:36,1278
1220,239,411,1870,"35 days, 17:34:55",2013-02-06 02:00:00,2010-02-01 10:32:08,2010-03-09 04:07:03,6818
719,34,283,1036,"35 days, 17:37:03",2013-02-03 08:39:36,2010-02-01 10:32:08,2010-03-09 04:09:11,8266
1027,1507,1318,3852,"35 days, 17:43:10",2013-02-06 01:42:26,2010-02-01 10:32:08,2010-03-09 04:15:18,2631
300,669,1644,2613,"35 days, 17:55:12",2013-02-05 01:37:28,2010-02-01 10:32:08,2010-03-09 04:27:20,9391
323,1278,2153,3754,"35 days, 17:55:23",2013-02-06 10:59:19,2010-02-01 10:32:08,2010-03-09 04:27:31,6775
868,1581,2395,4844,"35 days, 18:00:20",2013-02-06 09:30:29,2010-02-01 10:32:08,2010-03-09 04:32:28,3748
1217,4321,4975,10513,"35 days, 18:19:03",2013-02-07 08:54:42,2010-02-01 10:32:08,2010-03-09 04:51:11,5416
1012,285,747,2044,"35 days, 18:30:43",2013-02-04 04:38:08,2010-02-01 10:32:08,2010-03-09 05:02:51,9228
77,829,1372,2278,"35 days, 18:36:55",2013-02-04 06:01:05,2010-02-01 10:32:08,2010-03-09 05:09:03,3575
1227,1183,2176,4586,"35 days, 18:57:31",2013-02-05 06:21:13,2010-02-01 10:32:08,2010-03-09 05:29:39,6736
71,1386,2354,3811,"35 days, 19:07:21",2013-02-06 09:30:22,2010-02-01 10:32:08,2010-03-09 05:39:29,5596
658,6867,9791,17316,"35 days, 19:15:56",2013-02-07 11:32:15,2010-02-01 10:32:08,2010-03-09 05:48:04,5934
1491,4060,5661,11212,"35 days, 19:35:36",2013-02-07 00:02:37,2010-02-01 10:32:08,2010-03-09 06:07:44,2626
516,3061,3531,7108,"35 days, 19:35:38",2013-02-07 01:22:14,2010-02-01 10:32:08,2010-03-09 06:07:46,1606
13,235,897,1145,"35 days, 19:39:22",2013-02-05 08:05:11,2010-02-01 10:32:08,2010-03-09 06:11:30,9709
1060,4024,4422,9506,"35 days, 19:40:26",2013-02-05 00:00:32,2010-02-01 10:32:08,2010-03-09 06:12:34,6260
1676,3360,4421,9457,"35 days, 19:42:21",2013-02-06 06:14:58,2010-02-01 10:32:08,2010-03-09 06:14:29,4123
1260,3073,4918,9251,"35 days, 19:43:26",2013-02-05 03:47:14,2010-02-01 10:32:08,2010-03-09 06:15:34,7801
605,387,703,1695,"35 days, 19:51:03",2013-02-05 10:40:25,2010-02-01 10:32:08,2010-03-09 06:23:11,2741
961,576,1335,2872,"35 days, 19:52:26",2013-02-06 02:11:35,2010-02-01 10:32:08,2010-03-09 06:24:34,908
204,1902,3004,5110,"35 days, 20:00:42",2013-02-07 03:27:58,2010-02-01 10:32:08,2010-03-09 06:32:50,1924
605,456,1101,2162,"35 days, 20:05:19",2013-02-02 10:52:22,2010-02-01 10:32:08,2010-03-09 06:37:27,6837
1904,4494,5449,11847,"35 days, 20:06:07",2013-02-07 05:51:55,2010-02-01 10:32:08,2010-03-09 06:38:15,2476
724,610,1465,2799,"35 days, 20:12:32",2013-02-06 04:40:10,2010-02-01 10:32:08,2010-03-09 06:44:40,5928
1088,3132,2999,7219,"35 days, 20:18:23",2013-02-06 11:18:41,2010-02-01 10:32:08,2010-03-09 06:50:31,228
88,5784,5574,11446,"35 days, 20:27:27",2013-02-06 09:46:37,2010-02-01 10:32:08,2010-03-09 06:59:35,8714
1560,4144,5571,11275,"35 days, 20:50:07",2013-02-06 06:04:29,2010-02-01 10:32:08,2010-03-09 07:22:15,5825
278,136,171,585,"35 days, 20:56:04",2013-02-03 11:00:06,2010-02-01 10:32:08,2010-03-09 07:28:12,6983
729,82,317,1128,"35 days, 20:56:12",2013-01-30 11:12:24,2010-02-01 10:32:08,2010-03-09 07:28:20,59
1090,3137,3470,7697,"35 days, 21:09:09",2013-02-07 06:14:05,2010-02-01 10:32:08,2010-03-09 07:41:17,8830
1978,1330,2239,5547,"35 days, 21:31:25",2013-02-06 05:40:20,2010-02-01 10:32:08,2010-03-09 08:03:33,1161
815,1031,2080,3926,"35 days, 21:34:45",2013-02-08 03:31:39,2010-02-01 10:32:08,2010-03-09 08:06:53,2084
592,23,153,768,"35 days, 21:38:33",2013-02-02 06:41:11,2010-12-29 09:32:38,2011-02-03 07:11:11,2060
87,1608,2545,4240,"35 days, 21:41:05",2013-02-06 06:11:38,2010-02-01 10:32:08,2010-03-09 08:13:13,6731
667,1005,1428,3100,"35 days, 21:56:21",2013-02-07 00:16:56,2010-02-01 10:32:08,2010-03-09 08:28:29,252
395,1236,1687,3318,"35 days, 22:07:58",2013-02-05 11:05:34,2010-02-01 10:32:08,2010-03-09 08:40:06,9802
250,294,632,1176,"35 days, 22:12:06",2013-02-04 07:27:09,2010-02-01 10:32:08,2010-03-09 08:44:14,6749
255,1815,1671,3741,"35 days, 22:16:15",2013-02-06 07:18:48,2010-02-01 10:32:08,2010-03-09 08:48:23,1799
324,1711,1468,3503,"35 days, 22:38:18",2013-02-07 00:35:45,2010-02-01 10:32:08,2010-03-09 09:10:26,4475
2965,5702,6403,15070,"35 days, 22:44:15",2013-02-06 00:30:02,2010-02-01 10:32:08,2010-03-09 09:16:23,1958
1083,0,65,1148,"35 days, 22:55:40",2013-02-01 01:36:46,2010-03-07 09:58:50,2010-04-12 08:54:30,6426
1323,3390,4236,8949,"35 days, 23:01:50",2013-02-07 09:17:54,2010-02-01 10:32:08,2010-03-09 09:33:58,4515
977,4445,5842,11264,"35 days, 23:23:42",2013-02-06 03:52:31,2010-02-01 10:32:08,2010-03-09 09:55:50,6339
647,2738,3320,6705,"35 days, 23:32:42",2013-02-07 03:15:27,2010-02-01 10:32:08,2010-03-09 10:04:50,6489
121,109,322,552,"35 days, 23:33:29",2013-02-05 10:30:19,2010-02-01 10:32:08,2010-03-09 10:05:37,9576
166,607,820,1593,"35 days, 23:48:33",2013-02-04 04:27:04,2010-02-01 10:32:08,2010-03-09 10:20:41,3375
29,4964,4786,9779,"35 days, 23:55:09",2013-02-07 02:29:56,2010-02-01 10:32:08,2010-03-09 10:27:17,8895
202,2201,3317,5720,"36 days, 0:26:21",2013-02-07 08:14:04,2010-02-01 10:32:08,2010-03-09 10:58:29,786
137,6109,5988,12234,"36 days, 0:27:56",2013-02-07 09:41:51,2010-02-01 10:32:08,2010-03-09 11:00:04,8010
94,184,590,868,"36 days, 1:15:12",2013-02-04 11:26:20,2010-02-01 10:32:08,2010-03-09 11:47:20,7598
895,1674,2580,5149,"36 days, 1:27:50",2013-02-06 07:58:10,2010-02-01 10:32:08,2010-03-09 11:59:58,6038
786,777,1427,2990,"36 days, 2:29:44",2013-02-06 11:05:48,2010-03-01 01:36:33,2010-04-06 04:06:17,7455
728,200,203,1131,"36 days, 3:44:27",2013-02-04 07:35:44,2010-03-18 07:39:22,2010-04-23 11:23:49,4114
89,26,279,394,"36 days, 3:47:23",2013-02-05 04:46:55,2010-08-21 03:20:50,2010-09-26 07:08:13,8907
422,2123,3521,6066,"36 days, 13:34:26",2013-02-06 09:20:55,2010-02-01 10:32:08,2010-03-10 00:06:34,979
97,356,374,827,"36 days, 13:35:43",2013-02-05 06:25:25,2010-02-01 10:32:08,2010-03-10 00:07:51,3324
1409,598,1483,3490,"36 days, 13:41:09",2013-02-05 01:31:36,2010-02-01 10:32:08,2010-03-10 00:13:17,1813
767,2840,3833,7440,"36 days, 13:43:59",2013-02-07 01:10:48,2010-02-01 10:32:08,2010-03-10 00:16:07,5069
252,5738,8267,14257,"36 days, 13:48:59",2013-02-07 11:33:33,2010-02-01 10:32:08,2010-03-10 00:21:07,2921
184,774,1133,2091,"36 days, 13:49:05",2013-02-05 04:30:08,2010-02-01 10:32:08,2010-03-10 00:21:13,6574
65,148,242,455,"36 days, 13:53:57",2013-01-30 06:41:35,2010-02-01 10:32:08,2010-03-10 00:26:05,5419
748,912,1420,3080,"36 days, 14:06:11",2013-02-06 11:38:02,2010-02-01 10:32:08,2010-03-10 00:38:19,6005
1817,2839,3588,8244,"36 days, 14:09:29",2013-02-07 04:43:40,2010-02-01 10:32:08,2010-03-10 00:41:37,2564
217,798,1253,2268,"36 days, 14:23:11",2013-02-06 10:43:04,2010-02-01 10:32:08,2010-03-10 00:55:19,6116
65,463,862,1390,"36 days, 14:25:02",2013-02-06 05:59:40,2010-02-01 10:32:08,2010-03-10 00:57:10,2972
28,1308,1348,2684,"36 days, 14:30:30",2013-02-06 07:42:34,2010-02-01 10:32:08,2010-03-10 01:02:38,8576
1152,2328,2319,5799,"36 days, 14:37:01",2013-02-07 03:14:39,2010-02-01 10:32:08,2010-03-10 01:09:09,1918
1070,207,188,1465,"36 days, 14:47:49",2013-02-02 03:38:56,2010-02-01 10:32:08,2010-03-10 01:19:57,173
525,3987,5107,9619,"36 days, 14:50:36",2013-02-07 06:46:20,2010-02-01 10:32:08,2010-03-10 01:22:44,7904
173,314,516,1003,"36 days, 14:56:14",2013-02-07 02:04:41,2010-02-01 10:32:08,2010-03-10 01:28:22,6358
607,8131,7429,16167,"36 days, 15:02:08",2013-02-07 10:47:42,2010-02-01 10:32:08,2010-03-10 01:34:16,430
155,525,1044,1724,"36 days, 15:02:19",2013-02-06 09:43:25,2010-02-01 10:32:08,2010-03-10 01:34:27,4507
1226,4471,4422,10119,"36 days, 15:02:48",2013-02-07 03:14:38,2010-02-01 10:32:08,2010-03-10 01:34:56,8944
262,146,76,484,"36 days, 15:19:13",2013-02-01 07:47:21,2010-02-01 10:32:08,2010-03-10 01:51:21,2394
150,6466,4028,10644,"36 days, 15:28:27",2013-02-13 11:48:29,2010-02-01 10:32:08,2010-03-10 02:00:35,734
222,1583,1827,3632,"36 days, 15:36:40",2013-02-06 10:38:04,2010-02-01 10:32:08,2010-03-10 02:08:48,3018
88,223,569,880,"36 days, 15:40:17",2013-02-04 02:04:51,2010-02-01 10:32:08,2010-03-10 02:12:25,6554
480,4882,5967,11329,"36 days, 15:49:34",2013-02-07 10:46:50,2010-02-01 10:32:08,2010-03-10 02:21:42,9233
52,3092,3666,6810,"36 days, 15:49:38",2013-02-07 10:20:23,2010-02-01 10:32:08,2010-03-10 02:21:46,7892
80,5676,5828,11584,"36 days, 15:50:31",2013-02-07 05:43:31,2010-02-01 10:32:08,2010-03-10 02:22:39,6354
11,571,986,1568,"36 days, 15:51:45",2013-02-07 09:37:59,2010-02-01 10:32:08,2010-03-10 02:23:53,7368
1707,2078,2309,6094,"36 days, 15:58:47",2013-02-06 09:20:05,2010-02-01 10:32:08,2010-03-10 02:30:55,3144
629,169,209,1007,"36 days, 16:02:35",2013-02-07 07:44:53,2010-02-01 10:32:08,2010-03-10 02:34:43,2083
1115,3,117,1235,"36 days, 16:11:26",2013-02-03 04:32:39,2010-02-01 10:32:08,2010-03-10 02:43:34,9915
1490,194,595,2279,"36 days, 16:22:11",2013-02-03 01:02:11,2010-02-01 10:32:08,2010-03-10 02:54:19,58
1270,4673,4375,10318,"36 days, 16:28:30",2013-02-05 10:56:37,2010-02-01 10:32:08,2010-03-10 03:00:38,6504
101,6811,7563,14475,"36 days, 16:28:59",2013-02-07 00:59:43,2010-02-01 10:32:08,2010-03-10 03:01:07,2434
51,3690,3437,7178,"36 days, 16:43:54",2013-02-06 11:34:15,2010-02-01 10:32:08,2010-03-10 03:16:02,9846
0,726,1260,1986,"36 days, 16:49:28",2013-02-04 11:36:10,2010-02-01 10:32:08,2010-03-10 03:21:36,1891
876,960,1328,3164,"36 days, 16:49:31",2013-02-06 00:49:37,2010-02-01 10:32:08,2010-03-10 03:21:39,8622
1153,2503,2619,6275,"36 days, 17:07:01",2013-02-07 05:59:59,2010-02-01 10:32:08,2010-03-10 03:39:09,7081
1497,5998,7821,15316,"36 days, 17:23:03",2013-02-07 11:24:18,2010-02-01 10:32:08,2010-03-10 03:55:11,6665
1411,3002,4419,8832,"36 days, 17:23:38",2013-02-07 08:40:50,2010-02-01 10:32:08,2010-03-10 03:55:46,60
56,1922,2813,4791,"36 days, 17:25:29",2013-02-07 03:38:29,2010-02-01 10:32:08,2010-03-10 03:57:37,7078
830,783,1758,3371,"36 days, 17:43:24",2013-02-05 09:48:28,2010-02-01 10:32:08,2010-03-10 04:15:32,8527
629,1401,1518,3548,"36 days, 17:44:36",2013-02-05 10:55:52,2010-02-01 10:32:08,2010-03-10 04:16:44,9652
647,6930,6795,14372,"36 days, 17:50:59",2013-02-06 08:17:50,2010-02-01 10:32:08,2010-03-10 04:23:07,9579
834,4439,5148,10421,"36 days, 18:18:13",2013-02-07 06:04:44,2010-02-01 10:32:08,2010-03-10 04:50:21,5162
436,2179,4555,7170,"36 days, 18:20:56",2013-02-07 01:28:31,2010-02-01 10:32:08,2010-03-10 04:53:04,8162
197,818,1219,2234,"36 days, 18:35:52",2013-02-07 01:39:07,2010-02-01 10:32:08,2010-03-10 05:08:00,62
17,34,179,230,"36 days, 18:39:50",2013-01-30 08:36:12,2011-01-03 05:26:14,2011-02-09 00:06:04,306
700,314,588,1602,"36 days, 18:53:17",2013-02-03 01:42:25,2010-02-01 10:32:08,2010-03-10 05:25:25,9423
772,2064,2060,4896,"36 days, 19:00:26",2013-02-07 02:37:54,2010-02-01 10:32:08,2010-03-10 05:32:34,1481
1301,9009,7257,17567,"36 days, 19:02:01",2013-02-07 05:22:25,2010-02-01 10:32:08,2010-03-10 05:34:09,4027
45,30,290,365,"36 days, 19:05:24",2013-01-24 10:20:16,2013-01-24 10:20:16,2013-03-02 05:25:40,9899
1279,7475,6277,15031,"36 days, 19:13:35",2013-02-06 08:07:06,2010-02-01 10:32:08,2010-03-10 05:45:43,2209
845,1537,3232,5614,"36 days, 19:29:11",2013-02-05 09:08:38,2010-02-01 10:32:08,2010-03-10 06:01:19,4951
432,676,1720,2828,"36 days, 19:39:06",2013-02-06 09:23:22,2010-02-01 10:32:08,2010-03-10 06:11:14,3451
660,4838,3656,9154,"36 days, 19:45:37",2013-02-06 06:11:37,2010-02-01 10:32:08,2010-03-10 06:17:45,9784
29,568,1411,2008,"36 days, 20:07:38",2013-02-05 11:55:37,2010-02-01 10:32:08,2010-03-10 06:39:46,8068
68,2205,3145,5418,"36 days, 20:09:15",2013-02-03 11:37:47,2010-02-01 10:32:08,2010-03-10 06:41:23,8279
43,1153,2767,3963,"36 days, 20:17:55",2013-02-04 09:31:00,2010-02-01 10:32:08,2010-03-10 06:50:03,4117
444,1355,2253,4052,"36 days, 20:18:40",2013-02-05 04:35:09,2010-02-01 10:32:08,2010-03-10 06:50:48,8968
146,1294,2135,3575,"36 days, 20:31:19",2013-02-07 01:04:05,2010-02-01 10:32:08,2010-03-10 07:03:27,3854
1075,341,1074,2490,"36 days, 20:36:10",2013-01-31 11:37:26,2010-02-01 10:32:08,2010-03-10 07:08:18,8906
211,1151,1795,3157,"36 days, 20:38:00",2013-02-06 02:12:20,2010-03-26 05:24:04,2010-05-02 02:02:04,4331
181,688,1086,1955,"36 days, 20:41:57",2013-02-02 11:45:58,2010-02-01 10:32:08,2010-03-10 07:14:05,8580
37,3210,4192,7439,"36 days, 21:01:08",2013-02-07 02:27:31,2010-03-10 06:46:21,2010-04-16 03:47:29,3870
777,5243,5861,11881,"36 days, 21:18:18",2013-02-06 10:20:45,2010-02-01 10:32:08,2010-03-10 07:50:26,5776
915,4072,5539,10526,"36 days, 21:22:08",2013-02-08 10:49:05,2010-02-01 10:32:08,2010-03-10 07:54:16,1906
559,1466,2062,4087,"36 days, 21:28:03",2013-02-06 09:02:14,2010-02-01 10:32:08,2010-03-10 08:00:11,244
256,1580,2452,4288,"36 days, 21:30:27",2013-02-07 00:04:43,2010-02-01 10:32:08,2010-03-10 08:02:35,3727
170,2527,3831,6528,"36 days, 21:31:03",2013-02-07 10:38:32,2010-02-01 10:32:08,2010-03-10 08:03:11,8200
1760,354,1183,3297,"36 days, 21:40:51",2013-02-05 11:39:55,2010-02-01 10:32:08,2010-03-10 08:12:59,9065
339,462,1094,1895,"36 days, 21:45:29",2013-02-04 09:23:37,2010-02-01 10:32:08,2010-03-10 08:17:37,3833
845,2144,2290,5279,"36 days, 21:53:10",2013-02-06 03:36:59,2010-02-01 10:32:08,2010-03-10 08:25:18,8308
118,1358,2699,4175,"36 days, 22:04:25",2013-02-07 02:14:54,2010-02-01 10:32:08,2010-03-10 08:36:33,805
762,7382,6667,14811,"36 days, 22:05:00",2013-02-06 07:25:09,2010-02-01 10:32:08,2010-03-10 08:37:08,6342
96,1180,1568,2844,"36 days, 22:19:05",2013-02-06 09:45:52,2010-02-01 10:32:08,2010-03-10 08:51:13,8204
1081,2848,4931,8860,"36 days, 22:51:47",2013-02-07 05:28:05,2010-02-01 10:32:08,2010-03-10 09:23:55,859
1462,143,256,1861,"36 days, 22:58:55",2013-02-06 07:23:18,2010-02-01 10:32:08,2010-03-10 09:31:03,5032
262,3588,5843,9693,"36 days, 23:11:32",2013-02-09 10:10:00,2010-02-01 10:32:08,2010-03-10 09:43:40,8478
364,547,1038,1949,"36 days, 23:26:09",2013-02-08 09:52:15,2010-02-01 10:32:08,2010-03-10 09:58:17,4504
2688,4584,8130,15402,"37 days, 0:08:43",2013-02-06 11:28:52,2010-02-01 10:32:08,2010-03-10 10:40:51,5991
1491,2923,2436,6850,"37 days, 0:20:21",2013-02-07 11:28:17,2010-02-01 10:32:08,2010-03-10 10:52:29,6414
314,1208,2084,3606,"37 days, 0:29:23",2013-02-06 06:38:52,2010-02-01 10:32:08,2010-03-10 11:01:31,3202
669,793,1219,2681,"37 days, 0:43:02",2013-02-07 03:00:05,2010-02-01 10:32:08,2010-03-10 11:15:10,9189
236,468,554,1258,"37 days, 0:45:09",2013-02-04 08:48:16,2010-03-01 05:31:55,2010-04-07 06:17:04,3647
711,756,1000,2467,"37 days, 0:45:55",2013-02-12 05:34:27,2010-02-01 10:32:08,2010-03-10 11:18:03,6657
161,6432,5738,12331,"37 days, 0:52:00",2013-02-06 06:55:11,2010-02-01 10:32:08,2010-03-10 11:24:08,6264
172,2467,2249,4888,"37 days, 1:03:07",2013-02-06 10:51:49,2010-02-01 10:32:08,2010-03-10 11:35:15,1468
70,10704,7564,18338,"37 days, 1:11:34",2013-02-07 00:11:24,2010-02-01 10:32:08,2010-03-10 11:43:42,6071
652,17,134,803,"37 days, 1:13:12",2013-02-03 04:20:04,2010-02-01 10:32:08,2010-03-10 11:45:20,5095
525,6516,4798,11839,"37 days, 1:18:11",2013-02-06 09:44:59,2010-02-01 10:32:08,2010-03-10 11:50:19,1069
819,2144,4514,7477,"37 days, 1:23:41",2013-02-06 03:03:03,2010-02-01 10:32:08,2010-03-10 11:55:49,2347
576,52,218,846,"37 days, 1:36:18",2013-02-03 06:59:25,2011-07-17 00:05:05,2011-08-23 01:41:23,4840
26,266,677,969,"37 days, 2:03:33",2013-02-05 02:18:35,2010-03-06 02:07:18,2010-04-12 04:10:51,1975
65,470,900,1435,"37 days, 2:12:48",2013-02-05 03:33:20,2010-05-29 04:20:44,2010-07-05 06:33:32,1016
500,1579,1707,3786,"37 days, 3:32:39",2013-02-06 00:16:53,2010-02-11 06:31:31,2010-03-20 10:04:10,7935
1358,4091,5470,10919,"37 days, 5:11:04",2013-02-06 09:41:08,2010-02-19 00:47:53,2010-03-28 05:58:57,7903
1005,36,106,1147,"37 days, 5:19:29",2013-01-28 07:05:54,2010-11-26 03:36:02,2011-01-02 08:55:31,3938
293,1759,3177,5229,"37 days, 6:00:27",2013-02-07 04:28:06,2010-03-19 03:19:15,2010-04-25 09:19:42,2186
356,45,144,545,"37 days, 13:30:02",2013-02-07 02:41:12,2010-02-01 10:32:08,2010-03-11 00:02:10,3954
1528,1760,2898,6186,"37 days, 13:36:53",2013-02-05 03:02:49,2010-02-01 10:32:08,2010-03-11 00:09:01,4986
312,955,1335,2602,"37 days, 13:42:15",2013-02-06 00:32:19,2010-02-01 10:32:08,2010-03-11 00:14:23,3663
285,1048,1896,3229,"37 days, 13:54:13",2013-02-07 02:28:59,2010-02-01 10:32:08,2010-03-11 00:26:21,3841
30,127,275,432,"37 days, 14:05:48",2013-02-02 02:30:18,2010-02-01 10:32:08,2010-03-11 00:37:56,9940
79,3338,3187,6604,"37 days, 14:07:32",2013-02-20 09:03:32,2010-02-01 10:32:08,2010-03-11 00:39:40,2629
342,4141,4137,8620,"37 days, 14:07:57",2013-02-07 05:34:28,2010-02-01 10:32:08,2010-03-11 00:40:05,1676
103,3990,3446,7539,"37 days, 14:15:15",2013-02-07 06:39:09,2010-02-01 10:32:08,2010-03-11 00:47:23,4100
324,159,523,1006,"37 days, 14:22:05",2013-02-05 06:57:21,2010-02-01 10:32:08,2010-03-11 00:54:13,8705
929,8490,9709,19128,"37 days, 14:31:54",2013-02-07 08:44:21,2010-02-01 10:32:08,2010-03-11 01:04:02,7058
446,1444,1882,3772,"37 days, 14:38:33",2013-02-07 02:10:27,2010-02-01 10:32:08,2010-03-11 01:10:41,1551
287,3042,6127,9456,"37 days, 14:42:05",2013-02-07 00:47:35,2010-02-01 10:32:08,2010-03-11 01:14:13,3420
478,1252,2014,3744,"37 days, 14:44:30",2013-02-05 04:41:25,2010-02-01 10:32:08,2010-03-11 01:16:38,5831
260,3678,5352,9290,"37 days, 14:47:08",2013-02-06 10:06:29,2010-02-01 10:32:08,2010-03-11 01:19:16,9755
258,612,997,1867,"37 days, 14:48:13",2013-02-06 09:22:10,2010-02-01 10:32:08,2010-03-11 01:20:21,3810
116,3156,4555,7827,"37 days, 15:07:15",2013-02-06 11:06:20,2010-02-01 10:32:08,2010-03-11 01:39:23,7091
80,1241,1109,2430,"37 days, 15:11:36",2013-02-05 01:08:04,2010-02-01 10:32:08,2010-03-11 01:43:44,8310
1148,680,903,2731,"37 days, 15:12:12",2013-02-06 04:27:32,2010-02-01 10:32:08,2010-03-11 01:44:20,8423
321,1152,2014,3487,"37 days, 15:22:07",2013-02-04 09:27:42,2010-02-01 10:32:08,2010-03-11 01:54:15,3242
946,3088,3058,7092,"37 days, 15:33:06",2013-02-06 08:27:33,2010-02-01 10:32:08,2010-03-11 02:05:14,3853
1193,3275,4050,8518,"37 days, 15:41:15",2013-02-19 07:03:11,2010-02-01 10:32:08,2010-03-11 02:13:23,8904
1041,1795,2390,5226,"37 days, 15:47:01",2013-02-06 01:50:41,2010-02-01 10:32:08,2010-03-11 02:19:09,3788
16,415,538,969,"37 days, 15:56:33",2013-02-05 04:09:30,2010-02-01 10:32:08,2010-03-11 02:28:41,2677
142,2518,4206,6866,"37 days, 16:03:28",2013-02-06 07:51:34,2010-02-01 10:32:08,2010-03-11 02:35:36,1955
1586,2366,2576,6528,"37 days, 16:06:03",2013-02-06 03:48:28,2010-02-01 10:32:08,2010-03-11 02:38:11,5165
1034,1337,2329,4700,"37 days, 16:27:28",2013-02-06 02:50:40,2010-02-01 10:32:08,2010-03-11 02:59:36,8643
2605,8382,10599,21586,"37 days, 16:32:07",2013-02-06 10:46:32,2010-02-01 10:32:08,2010-03-11 03:04:15,2689
706,6568,5469,12743,"37 days, 16:43:35",2013-02-07 06:46:56,2010-02-01 10:32:08,2010-03-11 03:15:43,1127
479,9025,9083,18587,"37 days, 16:51:24",2013-02-07 10:04:42,2010-02-01 10:32:08,2010-03-11 03:23:32,3276
823,157,474,1454,"37 days, 16:54:57",2013-02-02 10:16:33,2010-02-01 10:32:08,2010-03-11 03:27:05,1313
62,858,933,1853,"37 days, 16:57:10",2013-02-04 07:25:02,2010-02-01 10:32:08,2010-03-11 03:29:18,2812
319,316,724,1359,"37 days, 17:05:06",2013-02-05 11:29:35,2010-02-01 10:32:08,2010-03-11 03:37:14,3064
1054,985,1815,3854,"37 days, 17:07:42",2013-02-07 06:24:05,2010-02-01 10:32:08,2010-03-11 03:39:50,2927
450,211,361,1022,"37 days, 17:09:09",2013-02-06 07:13:59,2010-02-01 10:32:08,2010-03-11 03:41:17,1420
124,5131,4873,10128,"37 days, 17:16:34",2013-02-06 04:32:38,2010-02-01 10:32:08,2010-03-11 03:48:42,3770
50,416,808,1274,"37 days, 17:23:38",2013-02-05 08:18:25,2010-02-01 10:32:08,2010-03-11 03:55:46,2507
962,3195,2681,6838,"37 days, 17:39:33",2013-02-07 00:05:09,2010-02-01 10:32:08,2010-03-11 04:11:41,9093
523,105,409,1037,"37 days, 17:46:15",2013-01-31 06:18:38,2010-02-01 10:32:08,2010-03-11 04:18:23,1306
1054,11,9,1074,"37 days, 18:03:43",2013-02-01 00:55:31,2011-04-24 06:03:13,2011-06-01 00:06:56,332
54,2410,2672,5136,"37 days, 18:23:18",2013-02-05 01:10:45,2010-02-01 10:32:08,2010-03-11 04:55:26,7791
416,2050,2747,5213,"37 days, 18:24:04",2013-02-06 04:40:37,2010-02-01 10:32:08,2010-03-11 04:56:12,9904
184,2,125,311,"37 days, 18:31:23",2013-01-29 08:49:15,2010-02-01 10:32:08,2010-03-11 05:03:31,2376
653,1235,1888,3776,"37 days, 18:31:57",2013-02-06 08:29:16,2010-02-01 10:32:08,2010-03-11 05:04:05,586
256,1042,1735,3033,"37 days, 18:38:24",2013-02-07 04:24:07,2010-02-01 10:32:08,2010-03-11 05:10:32,4062
77,6521,7032,13630,"37 days, 18:59:18",2013-02-06 10:06:16,2010-02-01 10:32:08,2010-03-11 05:31:26,1266
57,1680,1891,3628,"37 days, 19:15:36",2013-02-04 11:57:14,2010-02-01 10:32:08,2010-03-11 05:47:44,9180
91,463,1027,1581,"37 days, 20:01:47",2013-02-07 03:37:03,2010-02-01 10:32:08,2010-03-11 06:33:55,2392
1781,3654,2988,8423,"37 days, 20:06:12",2013-02-07 08:18:53,2010-02-01 10:32:08,2010-03-11 06:38:20,3807
1089,486,1226,2801,"37 days, 20:50:05",2013-02-07 00:49:34,2010-02-01 10:32:08,2010-03-11 07:22:13,3171
43,1841,1963,3847,"37 days, 20:51:52",2013-02-06 01:57:47,2010-02-01 10:32:08,2010-03-11 07:24:00,3132
954,3887,5170,10011,"37 days, 20:53:41",2013-02-07 05:56:59,2010-02-12 08:29:58,2010-03-22 05:23:39,9192
1838,821,1939,4598,"37 days, 20:54:17",2013-02-05 11:51:45,2010-02-01 10:32:08,2010-03-11 07:26:25,6842
2098,5604,6807,14509,"37 days, 21:01:48",2013-02-26 01:49:11,2010-02-01 10:32:08,2010-03-11 07:33:56,7712
106,10,114,230,"37 days, 21:22:22",2013-01-30 11:58:25,2011-01-12 10:50:58,2011-02-19 08:13:20,8943
1425,7034,6778,15237,"37 days, 21:24:28",2013-02-06 10:28:32,2010-02-01 10:32:08,2010-03-11 07:56:36,5649
2276,5493,6329,14098,"37 days, 21:34:57",2013-02-11 07:48:35,2010-02-01 10:32:08,2010-03-11 08:07:05,6209
4,834,915,1753,"37 days, 21:36:02",2013-02-04 07:26:54,2010-02-01 10:32:08,2010-03-11 08:08:10,3307
90,4404,5227,9721,"37 days, 21:42:55",2013-02-07 02:38:24,2010-02-28 10:56:15,2010-04-07 08:39:10,415
1352,4137,4391,9880,"37 days, 21:52:04",2013-02-07 11:59:52,2010-02-01 10:32:08,2010-03-11 08:24:12,6540
832,3145,4717,8694,"37 days, 22:06:15",2013-02-07 04:16:52,2010-02-01 10:32:08,2010-03-11 08:38:23,9920
1394,1442,2489,5325,"37 days, 22:11:53",2013-02-07 03:43:45,2010-02-01 10:32:08,2010-03-11 08:44:01,7200
669,3078,3259,7006,"37 days, 22:15:36",2013-02-05 09:04:51,2010-02-01 10:32:08,2010-03-11 08:47:44,297
244,6219,3930,10393,"37 days, 22:18:43",2013-02-07 06:38:37,2010-02-01 10:32:08,2010-03-11 08:50:51,3922
439,32,377,848,"37 days, 22:23:13",2013-02-06 11:32:49,2010-03-17 08:39:54,2010-04-24 07:03:07,5943
365,317,468,1150,"37 days, 22:32:38",2013-02-05 02:07:09,2010-02-01 10:32:08,2010-03-11 09:04:46,20
373,1624,2252,4249,"37 days, 22:36:40",2013-02-04 08:21:10,2010-02-01 10:32:08,2010-03-11 09:08:48,9728
91,100,492,683,"37 days, 22:39:52",2013-02-01 05:48:28,2010-02-01 10:32:08,2010-03-11 09:12:00,8323
1620,1396,2104,5120,"37 days, 22:49:53",2013-02-05 07:20:24,2010-02-01 10:32:08,2010-03-11 09:22:01,7722
730,3,20,753,"37 days, 22:53:16",2013-01-26 06:26:46,2010-07-09 01:46:53,2010-08-16 00:40:09,2227
230,1588,3459,5277,"37 days, 23:08:02",2013-02-06 06:46:46,2010-02-01 10:32:08,2010-03-11 09:40:10,8549
1292,171,178,1641,"37 days, 23:10:32",2013-01-31 11:07:01,2010-02-01 10:32:08,2010-03-11 09:42:40,4076
425,61,181,667,"37 days, 23:10:51",2013-02-07 11:00:17,2010-02-01 10:32:08,2010-03-11 09:42:59,3972
415,2919,3985,7319,"37 days, 23:13:14",2013-02-06 08:09:39,2010-02-01 10:32:08,2010-03-11 09:45:22,4021
146,68,291,505,"37 days, 23:15:44",2013-02-04 10:57:03,2010-02-01 10:32:08,2010-03-11 09:47:52,7416
2214,8178,7948,18340,"37 days, 23:17:19",2013-02-06 10:25:58,2010-02-01 10:32:08,2010-03-11 09:49:27,8997
585,1334,1697,3616,"37 days, 23:48:18",2013-02-04 10:20:49,2010-02-01 10:32:08,2010-03-11 10:20:26,5366
945,2,79,1026,"37 days, 23:50:50",2013-02-06 02:06:00,2010-10-14 02:35:56,2010-11-21 02:26:46,3702
19,1980,2418,4417,"38 days, 0:00:36",2013-02-06 06:34:40,2010-02-01 10:32:08,2010-03-11 10:32:44,6103
111,600,1072,1783,"38 days, 0:14:57",2013-02-06 10:03:17,2010-02-26 02:42:24,2010-04-05 02:57:21,567
114,1254,2476,3844,"38 days, 0:25:47",2013-02-07 07:00:00,2010-02-01 10:32:08,2010-03-11 10:57:55,836
199,549,894,1642,"38 days, 0:44:27",2013-02-06 09:48:35,2010-02-01 10:32:08,2010-03-11 11:16:35,2371
1071,4679,4239,9989,"38 days, 0:59:58",2013-02-06 10:06:51,2010-02-01 10:32:08,2010-03-11 11:32:06,1833
343,5185,4624,10152,"38 days, 1:05:06",2013-02-07 08:01:56,2010-02-01 10:32:08,2010-03-11 11:37:14,7995
341,186,485,1012,"38 days, 1:12:19",2013-02-03 10:44:24,2010-02-01 10:32:08,2010-03-11 11:44:27,7486
593,427,917,1937,"38 days, 1:15:42",2013-02-03 00:51:11,2010-02-01 10:32:08,2010-03-11 11:47:50,1358
284,1228,1296,2808,"38 days, 1:20:58",2013-02-04 02:21:22,2010-02-01 10:32:08,2010-03-11 11:53:06,5253
117,560,925,1602,"38 days, 1:21:01",2013-02-06 09:11:29,2010-02-01 10:32:08,2010-03-11 11:53:09,3926
372,11,92,475,"38 days, 2:18:42",2013-02-03 11:12:31,2011-12-20 05:44:18,2012-01-27 08:03:00,1323
190,1011,1007,2208,"38 days, 2:34:15",2013-02-05 09:15:17,2010-03-02 08:54:33,2010-04-09 11:28:48,5270
644,13,88,745,"38 days, 2:39:51",2013-01-30 08:33:09,2010-08-11 06:44:35,2010-09-18 09:24:26,3072
434,1181,2400,4015,"38 days, 3:07:21",2013-02-06 05:53:14,2010-03-10 06:38:06,2010-04-17 09:45:27,4531
517,288,825,1630,"38 days, 4:08:28",2013-02-07 07:06:45,2010-04-22 03:53:14,2010-05-30 08:01:42,613
30,34,114,178,"38 days, 4:27:22",2013-01-31 04:55:45,2012-03-17 02:49:03,2012-04-24 07:16:25,8245
1124,0,12,1136,"38 days, 6:39:37",2013-01-30 00:18:04,2011-02-02 05:18:29,2011-03-12 11:58:06,1850
183,152,619,954,"38 days, 12:15:17",2013-02-04 09:11:07,2010-05-20 11:54:56,2010-06-28 00:10:13,1777
161,5450,5977,11588,"38 days, 14:17:59",2013-02-06 05:40:17,2010-02-01 10:32:08,2010-03-12 00:50:07,3299
1042,0,27,1069,"38 days, 14:32:42",2013-02-02 06:59:40,2010-03-18 09:41:02,2010-04-26 00:13:44,6937
537,186,774,1497,"38 days, 14:37:30",2013-02-05 07:20:18,2010-02-01 10:32:08,2010-03-12 01:09:38,779
403,350,610,1363,"38 days, 14:49:00",2013-02-05 07:04:06,2010-02-01 10:32:08,2010-03-12 01:21:08,9936
1327,3907,4043,9277,"38 days, 14:53:27",2013-02-06 10:32:35,2010-02-01 10:32:08,2010-03-12 01:25:35,4796
550,908,1429,2887,"38 days, 15:01:08",2013-02-06 02:18:32,2010-02-01 10:32:08,2010-03-12 01:33:16,4553
197,174,352,723,"38 days, 15:09:43",2013-02-04 09:36:27,2010-02-01 10:32:08,2010-03-12 01:41:51,1301
357,2224,4116,6697,"38 days, 15:31:28",2013-02-07 01:29:15,2010-02-01 10:32:08,2010-03-12 02:03:36,1976
832,429,782,2043,"38 days, 15:32:40",2013-02-06 06:07:16,2010-02-27 08:52:51,2010-04-07 00:25:31,8336
9,99,172,280,"38 days, 15:33:41",2013-01-31 06:13:16,2010-02-01 10:32:08,2010-03-12 02:05:49,4459
306,5833,3317,9456,"38 days, 15:51:55",2013-02-06 04:42:14,2010-02-01 10:32:08,2010-03-12 02:24:03,8090
1280,264,549,2093,"38 days, 16:03:13",2013-02-02 06:52:35,2010-02-01 10:32:08,2010-03-12 02:35:21,1617
68,296,695,1059,"38 days, 16:08:23",2013-02-06 06:01:01,2010-04-19 09:15:12,2010-05-28 01:23:35,8995
13,2426,2943,5382,"38 days, 16:32:05",2013-02-06 05:35:44,2010-02-01 10:32:08,2010-03-12 03:04:13,6587
191,1966,2654,4811,"38 days, 16:36:23",2013-02-06 09:40:18,2010-02-01 10:32:08,2010-03-12 03:08:31,6609
1453,218,571,2242,"38 days, 16:39:30",2013-02-05 11:34:53,2010-02-01 10:32:08,2010-03-12 03:11:38,2335
756,1670,2846,5272,"38 days, 16:45:32",2013-02-05 07:15:44,2010-02-01 10:32:08,2010-03-12 03:17:40,1192
1579,2817,2967,7363,"38 days, 16:45:39",2013-02-07 06:26:08,2010-02-01 10:32:08,2010-03-12 03:17:47,5904
1411,377,805,2593,"38 days, 16:50:46",2013-02-05 08:40:49,2010-02-01 10:32:08,2010-03-12 03:22:54,6794
1682,7783,6763,16228,"38 days, 16:54:01",2013-02-07 02:49:09,2010-02-01 10:32:08,2010-03-12 03:26:09,3450
671,2780,3524,6975,"38 days, 17:25:34",2013-02-09 07:37:01,2010-02-01 10:32:08,2010-03-12 03:57:42,2343
531,292,988,1811,"38 days, 17:38:03",2013-02-05 09:27:53,2010-02-01 10:32:08,2010-03-12 04:10:11,4134
1404,1203,1394,4001,"38 days, 17:39:39",2013-02-05 04:47:50,2010-02-01 10:32:08,2010-03-12 04:11:47,8621
510,3777,4993,9280,"38 days, 17:49:53",2013-02-07 06:04:09,2010-02-01 10:32:08,2010-03-12 04:22:01,4196
571,4358,3980,8909,"38 days, 17:58:31",2013-02-06 11:21:42,2010-02-01 10:32:08,2010-03-12 04:30:39,1236
1443,4107,4330,9880,"38 days, 17:58:35",2013-02-08 04:03:23,2010-02-01 10:32:08,2010-03-12 04:30:43,4583
753,254,449,1456,"38 days, 18:06:59",2013-02-06 01:38:14,2010-02-01 10:32:08,2010-03-12 04:39:07,6874
206,2130,3724,6060,"38 days, 18:10:40",2013-02-07 06:12:31,2010-02-18 11:47:53,2010-03-29 05:58:33,8416
646,2393,4198,7237,"38 days, 18:15:19",2013-02-06 11:31:43,2010-02-01 10:32:08,2010-03-12 04:47:27,1189
756,2208,3193,6157,"38 days, 18:32:01",2013-02-05 09:34:22,2010-02-01 10:32:08,2010-03-12 05:04:09,4895
542,1589,1547,3678,"38 days, 18:35:09",2013-02-04 09:39:43,2010-02-01 10:32:08,2010-03-12 05:07:17,16
1236,616,1232,3084,"38 days, 18:44:46",2013-02-05 11:26:26,2010-03-06 10:00:36,2010-04-14 04:45:22,264
2191,2870,4950,10011,"38 days, 18:46:10",2013-02-07 09:44:18,2010-02-01 10:32:08,2010-03-12 05:18:18,2653
257,36,224,517,"38 days, 18:50:44",2013-02-05 01:06:34,2010-02-01 10:32:08,2010-03-12 05:22:52,8948
223,2144,4471,6838,"38 days, 18:54:56",2013-02-05 09:46:39,2010-02-01 10:32:08,2010-03-12 05:27:04,4173
218,97,215,530,"38 days, 19:00:37",2013-01-22 10:25:03,2013-01-22 10:25:03,2013-03-02 05:25:40,1670
962,388,643,1993,"38 days, 19:02:17",2013-02-04 08:53:35,2010-02-01 10:32:08,2010-03-12 05:34:25,6120
1002,2700,2780,6482,"38 days, 19:04:18",2013-02-06 10:09:22,2010-02-01 10:32:08,2010-03-12 05:36:26,7865
569,6011,7539,14119,"38 days, 19:32:32",2013-02-07 03:49:59,2010-02-01 10:32:08,2010-03-12 06:04:40,5901
855,52,256,1163,"38 days, 20:18:39",2013-02-01 09:31:54,2010-02-01 10:32:08,2010-03-12 06:50:47,7958
157,225,554,936,"38 days, 20:19:07",2013-01-30 11:35:55,2010-02-01 10:32:08,2010-03-12 06:51:15,1345
17,733,1752,2502,"38 days, 20:20:31",2013-02-06 11:53:28,2010-02-01 10:32:08,2010-03-12 06:52:39,6718
598,173,527,1298,"38 days, 20:21:18",2013-02-06 04:17:44,2010-02-01 10:32:08,2010-03-12 06:53:26,3116
1122,54,372,1548,"38 days, 20:33:54",2013-02-05 05:52:01,2010-02-01 10:32:08,2010-03-12 07:06:02,8877
1202,5817,5387,12406,"38 days, 20:36:14",2013-02-07 05:15:55,2010-02-01 10:32:08,2010-03-12 07:08:22,5348
200,1612,1623,3435,"38 days, 20:37:06",2013-02-06 05:32:25,2010-02-01 10:32:08,2010-03-12 07:09:14,9553
378,653,1272,2303,"38 days, 20:42:32",2013-02-05 04:56:58,2010-02-01 10:32:08,2010-03-12 07:14:40,8055
733,3644,3612,7989,"38 days, 20:44:50",2013-02-06 11:34:08,2010-02-01 10:32:08,2010-03-12 07:16:58,2242
2655,7971,6971,17597,"38 days, 20:46:14",2013-02-06 03:41:35,2010-02-01 10:32:08,2010-03-12 07:18:22,4795
144,226,627,997,"38 days, 20:56:04",2013-02-06 03:51:57,2010-02-01 10:32:08,2010-03-12 07:28:12,6370
41,1004,1446,2491,"38 days, 21:07:00",2013-02-06 01:50:01,2010-02-01 10:32:08,2010-03-12 07:39:08,2759
1321,1,56,1378,"38 days, 21:10:21",2013-01-29 11:00:59,2010-02-01 10:32:08,2010-03-12 07:42:29,4847
348,200,426,974,"38 days, 21:12:53",2013-02-02 06:56:43,2010-02-01 10:32:08,2010-03-12 07:45:01,3002
31,1614,2203,3848,"38 days, 21:25:24",2013-02-07 05:06:52,2010-02-01 10:32:08,2010-03-12 07:57:32,892
1379,874,1374,3627,"38 days, 21:29:00",2013-02-06 08:03:02,2010-02-01 10:32:08,2010-03-12 08:01:08,110
106,1393,1134,2633,"38 days, 21:35:42",2013-02-06 09:24:55,2010-02-01 10:32:08,2010-03-12 08:07:50,4921
18,2997,2841,5856,"38 days, 21:51:02",2013-02-07 01:46:18,2010-02-01 10:32:08,2010-03-12 08:23:10,6037
215,828,1351,2394,"38 days, 22:00:09",2013-02-05 11:55:01,2010-02-01 10:32:08,2010-03-12 08:32:17,4817
220,500,1126,1846,"38 days, 22:00:44",2013-02-07 01:17:26,2010-04-04 04:01:40,2010-05-13 02:02:24,5373
384,525,732,1641,"38 days, 22:01:55",2013-02-06 05:07:13,2010-02-01 10:32:08,2010-03-12 08:34:03,8696
1291,1273,1261,3825,"38 days, 22:17:32",2013-02-07 00:45:37,2010-02-01 10:32:08,2010-03-12 08:49:40,643
169,1970,2282,4421,"38 days, 22:28:49",2013-02-06 06:11:08,2010-02-01 10:32:08,2010-03-12 09:00:57,6738
364,472,582,1418,"38 days, 22:53:04",2013-01-31 06:43:22,2010-02-01 10:32:08,2010-03-12 09:25:12,5578
718,264,907,1889,"38 days, 22:59:56",2013-02-07 02:51:05,2010-02-01 10:32:08,2010-03-12 09:32:04,4231
669,1827,2166,4662,"38 days, 23:00:29",2013-02-05 00:59:44,2010-02-01 10:32:08,2010-03-12 09:32:37,2174
832,265,367,1464,"38 days, 23:00:30",2013-01-28 07:30:44,2010-02-01 10:32:08,2010-03-12 09:32:38,2606
462,2059,2932,5453,"38 days, 23:03:38",2013-02-16 11:30:48,2010-02-01 10:32:08,2010-03-12 09:35:46,738
186,3700,4447,8333,"38 days, 23:14:53",2013-02-11 11:20:04,2010-02-01 10:32:08,2010-03-12 09:47:01,3105
667,999,1332,2998,"38 days, 23:15:46",2013-02-07 02:28:32,2010-04-16 08:44:41,2010-05-25 08:00:27,4894
327,1738,2211,4276,"38 days, 23:25:16",2013-02-06 10:36:35,2010-02-01 10:32:08,2010-03-12 09:57:24,6945
590,5796,4567,10953,"38 days, 23:26:49",2013-02-07 01:20:01,2010-02-01 10:32:08,2010-03-12 09:58:57,3421
54,855,1609,2518,"38 days, 23:35:25",2013-02-06 03:12:21,2010-02-01 10:32:08,2010-03-12 10:07:33,7752
783,2987,3294,7064,"38 days, 23:37:14",2013-02-05 00:47:17,2010-02-01 10:32:08,2010-03-12 10:09:22,1187
1287,720,1262,3269,"38 days, 23:41:18",2013-02-06 08:05:59,2010-02-01 10:32:08,2010-03-12 10:13:26,369
501,950,1708,3159,"38 days, 23:50:27",2013-02-05 09:50:14,2010-02-01 10:32:08,2010-03-12 10:22:35,9358
340,1178,1500,3018,"39 days, 0:05:55",2013-02-07 00:45:33,2010-02-01 10:32:08,2010-03-12 10:38:03,6360
745,43,174,962,"39 days, 0:07:53",2013-02-02 10:26:56,2010-02-01 10:32:08,2010-03-12 10:40:01,4890
652,655,926,2233,"39 days, 0:10:41",2013-02-06 06:23:34,2010-02-01 10:32:08,2010-03-12 10:42:49,9431
318,2854,3728,6900,"39 days, 0:12:55",2013-02-06 09:39:02,2010-02-01 10:32:08,2010-03-12 10:45:03,9918
328,2565,2888,5781,"39 days, 0:35:35",2013-02-07 11:30:37,2010-02-01 10:32:08,2010-03-12 11:07:43,1335
411,1763,3260,5434,"39 days, 0:47:49",2013-02-07 02:51:38,2010-02-01 10:32:08,2010-03-12 11:19:57,8972
479,223,564,1266,"39 days, 0:49:18",2013-02-06 07:00:17,2010-02-01 10:32:08,2010-03-12 11:21:26,1431
66,223,655,944,"39 days, 0:50:00",2013-02-06 11:01:23,2010-02-01 10:32:08,2010-03-12 11:22:08,3553
1442,3969,5206,10617,"39 days, 0:51:13",2013-02-06 07:40:24,2010-02-01 10:32:08,2010-03-12 11:23:21,2578
121,798,1152,2071,"39 days, 0:53:46",2013-02-06 10:14:47,2010-02-01 10:32:08,2010-03-12 11:25:54,4177
257,330,517,1104,"39 days, 0:54:32",2013-02-02 05:30:52,2010-02-01 10:32:08,2010-03-12 11:26:40,2166
1018,5256,5713,11987,"39 days, 1:00:43",2013-02-06 10:35:14,2010-02-01 10:32:08,2010-03-12 11:32:51,1811
537,6780,7579,14896,"39 days, 1:01:18",2013-02-06 08:07:03,2010-02-01 10:32:08,2010-03-12 11:33:26,804
1240,189,930,2359,"39 days, 1:02:40",2013-02-03 08:45:06,2010-02-01 10:32:08,2010-03-12 11:34:48,7163
883,4152,4363,9398,"39 days, 1:22:42",2013-02-07 03:58:17,2010-02-01 10:32:08,2010-03-12 11:54:50,2142
103,415,680,1198,"39 days, 1:47:46",2013-02-05 05:42:09,2010-02-22 09:44:48,2010-04-02 11:32:34,2786
1144,5509,6473,13126,"39 days, 2:03:31",2013-02-07 09:11:40,2010-02-13 06:19:50,2010-03-24 08:23:21,4490
22,12,579,613,"39 days, 4:14:05",2013-02-02 00:03:53,2011-02-17 01:54:19,2011-03-28 06:08:24,7505
644,197,418,1259,"39 days, 5:48:06",2013-02-03 08:27:40,2010-05-10 04:16:37,2010-06-18 10:04:43,5894
1550,0,2,1552,"39 days, 10:14:02",2013-01-24 08:39:33,2011-12-03 00:36:48,2012-01-11 10:50:50,4182
117,4694,5384,10195,"39 days, 13:29:59",2013-02-07 10:59:24,2010-02-01 10:32:08,2010-03-13 00:02:07,3104
924,3545,4276,8745,"39 days, 13:33:03",2013-02-06 10:50:59,2010-02-01 10:32:08,2010-03-13 00:05:11,635
277,678,899,1854,"39 days, 13:36:48",2013-02-04 05:32:56,2010-02-01 10:32:08,2010-03-13 00:08:56,8258
1556,5030,5502,12088,"39 days, 13:42:26",2013-02-05 00:18:26,2010-02-01 10:32:08,2010-03-13 00:14:34,1710
621,494,1020,2135,"39 days, 13:47:27",2013-02-03 07:37:47,2010-02-01 10:32:08,2010-03-13 00:19:35,4563
170,2117,3019,5306,"39 days, 13:52:05",2013-02-09 04:56:34,2010-02-01 10:32:08,2010-03-13 00:24:13,7339
562,8435,8795,17792,"39 days, 14:03:39",2013-02-07 03:22:34,2010-02-01 10:32:08,2010-03-13 00:35:47,4956
382,5167,5613,11162,"39 days, 14:28:10",2013-02-07 09:02:55,2010-02-01 10:32:08,2010-03-13 01:00:18,3860
80,94,461,635,"39 days, 14:44:04",2013-02-01 07:05:42,2010-09-14 11:51:12,2010-10-24 02:35:16,7744
872,5747,5438,12057,"39 days, 15:16:09",2013-02-07 07:51:42,2010-02-01 10:32:08,2010-03-13 01:48:17,1997
1117,3209,3406,7732,"39 days, 15:19:54",2013-02-06 01:37:20,2010-02-01 10:32:08,2010-03-13 01:52:02,4116
1909,1341,1792,5042,"39 days, 15:30:11",2013-02-07 09:25:21,2010-02-01 10:32:08,2010-03-13 02:02:19,2035
407,7533,5646,13586,"39 days, 15:33:14",2013-02-07 01:44:18,2010-02-01 10:32:08,2010-03-13 02:05:22,2033
231,621,924,1776,"39 days, 15:40:22",2013-02-03 03:23:10,2010-02-01 10:32:08,2010-03-13 02:12:30,719
719,638,1844,3201,"39 days, 15:46:02",2013-02-06 10:25:22,2010-02-01 10:32:08,2010-03-13 02:18:10,9780
2179,1212,1359,4750,"39 days, 15:51:41",2013-02-07 02:44:36,2010-02-01 10:32:08,2010-03-13 02:23:49,9653
307,2432,2760,5499,"39 days, 16:17:57",2013-02-09 04:24:16,2010-02-01 10:32:08,2010-03-13 02:50:05,2798
1470,4215,5222,10907,"39 days, 16:28:19",2013-02-06 11:23:39,2010-02-01 10:32:08,2010-03-13 03:00:27,5488
916,2210,4981,8107,"39 days, 16:37:05",2013-02-07 06:40:07,2010-02-01 10:32:08,2010-03-13 03:09:13,8975
55,641,1273,1969,"39 days, 16:39:11",2013-02-05 11:28:57,2010-02-01 10:32:08,2010-03-13 03:11:19,8449
859,585,730,2174,"39 days, 16:53:39",2013-02-02 04:42:19,2010-02-01 10:32:08,2010-03-13 03:25:47,5498
192,381,754,1327,"39 days, 16:55:11",2013-02-03 08:58:29,2010-02-01 10:32:08,2010-03-13 03:27:19,5688
381,635,960,1976,"39 days, 17:00:35",2013-02-07 07:08:53,2010-02-01 10:32:08,2010-03-13 03:32:43,3349
194,1141,2321,3656,"39 days, 17:10:27",2013-02-05 08:52:46,2010-02-01 10:32:08,2010-03-13 03:42:35,5515
480,1387,1929,3796,"39 days, 17:14:28",2013-02-04 11:59:19,2010-02-01 10:32:08,2010-03-13 03:46:36,3953
530,3649,4279,8458,"39 days, 17:24:33",2013-02-07 11:22:03,2010-02-01 10:32:08,2010-03-13 03:56:41,2986
100,982,1515,2597,"39 days, 17:44:12",2013-02-04 00:16:17,2010-02-01 10:32:08,2010-03-13 04:16:20,8811
184,3210,2750,6144,"39 days, 17:49:48",2013-02-07 05:31:08,2010-02-01 10:32:08,2010-03-13 04:21:56,2659
342,3223,4140,7705,"39 days, 17:57:33",2013-02-06 02:05:04,2010-02-01 10:32:08,2010-03-13 04:29:41,8409
297,516,893,1706,"39 days, 18:03:31",2013-02-03 07:24:41,2010-05-03 08:06:35,2010-06-12 02:10:06,5979
13,771,1616,2400,"39 days, 18:05:55",2013-02-07 03:55:51,2010-02-01 10:32:08,2010-03-13 04:38:03,9445
1555,4031,4907,10493,"39 days, 18:14:48",2013-02-06 05:02:50,2010-02-01 10:32:08,2010-03-13 04:46:56,1568
774,584,1594,2952,"39 days, 18:17:12",2013-02-04 11:31:17,2010-02-01 10:32:08,2010-03-13 04:49:20,9264
8,363,467,838,"39 days, 18:25:02",2013-02-06 04:13:25,2010-02-01 10:32:08,2010-03-13 04:57:10,3885
207,1191,2313,3711,"39 days, 18:29:24",2013-02-06 11:22:35,2010-02-01 10:32:08,2010-03-13 05:01:32,3736
1372,2345,3359,7076,"39 days, 18:29:28",2013-02-07 06:24:07,2010-02-01 10:32:08,2010-03-13 05:01:36,4208
68,7820,6505,14393,"39 days, 18:34:26",2013-02-06 04:30:41,2010-02-01 10:32:08,2010-03-13 05:06:34,2827
204,231,525,960,"39 days, 18:53:57",2013-02-05 07:35:23,2010-02-01 10:32:08,2010-03-13 05:26:05,3554
713,5842,8930,15485,"39 days, 19:16:29",2013-02-08 07:16:48,2010-02-01 10:32:08,2010-03-13 05:48:37,7443
638,635,1745,3018,"39 days, 19:35:59",2013-02-05 11:03:56,2010-02-01 10:32:08,2010-03-13 06:08:07,7624
232,524,372,1128,"39 days, 19:41:40",2013-02-05 06:25:59,2010-02-01 10:32:08,2010-03-13 06:13:48,2924
124,637,1094,1855,"39 days, 19:49:55",2013-02-03 06:30:53,2010-02-01 10:32:08,2010-03-13 06:22:03,1540
771,893,1344,3008,"39 days, 20:27:22",2013-02-07 04:08:35,2010-02-01 10:32:08,2010-03-13 06:59:30,4892
214,134,226,574,"39 days, 20:30:57",2013-02-06 01:10:16,2010-02-01 10:32:08,2010-03-13 07:03:05,5511
569,1160,1810,3539,"39 days, 20:36:50",2013-02-05 10:05:04,2010-02-01 10:32:08,2010-03-13 07:08:58,5857
118,272,717,1107,"39 days, 20:45:27",2013-02-04 11:49:12,2010-02-01 10:32:08,2010-03-13 07:17:35,7941
211,788,1503,2502,"39 days, 20:49:58",2013-02-07 05:36:30,2010-02-01 10:32:08,2010-03-13 07:22:06,5881
451,8469,7425,16345,"39 days, 20:52:45",2013-02-05 11:42:15,2010-02-01 10:32:08,2010-03-13 07:24:53,8316
307,1199,2081,3587,"39 days, 21:07:26",2013-02-07 08:10:50,2010-02-01 10:32:08,2010-03-13 07:39:34,2251
481,2598,3178,6257,"39 days, 21:07:45",2013-02-06 03:55:17,2010-02-01 10:32:08,2010-03-13 07:39:53,5182
569,165,602,1336,"39 days, 21:29:18",2013-02-05 00:10:26,2010-02-01 10:32:08,2010-03-13 08:01:26,5397
2075,9108,7059,18242,"39 days, 21:33:01",2013-02-07 10:02:31,2010-02-01 10:32:08,2010-03-13 08:05:09,655
107,2626,2759,5492,"39 days, 21:33:58",2013-02-05 10:05:12,2010-02-01 10:32:08,2010-03-13 08:06:06,3311
387,1148,1635,3170,"39 days, 21:36:17",2013-02-06 01:44:10,2010-02-01 10:32:08,2010-03-13 08:08:25,1701
238,1364,1600,3202,"39 days, 21:37:19",2013-02-06 08:12:04,2010-02-01 10:32:08,2010-03-13 08:09:27,7824
34,65,306,405,"39 days, 21:40:23",2013-02-04 07:15:56,2010-02-01 10:32:08,2010-03-13 08:12:31,3635
891,3208,4474,8573,"39 days, 21:45:04",2013-02-07 11:30:24,2010-02-01 10:32:08,2010-03-13 08:17:12,8060
25,825,2578,3428,"39 days, 21:48:27",2013-02-05 03:19:25,2010-02-01 10:32:08,2010-03-13 08:20:35,2112
785,485,1138,2408,"39 days, 21:59:05",2013-02-06 10:40:20,2010-02-01 10:32:08,2010-03-13 08:31:13,2925
407,76,336,819,"39 days, 22:03:52",2013-01-29 04:41:27,2010-02-01 10:32:08,2010-03-13 08:36:00,9432
947,1011,1259,3217,"39 days, 22:13:17",2013-02-03 03:01:10,2010-02-01 10:32:08,2010-03-13 08:45:25,401
1783,2377,3356,7516,"39 days, 22:37:29",2013-02-11 01:13:05,2010-02-01 10:32:08,2010-03-13 09:09:37,6636
165,874,1160,2199,"39 days, 22:48:50",2013-02-06 03:42:23,2010-02-01 10:32:08,2010-03-13 09:20:58,4447
80,220,504,804,"39 days, 22:49:50",2013-02-02 04:27:16,2010-07-27 02:56:16,2010-09-05 01:46:06,6131
69,522,1328,1919,"39 days, 23:07:26",2013-02-06 10:33:44,2010-02-20 10:58:18,2010-04-01 10:05:44,4982
210,7563,7427,15200,"39 days, 23:16:51",2013-02-07 00:53:15,2010-02-01 10:32:08,2010-03-13 09:48:59,1426
675,1535,2376,4586,"39 days, 23:20:35",2013-02-06 00:40:29,2010-02-01 10:32:08,2010-03-13 09:52:43,4826
557,420,969,1946,"39 days, 23:21:27",2013-02-05 07:01:16,2010-02-01 10:32:08,2010-03-13 09:53:35,9611
88,1008,2545,3641,"39 days, 23:28:15",2013-02-11 07:03:48,2010-02-01 10:32:08,2010-03-13 10:00:23,4309
436,1661,2498,4595,"39 days, 23:29:49",2013-02-08 10:23:48,2010-02-01 10:32:08,2010-03-13 10:01:57,1496
163,2437,2913,5513,"39 days, 23:41:35",2013-02-05 01:23:44,2010-02-01 10:32:08,2010-03-13 10:13:43,1150
422,1097,1966,3485,"39 days, 23:50:54",2013-02-07 11:15:15,2010-02-01 10:32:08,2010-03-13 10:23:02,1522
689,1459,1626,3774,"39 days, 23:54:06",2013-02-06 04:44:52,2010-02-01 10:32:08,2010-03-13 10:26:14,1703
244,512,1225,1981,"39 days, 23:55:43",2013-02-06 01:34:35,2010-02-01 10:32:08,2010-03-13 10:27:51,7008
461,2797,2939,6197,"39 days, 23:58:13",2013-02-07 03:06:37,2010-02-01 10:32:08,2010-03-13 10:30:21,102
50,781,873,1704,"40 days, 0:10:22",2013-02-03 11:17:21,2010-02-01 10:32:08,2010-03-13 10:42:30,8003
1009,3545,4478,9032,"40 days, 0:14:07",2013-02-08 11:26:55,2010-02-01 10:32:08,2010-03-13 10:46:15,365
906,415,931,2252,"40 days, 0:23:52",2013-02-07 02:42:45,2010-02-01 10:32:08,2010-03-13 10:56:00,4596
787,241,493,1521,"40 days, 0:31:06",2013-02-02 03:55:08,2010-02-01 10:32:08,2010-03-13 11:03:14,8356
24,3624,3225,6873,"40 days, 0:33:28",2013-02-23 05:56:21,2010-02-01 10:32:08,2010-03-13 11:05:36,1565
452,5416,3548,9416,"40 days, 0:40:53",2013-02-07 02:49:32,2010-02-01 10:32:08,2010-03-13 11:13:01,803
493,5,92,590,"40 days, 0:48:49",2013-01-30 03:23:47,2010-02-01 10:32:08,2010-03-13 11:20:57,7298
726,928,1525,3179,"40 days, 0:57:15",2013-02-05 03:10:22,2010-02-01 10:32:08,2010-03-13 11:29:23,5081
775,2137,3762,6674,"40 days, 1:08:43",2013-02-07 09:01:57,2010-02-01 10:32:08,2010-03-13 11:40:51,6266
177,1815,3068,5060,"40 days, 1:11:09",2013-02-07 04:53:39,2010-02-01 10:32:08,2010-03-13 11:43:17,6868
702,102,606,1410,"40 days, 1:18:16",2013-02-05 08:46:37,2010-04-26 01:37:58,2010-06-05 02:56:14,7930
1018,778,1618,3414,"40 days, 1:26:14",2013-02-05 04:44:35,2010-02-01 10:32:08,2010-03-13 11:58:22,6316
159,258,522,939,"40 days, 2:35:18",2013-02-05 02:53:42,2010-03-30 05:09:49,2010-05-09 07:45:07,1878
394,637,1392,2423,"40 days, 3:28:54",2013-02-04 06:17:42,2010-02-05 02:34:33,2010-03-17 06:03:27,8973
364,21,61,446,"40 days, 3:58:46",2013-01-29 05:18:25,2011-07-07 04:34:52,2011-08-16 08:33:38,1262
71,31,168,270,"40 days, 4:52:22",2013-02-06 07:16:05,2011-06-21 04:34:38,2011-07-31 09:27:00,2824
65,1164,1693,2922,"40 days, 6:15:45",2013-02-06 02:49:37,2010-02-19 00:59:46,2010-03-31 07:15:31,6544
194,2145,3527,5866,"40 days, 7:15:01",2013-02-08 01:18:04,2010-02-15 02:34:24,2010-03-27 09:49:25,8998
1493,6121,5644,13258,"40 days, 13:42:10",2013-02-08 00:37:52,2010-02-01 10:32:08,2010-03-14 00:14:18,221
2059,7976,7588,17623,"40 days, 13:56:47",2013-02-07 07:52:27,2010-02-01 10:32:08,2010-03-14 00:28:55,2125
170,1156,1770,3096,"40 days, 13:59:52",2013-02-05 11:50:39,2010-02-01 10:32:08,2010-03-14 00:32:00,3345
249,3033,3393,6675,"40 days, 14:00:29",2013-02-06 03:21:42,2010-02-01 10:32:08,2010-03-14 00:32:37,2487
294,1394,2419,4107,"40 days, 14:02:06",2013-02-06 05:47:23,2010-02-01 10:32:08,2010-03-14 00:34:14,8649
484,2555,2763,5802,"40 days, 14:05:11",2013-02-06 11:07:50,2010-02-01 10:32:08,2010-03-14 00:37:19,6173
1767,5277,5356,12400,"40 days, 14:07:15",2013-02-07 03:34:20,2010-02-01 10:32:08,2010-03-14 00:39:23,7147
574,6353,8346,15273,"40 days, 14:29:13",2013-02-09 10:49:25,2010-02-01 10:32:08,2010-03-14 01:01:21,6998
1522,1071,1756,4349,"40 days, 14:32:15",2013-02-06 09:22:24,2010-02-01 10:32:08,2010-03-14 01:04:23,3440
309,257,506,1072,"40 days, 14:38:48",2013-02-04 01:20:30,2010-02-01 10:32:08,2010-03-14 01:10:56,5475
167,535,1235,1937,"40 days, 14:44:57",2013-02-06 02:04:07,2010-02-01 10:32:08,2010-03-14 01:17:05,3347
294,2773,3500,6567,"40 days, 14:57:53",2013-02-04 08:45:15,2010-02-01 10:32:08,2010-03-14 01:30:01,9790
913,474,487,1874,"40 days, 15:11:32",2013-02-06 09:55:07,2010-02-01 10:32:08,2010-03-14 01:43:40,8760
242,396,788,1426,"40 days, 15:43:04",2013-02-06 07:44:33,2010-03-16 09:39:20,2010-04-26 01:22:24,5664
251,447,962,1660,"40 days, 16:07:50",2013-02-07 00:34:56,2010-02-01 10:32:08,2010-03-14 02:39:58,7189
350,402,791,1543,"40 days, 16:08:20",2013-02-05 08:55:45,2010-02-01 10:32:08,2010-03-14 02:40:28,2298
220,824,1288,2332,"40 days, 16:29:31",2013-02-05 06:53:39,2010-02-01 10:32:08,2010-03-14 03:01:39,7896
871,579,1569,3019,"40 days, 16:37:58",2013-02-05 10:53:42,2010-02-01 10:32:08,2010-03-14 03:10:06,1191
35,544,982,1561,"40 days, 16:45:29",2013-02-06 11:43:22,2010-02-01 10:32:08,2010-03-14 03:17:37,4740
257,4188,6756,11201,"40 days, 16:52:55",2013-02-06 00:24:53,2010-02-01 10:32:08,2010-03-14 03:25:03,1499
1311,1,46,1358,"40 days, 16:59:52",2013-01-31 02:42:21,2011-04-04 09:53:15,2011-05-15 02:53:07,2432
247,720,1496,2463,"40 days, 17:02:35",2013-02-06 09:29:42,2010-02-01 10:32:08,2010-03-14 03:34:43,1528
311,2458,2946,5715,"40 days, 17:13:08",2013-02-07 07:20:06,2010-02-01 10:32:08,2010-03-14 03:45:16,9661
866,1326,2125,4317,"40 days, 17:35:51",2013-02-16 02:45:56,2010-03-05 07:10:05,2010-04-15 00:45:56,2396
376,1180,2344,3900,"40 days, 17:49:01",2013-02-04 04:05:53,2010-02-01 10:32:08,2010-03-14 04:21:09,2129
137,1147,1576,2860,"40 days, 17:49:41",2013-02-06 04:06:50,2010-02-01 10:32:08,2010-03-14 04:21:49,5269
1409,111,355,1875,"40 days, 18:03:51",2013-02-05 09:07:59,2010-02-01 10:32:08,2010-03-14 04:35:59,7233
1366,4135,5509,11010,"40 days, 18:32:39",2013-02-06 07:45:04,2010-02-01 10:32:08,2010-03-14 05:04:47,2133
222,2180,2456,4858,"40 days, 19:02:45",2013-02-06 00:20:59,2010-02-01 10:32:08,2010-03-14 05:34:53,3167
219,152,133,504,"40 days, 19:08:13",2013-02-01 04:44:15,2010-08-08 09:16:15,2010-09-18 04:24:28,4827
8,1375,2242,3625,"40 days, 19:21:10",2013-02-05 09:33:19,2010-02-01 10:32:08,2010-03-14 05:53:18,6635
510,3727,4046,8283,"40 days, 19:25:07",2013-02-07 04:53:56,2010-02-01 10:32:08,2010-03-14 05:57:15,4096
399,1586,2570,4555,"40 days, 19:44:32",2013-02-06 09:06:09,2010-02-01 10:32:08,2010-03-14 06:16:40,7283
579,174,182,935,"40 days, 19:52:13",2013-02-02 09:50:56,2010-02-01 10:32:08,2010-03-14 06:24:21,5572
948,1043,1637,3628,"40 days, 19:52:52",2013-02-06 00:41:58,2010-02-01 10:32:08,2010-03-14 06:25:00,791
1353,1512,2548,5413,"40 days, 20:06:09",2013-02-05 10:05:46,2010-02-01 10:32:08,2010-03-14 06:38:17,6869
518,383,991,1892,"40 days, 20:17:26",2013-02-10 03:10:02,2010-02-01 10:32:08,2010-03-14 06:49:34,4301
600,2538,4140,7278,"40 days, 20:32:23",2013-02-07 03:02:30,2010-02-01 10:32:08,2010-03-14 07:04:31,7217
52,2378,2123,4553,"40 days, 20:41:30",2013-02-06 09:20:00,2010-02-01 10:32:08,2010-03-14 07:13:38,5879
648,5951,7250,13849,"40 days, 20:42:54",2013-02-07 06:40:27,2010-02-01 10:32:08,2010-03-14 07:15:02,5063
652,0,11,663,"40 days, 20:46:05",2013-01-29 06:26:42,2011-09-09 05:56:41,2011-10-20 02:42:46,9270
514,7018,4797,12329,"40 days, 20:51:51",2013-02-06 06:32:04,2010-02-01 10:32:08,2010-03-14 07:23:59,3073
1091,1,133,1225,"40 days, 21:24:51",2013-01-20 08:00:49,2013-01-20 08:00:49,2013-03-02 05:25:40,9151
556,2794,3731,7081,"40 days, 21:24:59",2013-02-06 06:17:18,2010-02-01 10:32:08,2010-03-14 07:57:07,8660
319,1355,3256,4930,"40 days, 21:47:54",2013-02-07 07:10:16,2010-02-01 10:32:08,2010-03-14 08:20:02,9442
68,692,1167,1927,"40 days, 22:20:52",2013-02-05 01:32:42,2010-05-22 08:16:54,2010-07-02 06:37:46,4846
887,0,8,895,"40 days, 22:21:46",2013-01-29 08:49:32,2010-02-01 10:32:08,2010-03-14 08:53:54,6418
318,147,316,781,"40 days, 22:31:35",2013-02-02 00:40:27,2010-02-01 10:32:08,2010-03-14 09:03:43,4891
208,48,346,602,"40 days, 22:32:34",2013-02-07 04:47:59,2010-02-01 10:32:08,2010-03-14 09:04:42,9522
80,43,279,402,"40 days, 22:37:01",2013-02-04 10:23:40,2010-11-04 05:32:58,2010-12-15 04:09:59,474
576,379,394,1349,"40 days, 22:37:09",2013-02-01 09:00:31,2010-02-01 10:32:08,2010-03-14 09:09:17,3251
1014,3460,4111,8585,"40 days, 22:54:33",2013-02-07 03:34:51,2010-02-01 10:32:08,2010-03-14 09:26:41,862
94,672,1558,2324,"40 days, 23:03:48",2013-02-06 01:46:01,2010-02-01 10:32:08,2010-03-14 09:35:56,7253
5,341,679,1025,"40 days, 23:14:59",2013-02-04 04:07:26,2010-02-01 10:32:08,2010-03-14 09:47:07,6043
853,2173,3805,6831,"40 days, 23:24:11",2013-02-06 01:25:39,2010-02-01 10:32:08,2010-03-14 09:56:19,3963
1169,6424,5002,12595,"40 days, 23:32:59",2013-02-10 10:42:07,2010-02-01 10:32:08,2010-03-14 10:05:07,5224
2170,6257,5741,14168,"40 days, 23:33:59",2013-02-07 11:16:55,2010-02-01 10:32:08,2010-03-14 10:06:07,3759
186,1659,2352,4197,"40 days, 23:38:04",2013-02-06 04:22:54,2010-02-01 10:32:08,2010-03-14 10:10:12,6622
1726,2609,2732,7067,"40 days, 23:45:50",2013-02-07 01:11:35,2010-02-01 10:32:08,2010-03-14 10:17:58,7060
1086,6587,6903,14576,"40 days, 23:47:22",2013-02-07 01:20:40,2010-02-01 10:32:08,2010-03-14 10:19:30,3506
142,3012,3866,7020,"40 days, 23:56:46",2013-02-07 01:26:48,2010-02-01 10:32:08,2010-03-14 10:28:54,1830
460,293,577,1330,"40 days, 23:58:36",2013-02-02 00:07:48,2010-02-01 10:32:08,2010-03-14 10:30:44,2893
1496,1563,1839,4898,"41 days, 0:00:07",2013-02-05 04:45:52,2010-02-01 10:32:08,2010-03-14 10:32:15,9700
586,424,626,1636,"41 days, 0:22:07",2013-02-04 09:13:46,2010-02-01 10:32:08,2010-03-14 10:54:15,4399
230,3001,6738,9969,"41 days, 0:24:29",2013-02-07 08:54:00,2010-02-01 10:32:08,2010-03-14 10:56:37,6973
184,2714,2819,5717,"41 days, 0:27:40",2013-02-05 02:54:52,2010-02-01 10:32:08,2010-03-14 10:59:48,6436
1347,6697,8394,16438,"41 days, 0:33:24",2013-02-07 01:31:27,2010-02-01 10:32:08,2010-03-14 11:05:32,8314
102,56,498,656,"41 days, 0:37:56",2013-02-02 05:20:07,2010-02-01 10:32:08,2010-03-14 11:10:04,7927
619,378,758,1755,"41 days, 0:44:19",2013-02-05 05:12:55,2010-04-10 09:21:07,2010-05-21 10:05:26,8459
351,1115,2138,3604,"41 days, 1:14:04",2013-02-06 02:18:40,2010-02-01 10:32:08,2010-03-14 11:46:12,3483
730,1175,1619,3524,"41 days, 2:03:10",2013-02-06 06:25:18,2010-03-31 08:50:01,2010-05-11 10:53:11,1561
243,249,590,1082,"41 days, 2:05:39",2013-02-05 08:55:32,2010-06-24 00:06:52,2010-08-04 02:12:31,88
759,5,35,799,"41 days, 2:28:46",2013-01-20 02:56:54,2013-01-20 02:56:54,2013-03-02 05:25:40,4342
141,1288,2109,3538,"41 days, 13:49:56",2013-02-07 09:04:41,2010-02-01 10:32:08,2010-03-15 00:22:04,1183
1343,1961,2345,5649,"41 days, 14:20:34",2013-02-07 04:48:16,2010-02-01 10:32:08,2010-03-15 00:52:42,7762
150,1466,1722,3338,"41 days, 15:10:57",2013-02-11 07:21:26,2010-02-01 10:32:08,2010-03-15 01:43:05,9198
550,196,293,1039,"41 days, 15:15:41",2013-02-07 00:16:02,2010-02-01 10:32:08,2010-03-15 01:47:49,3431
65,457,1044,1566,"41 days, 15:26:53",2013-02-06 11:46:03,2010-02-01 10:32:08,2010-03-15 01:59:01,7643
1037,607,924,2568,"41 days, 15:33:15",2013-02-06 06:06:29,2010-02-01 10:32:08,2010-03-15 02:05:23,7556
519,653,891,2063,"41 days, 16:03:07",2013-02-06 11:48:06,2010-02-01 10:32:08,2010-03-15 02:35:15,7188
825,1250,2012,4087,"41 days, 16:03:22",2013-02-06 09:52:35,2010-02-01 10:32:08,2010-03-15 02:35:30,13
484,376,794,1654,"41 days, 16:09:44",2013-02-04 03:55:49,2010-02-01 10:32:08,2010-03-15 02:41:52,8776
43,3726,3513,7282,"41 days, 16:19:56",2013-02-10 07:54:40,2010-02-01 10:32:08,2010-03-15 02:52:04,7681
1100,1979,2939,6018,"41 days, 16:22:06",2013-02-06 08:13:49,2010-02-01 10:32:08,2010-03-15 02:54:14,9916
221,134,260,615,"41 days, 16:29:38",2013-02-11 02:59:47,2010-02-01 10:32:08,2010-03-15 03:01:46,4901
30,2651,3865,6546,"41 days, 16:45:08",2013-02-07 10:23:03,2010-02-01 10:32:08,2010-03-15 03:17:16,4573
653,1504,2377,4534,"41 days, 16:46:25",2013-02-05 08:09:55,2010-02-01 10:32:08,2010-03-15 03:18:33,6045
2447,7163,8573,18183,"41 days, 16:53:57",2013-02-07 06:10:38,2010-02-01 10:32:08,2010-03-15 03:26:05,1104
83,340,433,856,"41 days, 16:54:38",2013-02-01 09:48:08,2010-02-01 10:32:08,2010-03-15 03:26:46,3467
1145,2858,2936,6939,"41 days, 17:04:17",2013-02-07 02:49:43,2010-02-01 10:32:08,2010-03-15 03:36:25,1289
1250,2421,3511,7182,"41 days, 17:30:14",2013-02-06 07:20:47,2010-02-01 10:32:08,2010-03-15 04:02:22,3513
972,71,473,1516,"41 days, 17:35:02",2013-02-04 09:16:23,2010-02-01 10:32:08,2010-03-15 04:07:10,7207
92,410,603,1105,"41 days, 17:45:43",2013-02-02 08:13:35,2010-02-01 10:32:08,2010-03-15 04:17:51,2723
134,1484,2461,4079,"41 days, 17:47:37",2013-02-07 00:57:03,2010-02-01 10:32:08,2010-03-15 04:19:45,6170
279,584,773,1636,"41 days, 17:56:33",2013-02-02 09:38:23,2010-05-04 11:30:57,2010-06-15 05:27:30,5259
1038,221,240,1499,"41 days, 18:13:38",2013-01-30 06:34:32,2010-02-01 10:32:08,2010-03-15 04:45:46,2474
341,2032,3496,5869,"41 days, 18:27:09",2013-02-07 01:22:36,2010-02-01 10:32:08,2010-03-15 04:59:17,7835
827,5249,5214,11290,"41 days, 18:43:54",2013-02-07 06:32:53,2010-02-01 10:32:08,2010-03-15 05:16:02,8888
501,895,1736,3132,"41 days, 18:44:21",2013-02-05 05:51:12,2010-02-01 10:32:08,2010-03-15 05:16:29,4329
828,3414,4029,8271,"41 days, 18:58:51",2013-02-07 09:33:20,2010-02-01 10:32:08,2010-03-15 05:30:59,9948
698,1716,2016,4430,"41 days, 19:00:54",2013-02-06 00:24:34,2010-02-01 10:32:08,2010-03-15 05:33:02,1998
713,4,117,834,"41 days, 19:05:25",2013-01-26 04:19:56,2011-07-07 06:22:50,2011-08-18 01:28:15,7105
363,534,1478,2375,"41 days, 19:29:43",2013-02-06 04:22:22,2010-02-01 10:32:08,2010-03-15 06:01:51,5454
1074,953,1868,3895,"41 days, 19:34:57",2013-02-06 07:08:36,2010-02-01 10:32:08,2010-03-15 06:07:05,7108
107,1629,2545,4281,"41 days, 19:38:39",2013-02-05 08:26:00,2010-02-01 10:32:08,2010-03-15 06:10:47,6871
477,1768,3332,5577,"41 days, 19:57:02",2013-02-07 00:15:19,2010-02-01 10:32:08,2010-03-15 06:29:10,1476
607,1621,2250,4478,"41 days, 19:58:30",2013-02-07 08:37:45,2010-02-01 10:32:08,2010-03-15 06:30:38,4824
2,36,100,138,"41 days, 19:58:32",2013-01-31 04:27:05,2011-06-25 08:49:01,2011-08-06 04:47:33,2468
1953,6710,7047,15710,"41 days, 20:03:00",2013-02-06 04:37:04,2010-02-01 10:32:08,2010-03-15 06:35:08,9318
1036,2608,4204,7848,"41 days, 20:24:28",2013-02-07 09:29:22,2010-02-01 10:32:08,2010-03-15 06:56:36,746
1830,1520,2316,5666,"41 days, 20:27:10",2013-02-09 07:00:31,2010-02-01 10:32:08,2010-03-15 06:59:18,801
1815,1323,1634,4772,"41 days, 20:27:22",2013-02-06 05:32:19,2010-02-01 10:32:08,2010-03-15 06:59:30,9717
65,8345,7212,15622,"41 days, 20:29:41",2013-02-07 06:46:09,2010-02-01 10:32:08,2010-03-15 07:01:49,849
483,1930,2796,5209,"41 days, 20:37:26",2013-02-06 03:10:28,2010-02-01 10:32:08,2010-03-15 07:09:34,4685
32,397,724,1153,"41 days, 20:43:07",2013-02-04 02:05:14,2010-02-01 10:32:08,2010-03-15 07:15:15,1722
1290,367,329,1986,"41 days, 20:44:23",2013-01-30 06:40:37,2010-02-01 10:32:08,2010-03-15 07:16:31,3207
585,532,1377,2494,"41 days, 20:47:11",2013-02-05 07:18:11,2010-02-01 10:32:08,2010-03-15 07:19:19,2513
341,1706,2587,4634,"41 days, 20:55:36",2013-02-03 09:11:04,2010-02-01 10:32:08,2010-03-15 07:27:44,8752
1459,552,757,2768,"41 days, 20:58:30",2013-02-05 07:03:06,2010-03-09 09:11:26,2010-04-20 06:09:56,6669
690,358,771,1819,"41 days, 21:29:10",2013-02-06 10:19:15,2010-02-01 10:32:08,2010-03-15 08:01:18,3883
1610,1556,2500,5666,"41 days, 21:33:37",2013-02-04 10:42:33,2010-02-18 07:26:57,2010-04-01 05:00:34,1089
1021,1,11,1033,"41 days, 21:58:03",2013-01-20 09:28:28,2011-10-22 08:41:31,2011-12-03 06:39:34,5836
42,67,261,370,"41 days, 22:31:57",2013-02-03 09:44:29,2010-12-30 07:16:05,2011-02-10 05:48:02,8276
1042,637,2005,3684,"41 days, 22:49:10",2013-02-04 09:52:28,2010-02-01 10:32:08,2010-03-15 09:21:18,7707
228,1042,1026,2296,"41 days, 22:50:47",2013-02-04 10:13:21,2010-02-01 10:32:08,2010-03-15 09:22:55,3439
835,2936,3435,7206,"41 days, 23:15:07",2013-02-06 01:19:06,2010-02-01 10:32:08,2010-03-15 09:47:15,2252
449,59,129,637,"41 days, 23:37:30",2013-01-31 05:14:58,2010-02-01 10:32:08,2010-03-15 10:09:38,6135
648,738,1012,2398,"41 days, 23:45:10",2013-02-05 00:05:56,2010-02-01 10:32:08,2010-03-15 10:17:18,2264
105,134,453,692,"41 days, 23:50:23",2013-02-04 04:26:57,2010-02-01 10:32:08,2010-03-15 10:22:31,460
343,780,911,2034,"41 days, 23:55:14",2013-02-05 05:58:01,2010-02-01 10:32:08,2010-03-15 10:27:22,4619
58,1679,1908,3645,"41 days, 23:59:03",2013-02-07 10:31:22,2010-02-01 10:32:08,2010-03-15 10:31:11,1422
378,4750,6751,11879,"42 days, 0:21:12",2013-02-06 11:14:20,2010-02-01 10:32:08,2010-03-15 10:53:20,1898
1112,7299,4939,13350,"42 days, 0:26:47",2013-02-07 04:57:25,2010-02-01 10:32:08,2010-03-15 10:58:55,8434
874,176,382,1432,"42 days, 0:43:20",2013-02-06 02:08:58,2010-02-01 10:32:08,2010-03-15 11:15:28,6183
240,137,301,678,"42 days, 0:44:27",2013-02-02 08:43:39,2010-02-01 10:32:08,2010-03-15 11:16:35,8326
350,2169,3514,6033,"42 days, 0:50:02",2013-02-07 10:39:14,2010-02-01 10:32:08,2010-03-15 11:22:10,869
657,2121,3210,5988,"42 days, 0:52:05",2013-02-07 00:57:41,2010-02-01 10:32:08,2010-03-15 11:24:13,3179
261,3588,4552,8401,"42 days, 1:16:57",2013-02-06 00:01:16,2010-02-01 10:32:08,2010-03-15 11:49:05,4529
20,2320,3843,6183,"42 days, 1:20:52",2013-02-07 11:07:22,2010-02-01 10:32:08,2010-03-15 11:53:00,7552
674,3,46,723,"42 days, 1:45:35",2013-02-06 05:23:42,2010-02-17 03:32:50,2010-03-31 05:18:25,4349
117,255,453,825,"42 days, 2:02:26",2013-02-05 03:08:36,2010-06-06 09:37:30,2010-07-18 11:39:56,2004
19,923,1778,2720,"42 days, 3:42:39",2013-02-07 05:57:11,2010-03-13 00:17:03,2010-04-24 03:59:42,4884
775,2,44,821,"42 days, 7:18:20",2013-02-03 01:24:16,2011-04-17 03:17:56,2011-05-29 10:36:16,1614
11,3466,3436,6913,"42 days, 13:52:11",2013-02-07 08:44:15,2010-02-01 10:32:08,2010-03-16 00:24:19,1608
72,327,1154,1553,"42 days, 14:24:50",2013-02-07 06:34:24,2010-02-01 10:32:08,2010-03-16 00:56:58,9322
341,4093,4958,9392,"42 days, 14:37:09",2013-02-12 01:26:18,2010-02-01 10:32:08,2010-03-16 01:09:17,8603
320,1412,2622,4354,"42 days, 14:39:37",2013-02-07 09:04:14,2010-02-01 10:32:08,2010-03-16 01:11:45,3552
1101,3349,4867,9317,"42 days, 14:41:16",2013-02-07 09:55:30,2010-02-01 10:32:08,2010-03-16 01:13:24,4572
969,723,1473,3165,"42 days, 14:59:43",2013-02-05 09:43:45,2010-02-01 10:32:08,2010-03-16 01:31:51,118
513,2283,2339,5135,"42 days, 15:27:50",2013-02-05 09:15:04,2010-02-01 10:32:08,2010-03-16 01:59:58,7727
17,982,1625,2624,"42 days, 15:46:39",2013-02-07 05:27:06,2010-02-01 10:32:08,2010-03-16 02:18:47,3495
333,2032,3479,5844,"42 days, 16:22:40",2013-02-06 00:03:27,2010-02-01 10:32:08,2010-03-16 02:54:48,4031
57,856,1333,2246,"42 days, 16:26:24",2013-02-05 08:17:29,2010-02-01 10:32:08,2010-03-16 02:58:32,4601
790,1887,2468,5145,"42 days, 16:44:15",2013-02-07 08:17:51,2010-02-01 10:32:08,2010-03-16 03:16:23,6285
564,1100,1483,3147,"42 days, 16:44:39",2013-02-07 02:58:13,2010-02-01 10:32:08,2010-03-16 03:16:47,2226
696,1,18,715,"42 days, 16:49:21",2013-01-27 00:04:24,2011-11-19 10:16:00,2012-01-01 03:05:21,6399
211,2971,5013,8195,"42 days, 16:51:03",2013-02-06 04:13:49,2010-02-01 10:32:08,2010-03-16 03:23:11,5457
509,7571,7749,15829,"42 days, 17:11:02",2013-02-08 10:22:47,2010-02-01 10:32:08,2010-03-16 03:43:10,1782
629,3113,2764,6506,"42 days, 17:41:14",2013-02-07 05:14:09,2010-02-01 10:32:08,2010-03-16 04:13:22,9346
229,372,1265,1866,"42 days, 17:48:17",2013-02-08 07:39:55,2010-02-01 10:32:08,2010-03-16 04:20:25,1939
53,451,1183,1687,"42 days, 18:22:52",2013-02-05 06:25:01,2010-02-01 10:32:08,2010-03-16 04:55:00,9296
754,2391,2592,5737,"42 days, 19:31:18",2013-02-07 02:23:41,2010-02-01 10:32:08,2010-03-16 06:03:26,2522
651,2241,3409,6301,"42 days, 19:36:37",2013-02-06 04:41:39,2010-02-01 10:32:08,2010-03-16 06:08:45,6242
582,1974,2334,4890,"42 days, 19:40:30",2013-02-06 00:27:13,2010-02-01 10:32:08,2010-03-16 06:12:38,6007
765,2293,4516,7574,"42 days, 20:14:53",2013-02-07 06:57:04,2010-02-01 10:32:08,2010-03-16 06:47:01,8632
33,265,535,833,"42 days, 20:19:59",2013-02-06 07:47:13,2010-02-01 10:32:08,2010-03-16 06:52:07,2162
45,174,260,479,"42 days, 20:36:45",2013-02-05 05:17:18,2010-02-01 10:32:08,2010-03-16 07:08:53,4722
637,5738,4420,10795,"42 days, 20:59:08",2013-02-06 07:58:40,2010-02-01 10:32:08,2010-03-16 07:31:16,9174
87,265,696,1048,"42 days, 21:06:13",2013-02-02 04:31:26,2010-02-01 10:32:08,2010-03-16 07:38:21,9418
215,269,299,783,"42 days, 21:07:49",2013-02-05 02:07:17,2010-02-01 10:32:08,2010-03-16 07:39:57,4609
916,1724,2977,5617,"42 days, 21:11:59",2013-02-06 08:17:21,2010-02-01 10:32:08,2010-03-16 07:44:07,2265
99,4479,5312,9890,"42 days, 21:22:52",2013-02-05 03:17:02,2010-02-13 10:38:51,2010-03-28 08:01:43,4519
347,457,717,1521,"42 days, 21:27:22",2013-02-06 01:33:09,2010-02-01 10:32:08,2010-03-16 07:59:30,4559
1058,2129,3488,6675,"42 days, 21:38:07",2013-02-07 07:22:43,2010-02-01 10:32:08,2010-03-16 08:10:15,754
62,3779,4382,8223,"42 days, 21:52:46",2013-02-06 10:32:13,2010-02-01 10:32:08,2010-03-16 08:24:54,6700
315,7622,5157,13094,"42 days, 21:58:28",2013-02-06 01:37:48,2010-02-01 10:32:08,2010-03-16 08:30:36,7656
282,3020,2947,6249,"42 days, 21:59:56",2013-02-06 08:21:52,2010-02-01 10:32:08,2010-03-16 08:32:04,2777
927,673,1152,2752,"42 days, 22:07:17",2013-02-06 06:31:28,2010-02-01 10:32:08,2010-03-16 08:39:25,3415
2,268,469,739,"42 days, 23:04:01",2013-02-07 05:41:25,2010-02-01 10:32:08,2010-03-16 09:36:09,3262
716,1212,1583,3511,"42 days, 23:04:31",2013-02-06 08:21:48,2010-02-01 10:32:08,2010-03-16 09:36:39,3254
334,437,723,1494,"42 days, 23:05:06",2013-02-04 09:37:16,2010-02-01 10:32:08,2010-03-16 09:37:14,9269
1335,3226,3312,7873,"42 days, 23:52:04",2013-02-06 11:58:35,2010-02-01 10:32:08,2010-03-16 10:24:12,1660
1583,5502,7166,14251,"43 days, 0:04:42",2013-02-07 03:41:12,2010-02-01 10:32:08,2010-03-16 10:36:50,1182
662,0,88,750,"43 days, 0:45:15",2013-01-29 03:37:29,2010-02-01 10:32:08,2010-03-16 11:17:23,1486
640,201,331,1172,"43 days, 0:52:46",2013-02-01 05:29:08,2010-02-01 10:32:08,2010-03-16 11:24:54,3203
792,3080,3991,7863,"43 days, 1:15:55",2013-02-07 10:51:05,2010-02-01 10:32:08,2010-03-16 11:48:03,6023
145,1747,2705,4597,"43 days, 1:25:11",2013-02-06 07:17:32,2010-02-01 10:32:08,2010-03-16 11:57:19,919
890,1977,3411,6278,"43 days, 4:54:09",2013-02-06 05:38:49,2010-02-27 02:28:07,2010-04-11 07:22:16,8005
1131,5868,7739,14738,"43 days, 13:30:06",2013-02-07 01:07:58,2010-02-01 10:32:08,2010-03-17 00:02:14,3334
1258,873,2222,4353,"43 days, 13:31:58",2013-02-06 07:21:29,2010-02-01 10:32:08,2010-03-17 00:04:06,2003
207,211,379,797,"43 days, 13:43:13",2013-02-02 11:11:44,2010-02-01 10:32:08,2010-03-17 00:15:21,8018
41,1654,2183,3878,"43 days, 14:01:42",2013-02-06 11:46:32,2010-02-01 10:32:08,2010-03-17 00:33:50,3618
52,58,232,342,"43 days, 14:13:40",2013-02-06 02:06:35,2010-03-08 10:27:44,2010-04-21 00:41:24,284
1620,5704,4570,11894,"43 days, 14:15:52",2013-02-06 07:10:25,2010-02-01 10:32:08,2010-03-17 00:48:00,7807
429,1445,2630,4504,"43 days, 14:43:32",2013-02-06 07:01:47,2010-02-01 10:32:08,2010-03-17 01:15:40,9059
18,3672,3578,7268,"43 days, 14:49:36",2013-02-06 09:58:13,2010-02-01 10:32:08,2010-03-17 01:21:44,9505
1011,625,1795,3431,"43 days, 14:57:00",2013-02-04 11:07:02,2010-02-01 10:32:08,2010-03-17 01:29:08,8694
57,8539,6147,14743,"43 days, 15:19:14",2013-02-07 10:22:06,2010-02-01 10:32:08,2010-03-17 01:51:22,1758
59,1884,2567,4510,"43 days, 15:20:43",2013-02-05 01:46:21,2010-02-01 10:32:08,2010-03-17 01:52:51,6900
23,5263,5710,10996,"43 days, 15:27:19",2013-02-18 04:54:57,2010-02-01 10:32:08,2010-03-17 01:59:27,2197
517,497,1005,2019,"43 days, 15:27:27",2013-02-01 09:18:16,2010-02-01 10:32:08,2010-03-17 01:59:35,2568
11,986,1446,2443,"43 days, 15:30:20",2013-02-06 08:35:09,2010-02-01 10:32:08,2010-03-17 02:02:28,7539
610,217,534,1361,"43 days, 15:33:35",2013-02-05 02:49:45,2010-02-01 10:32:08,2010-03-17 02:05:43,6509
152,4202,6001,10355,"43 days, 15:39:19",2013-02-06 03:55:48,2010-02-01 10:32:08,2010-03-17 02:11:27,9530
273,3875,3668,7816,"43 days, 15:41:55",2013-02-07 08:00:33,2010-02-01 10:32:08,2010-03-17 02:14:03,7055
647,2694,2326,5667,"43 days, 15:58:59",2013-02-07 00:51:34,2010-02-01 10:32:08,2010-03-17 02:31:07,7068
100,505,983,1588,"43 days, 16:14:44",2013-01-31 11:42:03,2010-02-01 10:32:08,2010-03-17 02:46:52,4536
1527,1125,2151,4803,"43 days, 16:19:43",2013-02-05 10:35:01,2010-02-01 10:32:08,2010-03-17 02:51:51,245
38,110,232,380,"43 days, 16:20:27",2013-02-07 08:57:34,2010-02-01 10:32:08,2010-03-17 02:52:35,4862
1160,5826,6049,13035,"43 days, 16:26:18",2013-02-05 11:09:49,2010-02-01 10:32:08,2010-03-17 02:58:26,7550
53,1618,2821,4492,"43 days, 16:41:31",2013-02-07 08:32:12,2010-02-01 10:32:08,2010-03-17 03:13:39,9794
98,150,296,544,"43 days, 16:44:22",2013-01-31 08:59:50,2010-07-18 08:19:48,2010-08-31 01:04:10,6757
70,7303,7239,14612,"43 days, 17:06:16",2013-02-07 02:05:05,2010-02-07 09:55:55,2010-03-23 03:02:11,722
1046,2798,1758,5602,"43 days, 17:42:01",2013-02-09 08:54:16,2010-02-01 10:32:08,2010-03-17 04:14:09,7458
162,217,580,959,"43 days, 17:42:05",2013-02-06 01:26:46,2010-02-01 10:32:08,2010-03-17 04:14:13,3162
17,112,139,268,"43 days, 17:45:49",2013-02-04 09:55:47,2010-02-01 10:32:08,2010-03-17 04:17:57,2902
776,884,1720,3380,"43 days, 18:16:26",2013-02-07 03:42:51,2010-02-01 10:32:08,2010-03-17 04:48:34,3422
183,178,935,1296,"43 days, 18:25:24",2013-02-06 00:22:38,2010-09-07 08:38:07,2010-10-21 03:03:31,4217
396,1502,1891,3789,"43 days, 18:36:01",2013-02-05 09:12:27,2010-02-01 10:32:08,2010-03-17 05:08:09,7703
272,48,188,508,"43 days, 18:53:37",2013-02-01 02:45:54,2011-01-17 05:18:07,2011-03-02 00:11:44,5239
60,1003,1222,2285,"43 days, 19:17:47",2013-02-07 11:56:58,2010-02-01 10:32:08,2010-03-17 05:49:55,6138
382,2042,2239,4663,"43 days, 19:19:05",2013-02-06 09:55:16,2010-02-01 10:32:08,2010-03-17 05:51:13,3744
447,832,1364,2643,"43 days, 19:28:39",2013-02-05 04:29:34,2010-02-01 10:32:08,2010-03-17 06:00:47,1492
183,1953,2910,5046,"43 days, 19:29:31",2013-02-05 09:35:53,2010-02-01 10:32:08,2010-03-17 06:01:39,4365
634,461,1080,2175,"43 days, 19:34:43",2013-02-05 03:56:38,2010-02-01 10:32:08,2010-03-17 06:06:51,5031
171,154,211,536,"43 days, 19:51:35",2013-02-07 10:56:32,2010-02-01 10:32:08,2010-03-17 06:23:43,5860
720,657,1055,2432,"43 days, 20:10:01",2013-02-07 06:34:52,2010-03-04 08:27:24,2010-04-17 04:37:25,9105
773,900,1676,3349,"43 days, 20:19:51",2013-02-07 09:08:27,2010-02-01 10:32:08,2010-03-17 06:51:59,2600
35,726,1554,2315,"43 days, 20:21:53",2013-02-05 03:58:22,2010-02-01 10:32:08,2010-03-17 06:54:01,8035
423,2978,4770,8171,"43 days, 20:33:03",2013-02-07 02:02:20,2010-02-01 10:32:08,2010-03-17 07:05:11,3117
562,351,779,1692,"43 days, 20:49:42",2013-02-06 09:21:46,2010-02-22 03:20:52,2010-04-07 00:10:34,6655
367,1758,2955,5080,"43 days, 21:33:38",2013-02-07 02:08:26,2010-02-11 09:37:24,2010-03-27 07:11:02,8708
981,5451,7291,13723,"43 days, 21:45:12",2013-02-07 02:48:09,2010-02-01 10:32:08,2010-03-17 08:17:20,7758
427,944,1824,3195,"43 days, 21:57:48",2013-02-06 04:59:38,2010-02-01 10:32:08,2010-03-17 08:29:56,5318
752,621,1173,2546,"43 days, 22:00:27",2013-02-06 06:37:37,2010-02-01 10:32:08,2010-03-17 08:32:35,3840
877,120,176,1173,"43 days, 22:32:45",2013-02-05 11:01:49,2010-02-23 06:20:47,2010-04-08 04:53:32,5100
1066,2495,3358,6919,"43 days, 22:39:30",2013-02-04 11:42:40,2010-02-01 10:32:08,2010-03-17 09:11:38,3160
530,965,1698,3193,"43 days, 22:46:06",2013-02-05 02:32:16,2010-02-01 10:32:08,2010-03-17 09:18:14,5172
495,1545,2841,4881,"43 days, 22:51:57",2013-02-11 10:36:02,2010-02-01 10:32:08,2010-03-17 09:24:05,9232
14,5852,5507,11373,"43 days, 23:03:47",2013-02-06 08:17:00,2010-02-27 11:13:07,2010-04-12 10:16:54,3711
703,998,1344,3045,"43 days, 23:10:00",2013-02-04 01:45:16,2010-02-01 10:32:08,2010-03-17 09:42:08,3191
312,123,512,947,"43 days, 23:12:30",2013-02-06 00:05:51,2010-02-01 10:32:08,2010-03-17 09:44:38,9634
162,718,1937,2817,"43 days, 23:28:43",2013-02-04 02:37:33,2010-02-01 10:32:08,2010-03-17 10:00:51,4453
364,118,393,875,"43 days, 23:42:01",2013-02-02 06:58:04,2010-02-01 10:32:08,2010-03-17 10:14:09,7869
644,292,626,1562,"43 days, 23:46:38",2013-02-03 11:14:02,2010-02-01 10:32:08,2010-03-17 10:18:46,9764
1265,1496,1939,4700,"43 days, 23:52:15",2013-02-06 01:23:40,2010-02-01 10:32:08,2010-03-17 10:24:23,9394
1391,1934,1990,5315,"43 days, 23:57:02",2013-02-07 04:01:17,2010-02-01 10:32:08,2010-03-17 10:29:10,9999
891,458,1369,2718,"44 days, 0:19:13",2013-02-05 03:56:01,2010-02-01 10:32:08,2010-03-17 10:51:21,3625
166,20,133,319,"44 days, 0:25:50",2013-01-30 06:49:32,2010-09-09 08:46:54,2010-10-23 09:12:44,5871
241,20,246,507,"44 days, 0:39:46",2013-02-09 04:52:26,2010-02-01 10:32:08,2010-03-17 11:11:54,5650
1127,3,24,1154,"44 days, 0:41:42",2013-02-05 03:54:07,2011-06-13 00:24:43,2011-07-27 01:06:25,4512
39,586,1142,1767,"44 days, 0:44:02",2013-02-04 08:21:38,2010-02-01 10:32:08,2010-03-17 11:16:10,2326
555,1678,2890,5123,"44 days, 0:54:22",2013-02-09 03:04:51,2010-02-01 10:32:08,2010-03-17 11:26:30,5555
694,4597,7713,13004,"44 days, 1:00:50",2013-02-05 11:09:54,2010-02-01 10:32:08,2010-03-17 11:32:58,327
1027,459,574,2060,"44 days, 1:02:08",2013-02-07 03:50:14,2010-02-01 10:32:08,2010-03-17 11:34:16,1643
792,759,1349,2900,"44 days, 2:26:08",2013-02-07 03:06:29,2010-03-08 09:30:47,2010-04-21 11:56:55,9208
49,331,415,795,"44 days, 7:48:02",2013-02-05 00:43:15,2010-03-10 02:09:28,2010-04-23 09:57:30,3539
1393,0,28,1421,"44 days, 13:28:55",2013-01-27 02:44:38,2010-02-01 10:32:08,2010-03-18 00:01:03,308
605,1728,1747,4080,"44 days, 13:41:55",2013-02-05 04:52:22,2010-02-01 10:32:08,2010-03-18 00:14:03,7465
1163,3523,4729,9415,"44 days, 14:06:12",2013-02-07 00:06:06,2010-02-01 10:32:08,2010-03-18 00:38:20,2086
1028,10057,6064,17149,"44 days, 14:18:03",2013-02-07 00:46:29,2010-02-01 10:32:08,2010-03-18 00:50:11,1094
49,5199,5460,10708,"44 days, 14:28:47",2013-02-22 11:22:11,2010-02-01 10:32:08,2010-03-18 01:00:55,3536
97,1401,1751,3249,"44 days, 14:40:04",2013-02-06 05:41:49,2010-02-01 10:32:08,2010-03-18 01:12:12,2482
1034,552,954,2540,"44 days, 14:41:41",2013-02-05 04:34:05,2010-02-01 10:32:08,2010-03-18 01:13:49,3590
837,783,2142,3762,"44 days, 14:44:35",2013-02-06 04:49:40,2010-02-01 10:32:08,2010-03-18 01:16:43,9384
576,0,14,590,"44 days, 15:37:38",2013-01-22 01:15:05,2010-02-01 10:32:08,2010-03-18 02:09:46,9257
961,12459,8212,21632,"44 days, 17:01:24",2013-02-08 09:51:31,2010-02-01 10:32:08,2010-03-18 03:33:32,5972
1145,863,1828,3836,"44 days, 17:08:22",2013-02-06 09:04:24,2010-02-01 10:32:08,2010-03-18 03:40:30,4569
1013,440,1090,2543,"44 days, 17:12:29",2013-02-05 09:05:50,2010-02-01 10:32:08,2010-03-18 03:44:37,2866
11,644,594,1249,"44 days, 17:25:14",2013-02-05 08:13:55,2010-03-07 10:04:49,2010-04-21 03:30:03,139
2150,4738,6130,13018,"44 days, 17:31:40",2013-02-05 06:03:25,2010-02-01 10:32:08,2010-03-18 04:03:48,7792
606,6744,8474,15824,"44 days, 17:37:01",2013-02-07 05:28:03,2010-02-01 10:32:08,2010-03-18 04:09:09,5238
53,444,1050,1547,"44 days, 17:54:21",2013-02-03 09:31:21,2010-03-16 06:14:28,2010-04-30 00:08:49,8946
433,197,655,1285,"44 days, 18:08:15",2013-02-04 07:10:26,2010-02-01 10:32:08,2010-03-18 04:40:23,5662
730,475,833,2038,"44 days, 18:09:27",2013-02-06 06:28:23,2010-02-01 10:32:08,2010-03-18 04:41:35,3009
1172,1031,1131,3334,"44 days, 18:24:00",2013-02-05 10:20:16,2010-02-01 10:32:08,2010-03-18 04:56:08,9282
244,2510,2884,5638,"44 days, 18:36:28",2013-02-12 06:13:35,2010-02-01 10:32:08,2010-03-18 05:08:36,750
93,1144,1930,3167,"44 days, 19:06:19",2013-02-05 05:35:04,2010-02-01 10:32:08,2010-03-18 05:38:27,3852
257,221,384,862,"44 days, 19:12:21",2013-02-12 11:01:36,2010-02-01 10:32:08,2010-03-18 05:44:29,2399
1239,605,1476,3320,"44 days, 19:28:54",2013-02-05 09:18:01,2010-02-01 10:32:08,2010-03-18 06:01:02,4232
898,41,165,1104,"44 days, 19:37:06",2013-02-01 05:00:05,2010-02-01 10:32:08,2010-03-18 06:09:14,7983
93,811,1198,2102,"44 days, 19:44:29",2013-02-06 02:29:39,2010-02-01 10:32:08,2010-03-18 06:16:37,5094
210,2025,2940,5175,"44 days, 19:52:15",2013-02-06 09:04:34,2010-02-01 10:32:08,2010-03-18 06:24:23,7478
156,574,790,1520,"44 days, 19:56:28",2013-02-01 07:11:34,2010-02-01 10:32:08,2010-03-18 06:28:36,5660
1369,1,21,1391,"44 days, 20:00:43",2013-02-03 09:32:24,2010-02-01 10:32:08,2010-03-18 06:32:51,8013
1124,564,1368,3056,"44 days, 20:01:07",2013-02-06 02:59:00,2010-02-01 10:32:08,2010-03-18 06:33:15,7319
346,66,297,709,"44 days, 20:06:08",2013-02-05 02:24:00,2010-03-14 04:49:13,2010-04-28 00:55:21,3405
170,710,946,1826,"44 days, 20:06:16",2013-02-05 07:37:42,2010-02-01 10:32:08,2010-03-18 06:38:24,55
61,755,1756,2572,"44 days, 20:07:06",2013-02-07 08:53:04,2010-02-01 10:32:08,2010-03-18 06:39:14,9254
348,47,171,566,"44 days, 20:18:57",2013-02-03 05:42:46,2010-02-01 10:32:08,2010-03-18 06:51:05,5285
185,487,990,1662,"44 days, 20:26:16",2013-02-03 00:37:28,2010-02-01 10:32:08,2010-03-18 06:58:24,4174
828,505,842,2175,"44 days, 20:34:05",2013-02-04 08:36:13,2010-02-01 10:32:08,2010-03-18 07:06:13,1290
542,4653,6291,11486,"44 days, 20:38:49",2013-02-07 02:38:19,2010-02-01 10:32:08,2010-03-18 07:10:57,5479
848,3945,6948,11741,"44 days, 20:39:11",2013-02-06 10:57:46,2010-02-01 10:32:08,2010-03-18 07:11:19,4204
337,582,909,1828,"44 days, 20:40:14",2013-02-07 00:04:22,2010-02-01 10:32:08,2010-03-18 07:12:22,2373
615,7,57,679,"44 days, 21:00:42",2013-02-05 07:36:21,2011-10-12 11:02:33,2011-11-26 08:03:15,6770
765,159,483,1407,"44 days, 21:07:05",2013-02-04 08:28:13,2010-04-26 09:20:54,2010-06-10 06:27:59,603
944,2320,2802,6066,"44 days, 21:43:28",2013-02-05 08:41:59,2010-02-01 10:32:08,2010-03-18 08:15:36,2803
389,2539,3408,6336,"44 days, 22:03:59",2013-02-05 11:09:50,2010-02-01 10:32:08,2010-03-18 08:36:07,9344
812,802,1748,3362,"44 days, 22:22:06",2013-02-07 03:52:50,2010-02-01 10:32:08,2010-03-18 08:54:14,2410
1846,4893,4415,11154,"44 days, 22:35:03",2013-02-07 06:05:25,2010-02-01 10:32:08,2010-03-18 09:07:11,583
107,7100,7250,14457,"44 days, 22:35:29",2013-02-09 02:40:17,2010-02-01 10:32:08,2010-03-18 09:07:37,402
346,952,1045,2343,"44 days, 23:12:21",2013-02-04 05:27:39,2010-02-01 10:32:08,2010-03-18 09:44:29,1787
1306,2,0,1308,"44 days, 23:22:26",2013-01-27 02:14:58,2010-02-01 10:32:08,2010-03-18 09:54:34,9550
37,5084,4896,10017,"44 days, 23:23:48",2013-02-06 11:26:04,2010-02-01 10:32:08,2010-03-18 09:55:56,8914
558,945,1746,3249,"44 days, 23:24:37",2013-02-06 05:54:11,2010-02-01 10:32:08,2010-03-18 09:56:45,3200
308,115,327,750,"44 days, 23:29:02",2013-02-03 03:40:51,2010-02-01 10:32:08,2010-03-18 10:01:10,2478
28,505,695,1228,"44 days, 23:29:05",2013-02-05 02:21:46,2010-02-01 10:32:08,2010-03-18 10:01:13,9856
152,1528,2769,4449,"44 days, 23:41:38",2013-02-04 08:50:57,2010-02-01 10:32:08,2010-03-18 10:13:46,1946
405,134,504,1043,"45 days, 0:00:34",2013-02-03 02:28:35,2010-02-01 10:32:08,2010-03-18 10:32:42,1655
742,438,849,2029,"45 days, 0:02:27",2013-02-02 08:52:50,2010-02-01 10:32:08,2010-03-18 10:34:35,1671
741,734,1051,2526,"45 days, 0:25:06",2013-02-04 11:32:11,2010-02-01 10:32:08,2010-03-18 10:57:14,2814
46,240,851,1137,"45 days, 0:35:49",2013-02-05 07:38:10,2010-02-01 10:32:08,2010-03-18 11:07:57,4823
35,115,362,512,"45 days, 0:37:20",2013-02-04 05:27:33,2010-02-01 10:32:08,2010-03-18 11:09:28,8797
941,35,222,1198,"45 days, 0:37:33",2013-02-06 11:36:09,2010-09-21 09:39:03,2010-11-05 10:16:36,6204
367,38,137,542,"45 days, 0:47:33",2013-02-01 06:26:59,2010-02-01 10:32:08,2010-03-18 11:19:41,3731
213,58,230,501,"45 days, 3:20:38",2013-01-31 01:37:59,2010-03-24 00:57:37,2010-05-08 04:18:15,1694
144,63,192,399,"45 days, 3:37:42",2013-02-05 10:28:13,2010-05-12 06:41:05,2010-06-26 10:18:47,3868
243,453,1217,1913,"45 days, 3:48:33",2013-02-03 08:20:25,2010-02-26 00:51:58,2010-04-12 04:40:31,2737
332,6,163,501,"45 days, 6:34:20",2013-01-29 00:24:03,2010-03-18 00:58:25,2010-05-02 07:32:45,2603
758,0,12,770,"45 days, 6:59:17",2013-01-26 02:10:28,2011-03-23 00:45:48,2011-05-07 07:45:05,3404
1483,1012,1166,3661,"45 days, 14:00:14",2013-02-03 05:01:54,2010-02-01 10:32:08,2010-03-19 00:32:22,6782
357,6603,4678,11638,"45 days, 14:37:48",2013-02-06 06:16:30,2010-02-01 10:32:08,2010-03-19 01:09:56,831
466,255,723,1444,"45 days, 14:38:07",2013-02-05 11:14:51,2010-02-01 10:32:08,2010-03-19 01:10:15,9923
201,1532,2169,3902,"45 days, 15:07:12",2013-02-05 10:47:31,2010-02-01 10:32:08,2010-03-19 01:39:20,2306
1592,5629,5903,13124,"45 days, 15:09:56",2013-02-07 02:11:40,2010-02-01 10:32:08,2010-03-19 01:42:04,3873
67,1621,2220,3908,"45 days, 15:22:39",2013-02-06 06:37:05,2010-02-01 10:32:08,2010-03-19 01:54:47,5305
583,724,1267,2574,"45 days, 15:24:20",2013-02-05 04:34:16,2010-02-01 10:32:08,2010-03-19 01:56:28,9490
5,321,358,684,"45 days, 15:57:33",2013-02-01 06:49:04,2010-02-01 10:32:08,2010-03-19 02:29:41,487
241,698,1018,1957,"45 days, 16:50:08",2013-02-06 03:40:16,2010-02-01 10:32:08,2010-03-19 03:22:16,2710
727,3115,4891,8733,"45 days, 16:58:51",2013-02-07 05:56:34,2010-02-01 10:32:08,2010-03-19 03:30:59,7860
755,1537,1957,4249,"45 days, 16:59:11",2013-02-12 10:48:17,2010-02-01 10:32:08,2010-03-19 03:31:19,7252
1441,0,0,1441,"45 days, 16:59:53",2013-01-26 06:58:43,2010-02-01 10:32:08,2010-03-19 03:32:01,3569
526,935,1654,3115,"45 days, 17:07:23",2013-02-06 03:02:29,2010-02-01 10:32:08,2010-03-19 03:39:31,8640
325,300,557,1182,"45 days, 17:11:50",2013-01-31 03:09:57,2010-02-01 10:32:08,2010-03-19 03:43:58,2760
974,1,15,990,"45 days, 17:12:29",2013-01-24 00:13:03,2010-02-01 10:32:08,2010-03-19 03:44:37,3897
725,4665,3860,9250,"45 days, 17:20:17",2013-02-08 07:50:00,2010-02-01 10:32:08,2010-03-19 03:52:25,3346
1453,98,142,1693,"45 days, 17:39:09",2013-02-02 02:43:45,2010-02-01 10:32:08,2010-03-19 04:11:17,1862
245,10,112,367,"45 days, 17:46:07",2013-01-31 08:43:53,2010-06-16 07:45:17,2010-08-01 01:31:24,9673
2,415,401,818,"45 days, 18:00:00",2013-02-01 01:04:45,2010-02-01 10:32:08,2010-03-19 04:32:08,7524
906,5948,8044,14898,"45 days, 18:01:35",2013-02-07 02:50:10,2010-02-01 10:32:08,2010-03-19 04:33:43,2951
1208,1352,1756,4316,"45 days, 18:18:53",2013-02-04 06:43:23,2010-02-01 10:32:08,2010-03-19 04:51:01,3103
1331,1093,1932,4356,"45 days, 18:24:15",2013-02-04 11:23:23,2010-02-01 10:32:08,2010-03-19 04:56:23,1785
883,692,1272,2847,"45 days, 18:30:13",2013-02-05 10:44:09,2010-02-01 10:32:08,2010-03-19 05:02:21,6966
227,502,1443,2172,"45 days, 18:55:54",2013-02-06 02:39:20,2010-02-01 10:32:08,2010-03-19 05:28:02,4214
845,374,1119,2338,"45 days, 19:01:01",2013-02-04 06:09:54,2010-02-21 09:16:44,2010-04-08 04:17:45,491
329,378,728,1435,"45 days, 19:12:04",2013-02-07 04:59:30,2010-02-01 10:32:08,2010-03-19 05:44:12,822
364,167,475,1006,"45 days, 19:12:16",2013-02-05 07:15:34,2010-02-01 10:32:08,2010-03-19 05:44:24,7713
1123,50,389,1562,"45 days, 19:20:20",2013-02-04 03:20:33,2010-02-01 10:32:08,2010-03-19 05:52:28,2141
39,94,436,569,"45 days, 19:38:12",2013-02-06 00:21:42,2010-06-10 06:53:20,2010-07-26 02:31:32,4146
59,2114,2298,4471,"45 days, 19:53:16",2013-02-05 11:02:32,2010-02-01 10:32:08,2010-03-19 06:25:24,9240
947,1,45,993,"45 days, 19:56:38",2013-02-06 04:37:46,2010-09-26 11:46:44,2010-11-11 07:43:22,466
270,233,538,1041,"45 days, 19:59:53",2013-02-03 10:56:44,2010-02-01 10:32:08,2010-03-19 06:32:01,1143
621,126,169,916,"45 days, 20:03:38",2013-02-03 10:15:55,2010-02-01 10:32:08,2010-03-19 06:35:46,1238
602,900,1508,3010,"45 days, 20:36:10",2013-02-06 11:15:26,2010-02-01 10:32:08,2010-03-19 07:08:18,3019
36,375,430,841,"45 days, 20:54:34",2013-02-05 06:30:31,2010-02-01 10:32:08,2010-03-19 07:26:42,901
958,8,124,1090,"45 days, 20:54:38",2013-02-06 08:13:14,2010-02-01 10:32:08,2010-03-19 07:26:46,2679
384,3594,4320,8298,"45 days, 21:10:45",2013-02-07 11:58:12,2010-02-01 10:32:08,2010-03-19 07:42:53,9548
824,153,387,1364,"45 days, 21:27:12",2013-02-05 05:44:54,2010-02-01 10:32:08,2010-03-19 07:59:20,9597
985,1985,3024,5994,"45 days, 21:37:46",2013-02-07 02:23:53,2010-02-01 10:32:08,2010-03-19 08:09:54,3413
134,1104,1916,3154,"45 days, 21:40:30",2013-02-06 02:25:22,2010-02-01 10:32:08,2010-03-19 08:12:38,499
1847,5858,6463,14168,"45 days, 21:52:04",2013-02-13 02:12:54,2010-02-01 10:32:08,2010-03-19 08:24:12,9175
136,4116,4156,8408,"45 days, 22:09:08",2013-02-06 03:20:38,2010-04-25 09:46:20,2010-06-10 07:55:28,6523
100,257,610,967,"45 days, 22:16:02",2013-02-07 07:23:59,2010-02-01 10:32:08,2010-03-19 08:48:10,8511
139,232,685,1056,"45 days, 22:19:54",2013-02-07 06:39:49,2010-02-01 10:32:08,2010-03-19 08:52:02,1879
231,98,435,764,"45 days, 22:27:29",2013-02-04 06:59:20,2010-02-01 10:32:08,2010-03-19 08:59:37,1566
1656,400,880,2936,"45 days, 22:35:13",2013-02-07 00:43:09,2010-02-01 10:32:08,2010-03-19 09:07:21,4936
1567,445,460,2472,"45 days, 22:47:35",2013-02-06 01:37:02,2010-02-01 10:32:08,2010-03-19 09:19:43,2193
36,1287,1663,2986,"45 days, 22:48:18",2013-02-06 00:52:32,2010-02-01 10:32:08,2010-03-19 09:20:26,2230
242,492,688,1422,"45 days, 23:07:18",2013-02-07 10:36:26,2010-02-01 10:32:08,2010-03-19 09:39:26,2717
994,2932,3244,7170,"45 days, 23:09:37",2013-02-07 08:55:49,2010-02-01 10:32:08,2010-03-19 09:41:45,1897
535,6733,5700,12968,"45 days, 23:23:00",2013-02-08 11:22:02,2010-02-01 10:32:08,2010-03-19 09:55:08,599
241,880,1144,2265,"45 days, 23:25:58",2013-02-06 06:46:56,2010-02-01 10:32:08,2010-03-19 09:58:06,2511
187,2101,3043,5331,"45 days, 23:31:32",2013-02-06 00:48:41,2010-03-10 07:11:11,2010-04-25 06:42:43,9428
161,6838,6132,13131,"45 days, 23:54:38",2013-02-07 07:31:15,2010-02-01 10:32:08,2010-03-19 10:26:46,562
243,753,2039,3035,"46 days, 0:04:11",2013-02-07 11:56:37,2010-02-01 10:32:08,2010-03-19 10:36:19,9795
238,3271,6329,9838,"46 days, 0:14:28",2013-02-05 11:47:43,2010-02-01 10:32:08,2010-03-19 10:46:36,4304
158,160,312,630,"46 days, 0:21:21",2013-02-03 07:01:02,2010-02-01 10:32:08,2010-03-19 10:53:29,1185
628,2335,3928,6891,"46 days, 0:56:23",2013-02-05 05:15:44,2010-02-01 10:32:08,2010-03-19 11:28:31,1095
222,79,354,655,"46 days, 1:27:09",2013-02-01 03:22:56,2010-02-01 10:32:08,2010-03-19 11:59:17,1536
509,116,275,900,"46 days, 2:34:00",2013-02-04 10:35:26,2010-03-23 03:24:52,2010-05-08 05:58:52,7294
104,516,843,1463,"46 days, 6:44:55",2013-02-05 09:32:42,2010-05-22 00:51:52,2010-07-07 07:36:47,4440
332,338,795,1465,"46 days, 11:24:33",2013-02-05 08:20:32,2010-03-09 00:18:04,2010-04-24 11:42:37,1762
52,1719,2348,4119,"46 days, 13:44:54",2013-02-07 07:58:53,2010-02-01 10:32:08,2010-03-20 00:17:02,189
287,411,512,1210,"46 days, 14:02:47",2013-02-06 03:33:24,2010-02-01 10:32:08,2010-03-20 00:34:55,2943
369,113,263,745,"46 days, 14:15:26",2013-02-07 04:11:09,2010-10-25 10:05:10,2010-12-11 00:20:36,8217
25,968,1560,2553,"46 days, 14:47:23",2013-02-06 04:47:15,2010-02-01 10:32:08,2010-03-20 01:19:31,3355
824,765,1521,3110,"46 days, 15:08:00",2013-02-05 00:12:35,2010-02-01 10:32:08,2010-03-20 01:40:08,5347
466,395,1093,1954,"46 days, 15:40:49",2013-02-03 11:05:52,2010-02-01 10:32:08,2010-03-20 02:12:57,2332
1101,469,760,2330,"46 days, 15:44:20",2013-02-05 06:26:27,2010-02-01 10:32:08,2010-03-20 02:16:28,4617
185,610,1721,2516,"46 days, 15:49:07",2013-02-06 10:49:17,2010-02-01 10:32:08,2010-03-20 02:21:15,6835
836,1320,1323,3479,"46 days, 16:06:45",2013-02-03 06:00:50,2010-02-01 10:32:08,2010-03-20 02:38:53,7671
807,1199,1316,3322,"46 days, 16:07:19",2013-02-04 10:35:17,2010-02-01 10:32:08,2010-03-20 02:39:27,121
121,401,813,1335,"46 days, 16:08:40",2013-02-04 06:48:55,2010-02-01 10:32:08,2010-03-20 02:40:48,4143
770,475,616,1861,"46 days, 16:08:52",2013-02-04 11:23:24,2010-02-01 10:32:08,2010-03-20 02:41:00,8582
270,1290,1585,3145,"46 days, 16:36:16",2013-02-06 03:00:57,2010-02-01 10:32:08,2010-03-20 03:08:24,4014
636,798,1263,2697,"46 days, 17:41:00",2013-02-05 06:54:15,2010-02-01 10:32:08,2010-03-20 04:13:08,2132
867,157,366,1390,"46 days, 18:27:53",2013-02-01 05:24:27,2010-02-01 10:32:08,2010-03-20 05:00:01,1256
1249,372,1135,2756,"46 days, 18:39:11",2013-02-04 06:33:45,2010-02-01 10:32:08,2010-03-20 05:11:19,7007
324,4583,4536,9443,"46 days, 18:48:31",2013-02-06 11:56:07,2010-02-01 10:32:08,2010-03-20 05:20:39,4167
338,32,311,681,"46 days, 19:15:07",2013-02-03 07:17:20,2010-02-01 10:32:08,2010-03-20 05:47:15,579
1018,5,0,1023,"46 days, 19:23:02",2013-01-28 11:30:05,2011-08-19 11:26:42,2011-10-05 06:49:44,8265
1472,274,1065,2811,"46 days, 19:31:17",2013-02-04 01:58:40,2010-02-01 10:32:08,2010-03-20 06:03:25,1854
1061,2780,3519,7360,"46 days, 19:46:55",2013-02-04 08:06:45,2010-02-01 10:32:08,2010-03-20 06:19:03,7289
437,327,712,1476,"46 days, 19:52:10",2013-02-06 10:32:56,2010-02-01 10:32:08,2010-03-20 06:24:18,3595
98,703,1524,2325,"46 days, 20:06:46",2013-02-06 07:05:04,2010-02-01 10:32:08,2010-03-20 06:38:54,1601
1777,9026,7965,18768,"46 days, 20:18:37",2013-02-06 03:56:19,2010-02-01 10:32:08,2010-03-20 06:50:45,4087
322,173,457,952,"46 days, 20:32:54",2013-02-05 10:15:53,2010-02-01 10:32:08,2010-03-20 07:05:02,559
71,159,376,606,"46 days, 20:36:58",2013-02-02 05:46:46,2010-03-06 05:22:58,2010-04-22 01:59:56,857
130,1179,1605,2914,"46 days, 20:45:21",2013-02-06 01:06:11,2010-02-01 10:32:08,2010-03-20 07:17:29,1493
682,667,1315,2664,"46 days, 20:55:12",2013-02-07 04:22:13,2010-02-01 10:32:08,2010-03-20 07:27:20,8634
45,185,354,584,"46 days, 21:02:31",2013-02-02 04:32:20,2010-02-01 10:32:08,2010-03-20 07:34:39,2643
284,182,312,778,"46 days, 21:10:03",2013-02-07 08:19:23,2010-02-01 10:32:08,2010-03-20 07:42:11,5078
726,395,982,2103,"46 days, 21:31:19",2013-02-03 01:23:38,2010-02-01 10:32:08,2010-03-20 08:03:27,8387
1300,1919,3027,6246,"46 days, 21:31:38",2013-02-05 08:24:10,2010-02-01 10:32:08,2010-03-20 08:03:46,664
1446,917,1730,4093,"46 days, 21:43:46",2013-02-06 01:29:58,2010-02-01 10:32:08,2010-03-20 08:15:54,9058
382,689,935,2006,"46 days, 22:05:26",2013-02-18 05:20:13,2010-02-01 10:32:08,2010-03-20 08:37:34,2766
2624,6930,6400,15954,"46 days, 22:13:22",2013-02-07 04:08:09,2010-02-15 04:16:48,2010-04-03 02:30:10,680
900,3809,2902,7611,"46 days, 22:14:02",2013-02-06 02:32:06,2010-02-01 10:32:08,2010-03-20 08:46:10,4054
407,1342,2584,4333,"46 days, 22:24:47",2013-02-07 07:49:49,2010-02-01 10:32:08,2010-03-20 08:56:55,6919
969,454,1611,3034,"46 days, 22:34:09",2013-02-07 04:12:14,2010-02-01 10:32:08,2010-03-20 09:06:17,7849
1741,1010,1838,4589,"46 days, 22:42:23",2013-02-07 09:15:55,2010-02-01 10:32:08,2010-03-20 09:14:31,6615
522,686,1235,2443,"46 days, 23:24:49",2013-02-07 01:37:00,2010-02-01 10:32:08,2010-03-20 09:56:57,1515
1569,284,678,2531,"46 days, 23:33:04",2013-02-05 09:32:20,2010-02-01 10:32:08,2010-03-20 10:05:12,7891
67,1020,1732,2819,"46 days, 23:38:47",2013-02-04 10:27:12,2010-02-01 10:32:08,2010-03-20 10:10:55,5611
1010,0,18,1028,"46 days, 23:58:51",2013-01-31 11:34:43,2010-02-01 10:32:08,2010-03-20 10:30:59,1488
174,1568,3106,4848,"46 days, 23:59:11",2013-02-07 01:29:42,2010-02-01 10:32:08,2010-03-20 10:31:19,2524
221,555,1425,2201,"47 days, 0:25:53",2013-02-06 04:36:44,2010-02-01 10:32:08,2010-03-20 10:58:01,2664
32,2137,3165,5334,"47 days, 0:31:28",2013-02-07 04:04:34,2010-02-01 10:32:08,2010-03-20 11:03:36,6362
1173,628,766,2567,"47 days, 0:33:52",2013-02-07 04:13:40,2010-02-01 10:32:08,2010-03-20 11:06:00,7134
533,1034,1488,3055,"47 days, 0:37:10",2013-02-06 06:24:51,2010-02-01 10:32:08,2010-03-20 11:09:18,4369
969,0,35,1004,"47 days, 0:49:14",2013-02-13 11:42:38,2011-04-21 04:47:18,2011-06-07 05:36:32,5623
1382,1614,2653,5649,"47 days, 0:53:55",2013-02-07 02:39:52,2010-02-01 10:32:08,2010-03-20 11:26:03,9848
556,773,958,2287,"47 days, 1:07:59",2013-02-06 05:59:14,2010-02-01 10:32:08,2010-03-20 11:40:07,7894
17,1840,2162,4019,"47 days, 1:08:43",2013-02-06 00:39:42,2010-02-01 10:32:08,2010-03-20 11:40:51,7773
1125,4580,8323,14028,"47 days, 1:11:54",2013-02-07 00:32:56,2010-02-01 10:32:08,2010-03-20 11:44:02,6503
253,121,113,487,"47 days, 4:17:26",2013-02-04 00:13:56,2010-05-27 02:38:14,2010-07-13 06:55:40,3113
1013,8,129,1150,"47 days, 5:57:00",2013-02-06 05:53:20,2010-03-30 03:34:45,2010-05-16 09:31:45,4776
417,306,702,1425,"47 days, 12:28:12",2013-02-05 02:58:47,2010-09-19 11:37:05,2010-11-06 00:05:17,4736
498,24,199,721,"47 days, 13:32:12",2013-02-01 01:53:30,2010-02-01 10:32:08,2010-03-21 00:04:20,7714
487,4755,6914,12156,"47 days, 14:02:54",2013-02-15 11:07:43,2010-02-01 10:32:08,2010-03-21 00:35:02,2706
238,811,1032,2081,"47 days, 14:03:30",2013-02-04 06:52:48,2010-02-01 10:32:08,2010-03-21 00:35:38,1006
749,806,1221,2776,"47 days, 14:12:01",2013-02-06 11:20:01,2010-02-01 10:32:08,2010-03-21 00:44:09,2732
892,461,1515,2868,"47 days, 14:26:44",2013-02-04 11:18:59,2010-02-01 10:32:08,2010-03-21 00:58:52,3537
728,437,1035,2200,"47 days, 14:31:14",2013-02-08 08:04:08,2010-02-01 10:32:08,2010-03-21 01:03:22,546
5,351,982,1338,"47 days, 15:13:44",2013-02-06 01:13:49,2010-02-01 10:32:08,2010-03-21 01:45:52,4215
601,1648,2179,4428,"47 days, 15:39:04",2013-02-07 02:18:57,2010-02-01 10:32:08,2010-03-21 02:11:12,2055
1048,609,741,2398,"47 days, 15:41:03",2013-02-04 11:40:56,2010-02-01 10:32:08,2010-03-21 02:13:11,4144
782,5344,6239,12365,"47 days, 16:10:51",2013-02-07 01:31:09,2010-02-01 10:32:08,2010-03-21 02:42:59,8307
862,1592,2268,4722,"47 days, 16:32:54",2013-02-12 01:26:11,2010-02-01 10:32:08,2010-03-21 03:05:02,3693
2384,2304,3511,8199,"47 days, 16:34:08",2013-02-06 10:57:26,2010-02-01 10:32:08,2010-03-21 03:06:16,658
2153,5121,6214,13488,"47 days, 16:43:39",2013-02-06 01:36:58,2010-02-01 10:32:08,2010-03-21 03:15:47,2355
51,686,1668,2405,"47 days, 17:10:33",2013-02-07 02:28:46,2010-02-01 10:32:08,2010-03-21 03:42:41,1796
875,1903,2298,5076,"47 days, 17:15:40",2013-02-06 10:03:42,2010-02-01 10:32:08,2010-03-21 03:47:48,9835
1045,1238,2638,4921,"47 days, 17:17:26",2013-02-06 10:41:35,2010-02-01 10:32:08,2010-03-21 03:49:34,7071
141,502,677,1320,"47 days, 17:21:09",2013-02-06 02:00:26,2010-02-01 10:32:08,2010-03-21 03:53:17,2584
245,1805,1778,3828,"47 days, 17:24:00",2013-02-05 08:08:11,2010-02-01 10:32:08,2010-03-21 03:56:08,2896
75,3050,4139,7264,"47 days, 17:46:22",2013-02-07 04:20:56,2010-02-01 10:32:08,2010-03-21 04:18:30,9946
1730,4537,6371,12638,"47 days, 17:50:57",2013-02-07 08:08:30,2010-02-01 10:32:08,2010-03-21 04:23:05,3985
13,721,1096,1830,"47 days, 17:57:12",2013-02-05 04:50:32,2010-02-01 10:32:08,2010-03-21 04:29:20,9356
184,1119,1142,2445,"47 days, 18:41:19",2013-02-06 08:17:03,2010-02-01 10:32:08,2010-03-21 05:13:27,3126
439,864,1114,2417,"47 days, 18:45:39",2013-02-04 00:30:27,2010-02-01 10:32:08,2010-03-21 05:17:47,5007
134,211,287,632,"47 days, 18:55:05",2013-02-06 11:42:45,2010-02-01 10:32:08,2010-03-21 05:27:13,6984
46,51,453,550,"47 days, 19:25:47",2013-02-05 05:34:05,2010-02-01 10:32:08,2010-03-21 05:57:55,1062
24,253,618,895,"47 days, 19:33:23",2013-02-06 07:10:05,2010-02-01 10:32:08,2010-03-21 06:05:31,3411
127,2337,2796,5260,"47 days, 19:49:52",2013-02-06 03:04:39,2010-02-01 10:32:08,2010-03-21 06:22:00,9276
1430,1180,1202,3812,"47 days, 19:51:11",2013-02-04 07:37:21,2010-02-01 10:32:08,2010-03-21 06:23:19,828
786,979,2054,3819,"47 days, 20:05:02",2013-02-07 08:17:28,2010-02-01 10:32:08,2010-03-21 06:37:10,2057
1068,685,704,2457,"47 days, 20:11:44",2013-02-06 03:32:58,2010-02-01 10:32:08,2010-03-21 06:43:52,8561
821,7530,6640,14991,"47 days, 20:22:06",2013-02-07 05:12:22,2010-02-01 10:32:08,2010-03-21 06:54:14,4560
461,857,1574,2892,"47 days, 20:29:28",2013-02-08 08:20:21,2010-02-01 10:32:08,2010-03-21 07:01:36,8427
691,261,521,1473,"47 days, 20:34:55",2013-02-05 00:03:20,2010-02-01 10:32:08,2010-03-21 07:07:03,5027
1272,311,622,2205,"47 days, 20:38:29",2013-02-05 05:45:04,2010-02-01 10:32:08,2010-03-21 07:10:37,934
487,1363,1934,3784,"47 days, 20:41:25",2013-02-06 05:01:39,2010-02-01 10:32:08,2010-03-21 07:13:33,799
1155,672,1014,2841,"47 days, 21:15:34",2013-02-04 00:12:19,2010-02-01 10:32:08,2010-03-21 07:47:42,6063
1949,8284,6509,16742,"47 days, 21:25:25",2013-02-07 07:05:06,2010-02-01 10:32:08,2010-03-21 07:57:33,782
373,1205,2598,4176,"47 days, 21:32:36",2013-02-11 01:08:34,2010-02-01 10:32:08,2010-03-21 08:04:44,1120
572,878,1597,3047,"47 days, 21:44:24",2013-02-05 07:41:53,2010-02-01 10:32:08,2010-03-21 08:16:32,9751
33,1051,1704,2788,"47 days, 21:59:16",2013-02-05 03:51:17,2010-02-01 10:32:08,2010-03-21 08:31:24,1000
756,383,1080,2219,"47 days, 22:08:49",2013-02-07 07:28:02,2010-02-01 10:32:08,2010-03-21 08:40:57,6805
138,2925,4320,7383,"47 days, 22:12:48",2013-02-09 11:28:37,2010-02-01 10:32:08,2010-03-21 08:44:56,7864
1294,1214,1530,4038,"47 days, 22:35:23",2013-02-06 06:45:16,2010-02-01 10:32:08,2010-03-21 09:07:31,2439
805,3502,4763,9070,"47 days, 22:40:24",2013-02-06 11:49:35,2010-02-01 10:32:08,2010-03-21 09:12:32,7816
205,1335,1803,3343,"47 days, 22:43:36",2013-02-06 02:38:13,2010-02-01 10:32:08,2010-03-21 09:15:44,1169
7,160,323,490,"47 days, 22:51:05",2013-02-06 01:47:53,2010-02-01 10:32:08,2010-03-21 09:23:13,9215
102,1007,2421,3530,"47 days, 22:54:28",2013-02-06 04:23:51,2010-02-01 10:32:08,2010-03-21 09:26:36,8371
31,12,108,151,"47 days, 22:54:30",2013-01-29 10:30:48,2010-05-22 01:13:46,2010-07-09 00:08:16,543
243,46,252,541,"47 days, 23:08:13",2013-02-01 04:59:58,2010-04-23 04:06:15,2010-06-10 03:14:28,8232
122,1599,2240,3961,"47 days, 23:08:39",2013-02-12 09:26:49,2010-02-01 10:32:08,2010-03-21 09:40:47,5302
477,8979,7770,17226,"47 days, 23:10:18",2013-02-07 05:20:04,2010-02-01 10:32:08,2010-03-21 09:42:26,3287
946,14,183,1143,"47 days, 23:10:57",2013-01-25 04:04:28,2010-02-01 10:32:08,2010-03-21 09:43:05,1053
491,140,432,1063,"47 days, 23:15:12",2013-02-05 09:55:23,2010-02-01 10:32:08,2010-03-21 09:47:20,3008
903,4579,5800,11282,"47 days, 23:22:19",2013-02-07 07:51:02,2010-02-01 10:32:08,2010-03-21 09:54:27,7429
302,563,796,1661,"47 days, 23:24:24",2013-02-05 06:40:57,2010-02-01 10:32:08,2010-03-21 09:56:32,368
408,1694,3286,5388,"47 days, 23:25:17",2013-02-08 06:08:19,2010-02-01 10:32:08,2010-03-21 09:57:25,4630
147,828,877,1852,"47 days, 23:27:46",2013-02-07 03:27:30,2010-02-01 10:32:08,2010-03-21 09:59:54,7020
1109,2708,3412,7229,"47 days, 23:32:23",2013-02-06 04:39:34,2010-02-01 10:32:08,2010-03-21 10:04:31,980
1281,1883,2481,5645,"47 days, 23:32:57",2013-02-06 06:53:11,2010-02-01 10:32:08,2010-03-21 10:05:05,22
306,701,1523,2530,"47 days, 23:44:02",2013-02-05 02:06:37,2010-02-01 10:32:08,2010-03-21 10:16:10,9649
180,528,448,1156,"47 days, 23:44:35",2013-02-06 02:32:52,2010-02-01 10:32:08,2010-03-21 10:16:43,5955
785,4119,5337,10241,"47 days, 23:45:05",2013-02-06 11:25:48,2010-02-01 10:32:08,2010-03-21 10:17:13,1040
424,238,229,891,"47 days, 23:58:57",2013-02-01 11:27:13,2010-02-01 10:32:08,2010-03-21 10:31:05,2826
248,1899,3085,5232,"48 days, 0:04:23",2013-02-06 03:08:33,2010-02-01 10:32:08,2010-03-21 10:36:31,9604
976,3659,4439,9074,"48 days, 0:05:23",2013-02-05 07:10:15,2010-02-01 10:32:08,2010-03-21 10:37:31,2453
184,1163,1199,2546,"48 days, 0:33:21",2013-02-06 02:46:35,2010-02-01 10:32:08,2010-03-21 11:05:29,1101
6,621,752,1379,"48 days, 0:46:48",2013-02-05 10:06:18,2010-02-01 10:32:08,2010-03-21 11:18:56,6661
1170,2210,3378,6758,"48 days, 0:49:02",2013-02-04 05:27:39,2010-02-27 04:42:14,2010-04-16 05:31:16,5653
388,2441,2221,5050,"48 days, 1:03:07",2013-02-07 09:56:06,2010-02-01 10:32:08,2010-03-21 11:35:15,324
1223,2696,2887,6806,"48 days, 1:10:10",2013-02-06 06:18:03,2010-02-01 10:32:08,2010-03-21 11:42:18,5029
443,580,564,1587,"48 days, 2:55:37",2013-02-06 05:06:16,2010-03-14 04:03:23,2010-05-01 06:59:00,5939
526,223,387,1136,"48 days, 8:47:11",2013-02-01 09:56:28,2010-05-01 02:45:06,2010-06-18 11:32:17,7661
843,1462,2314,4619,"48 days, 13:42:52",2013-02-06 06:36:43,2010-02-01 10:32:08,2010-03-22 00:15:00,3215
411,251,502,1164,"48 days, 13:52:39",2013-02-06 00:12:40,2010-02-01 10:32:08,2010-03-22 00:24:47,694
405,2289,2645,5339,"48 days, 14:03:20",2013-02-06 07:49:12,2010-02-01 10:32:08,2010-03-22 00:35:28,4397
137,3510,4460,8107,"48 days, 14:08:12",2013-02-17 01:44:22,2010-02-01 10:32:08,2010-03-22 00:40:20,4120
510,905,1559,2974,"48 days, 14:11:20",2013-02-03 10:32:58,2010-02-01 10:32:08,2010-03-22 00:43:28,5074
70,130,468,668,"48 days, 14:12:04",2013-02-06 02:50:29,2010-02-01 10:32:08,2010-03-22 00:44:12,4426
379,241,649,1269,"48 days, 15:05:45",2013-02-06 09:34:45,2010-02-01 10:32:08,2010-03-22 01:37:53,4408
311,3173,3330,6814,"48 days, 15:11:26",2013-02-07 03:07:15,2010-02-01 10:32:08,2010-03-22 01:43:34,5130
751,6055,7140,13946,"48 days, 15:16:13",2013-02-11 09:29:14,2010-02-01 10:32:08,2010-03-22 01:48:21,4176
266,404,608,1278,"48 days, 15:26:56",2013-02-06 10:15:06,2010-02-01 10:32:08,2010-03-22 01:59:04,1972
163,167,760,1090,"48 days, 15:37:34",2013-02-03 02:37:02,2010-02-01 10:32:08,2010-03-22 02:09:42,4207
51,2472,3603,6126,"48 days, 15:38:16",2013-02-10 07:13:20,2010-02-01 10:32:08,2010-03-22 02:10:24,7307
795,1062,1502,3359,"48 days, 15:39:29",2013-02-05 05:40:15,2010-02-01 10:32:08,2010-03-22 02:11:37,2032
485,596,657,1738,"48 days, 15:44:06",2013-02-04 10:29:06,2010-02-01 10:32:08,2010-03-22 02:16:14,9830
346,1663,1587,3596,"48 days, 15:51:46",2013-02-06 05:40:18,2010-02-01 10:32:08,2010-03-22 02:23:54,7592
1677,9355,6425,17457,"48 days, 16:08:13",2013-02-06 10:30:43,2010-02-01 10:32:08,2010-03-22 02:40:21,9693
53,1169,1813,3035,"48 days, 16:09:15",2013-02-07 03:37:58,2010-02-01 10:32:08,2010-03-22 02:41:23,3491
99,2539,2856,5494,"48 days, 16:22:35",2013-02-07 09:26:46,2010-02-01 10:32:08,2010-03-22 02:54:43,832
52,969,1404,2425,"48 days, 16:45:01",2013-02-06 01:15:21,2010-02-01 10:32:08,2010-03-22 03:17:09,7718
689,1466,2079,4234,"48 days, 16:49:07",2013-02-09 11:43:58,2010-02-01 10:32:08,2010-03-22 03:21:15,1733
9,324,565,898,"48 days, 16:56:17",2013-02-04 06:02:18,2010-02-01 10:32:08,2010-03-22 03:28:25,6804
783,3983,4098,8864,"48 days, 16:57:06",2013-02-07 06:35:26,2010-02-01 10:32:08,2010-03-22 03:29:14,6301
708,3868,5019,9595,"48 days, 17:00:46",2013-02-07 09:36:10,2010-02-01 10:32:08,2010-03-22 03:32:54,5273
194,274,511,979,"48 days, 17:38:40",2013-02-03 00:44:36,2010-02-01 10:32:08,2010-03-22 04:10:48,8592
99,293,487,879,"48 days, 17:39:17",2013-01-27 03:07:03,2010-02-01 10:32:08,2010-03-22 04:11:25,4105
1313,2609,2851,6773,"48 days, 17:51:17",2013-02-06 09:08:02,2010-02-01 10:32:08,2010-03-22 04:23:25,4067
747,1267,2808,4822,"48 days, 18:31:46",2013-02-05 09:10:53,2010-02-01 10:32:08,2010-03-22 05:03:54,4130
234,133,187,554,"48 days, 18:38:11",2013-01-26 08:21:00,2010-02-01 10:32:08,2010-03-22 05:10:19,8831
107,97,508,712,"48 days, 18:43:54",2013-02-04 10:08:18,2010-02-01 10:32:08,2010-03-22 05:16:02,9908
414,244,485,1143,"48 days, 18:45:25",2013-02-05 09:45:34,2010-02-01 10:32:08,2010-03-22 05:17:33,9855
1267,1894,2888,6049,"48 days, 18:54:41",2013-02-05 08:08:40,2010-02-01 10:32:08,2010-03-22 05:26:49,4513
844,1247,2122,4213,"48 days, 18:59:54",2013-02-05 04:18:47,2010-02-01 10:32:08,2010-03-22 05:32:02,4261
48,2925,6984,9957,"48 days, 19:17:29",2013-02-07 08:49:16,2010-02-01 10:32:08,2010-03-22 05:49:37,9495
1455,352,511,2318,"48 days, 19:31:44",2013-02-05 09:33:12,2010-02-01 10:32:08,2010-03-22 06:03:52,4337
352,385,938,1675,"48 days, 20:20:37",2013-02-06 11:11:15,2010-02-01 10:32:08,2010-03-22 06:52:45,4338
610,8137,6038,14785,"48 days, 20:45:53",2013-02-07 10:50:41,2010-02-01 10:32:08,2010-03-22 07:18:01,8418
1011,0,0,1011,"48 days, 20:50:39",2013-01-24 05:38:57,2010-02-01 10:32:08,2010-03-22 07:22:47,9021
479,2941,3903,7323,"48 days, 20:55:00",2013-02-06 11:54:21,2010-02-01 10:32:08,2010-03-22 07:27:08,6559
326,695,1207,2228,"48 days, 21:13:48",2013-02-07 07:54:42,2010-02-01 10:32:08,2010-03-22 07:45:56,8237
77,2470,2583,5130,"48 days, 21:16:14",2013-02-04 04:43:46,2010-02-01 10:32:08,2010-03-22 07:48:22,5717
1136,322,1085,2543,"48 days, 21:44:10",2013-02-03 09:33:10,2010-02-01 10:32:08,2010-03-22 08:16:18,9791
33,1450,1721,3204,"48 days, 21:46:17",2013-02-15 00:31:46,2010-03-19 11:07:01,2010-05-07 08:53:18,8586
177,786,676,1639,"48 days, 21:51:44",2013-02-04 04:51:23,2010-02-01 10:32:08,2010-03-22 08:23:52,2637
650,2258,3742,6650,"48 days, 22:08:49",2013-02-05 08:53:39,2010-02-01 10:32:08,2010-03-22 08:40:57,1797
596,870,1510,2976,"48 days, 22:15:51",2013-02-06 06:33:25,2010-02-01 10:32:08,2010-03-22 08:47:59,7052
1168,28,177,1373,"48 days, 22:17:48",2013-02-01 07:54:12,2010-02-01 10:32:08,2010-03-22 08:49:56,3601
294,3364,4895,8553,"48 days, 22:21:20",2013-02-07 05:41:15,2010-02-01 10:32:08,2010-03-22 08:53:28,4375
903,3635,3560,8098,"48 days, 22:28:45",2013-02-07 04:28:11,2010-02-01 10:32:08,2010-03-22 09:00:53,9808
451,335,712,1498,"48 days, 22:30:36",2013-02-04 03:06:27,2010-02-01 10:32:08,2010-03-22 09:02:44,4662
1007,374,835,2216,"48 days, 22:32:45",2013-02-03 03:18:50,2010-02-01 10:32:08,2010-03-22 09:04:53,2362
1286,236,873,2395,"48 days, 22:35:39",2013-02-06 02:28:02,2010-02-01 10:32:08,2010-03-22 09:07:47,125
592,2211,3670,6473,"48 days, 22:41:27",2013-02-06 07:03:30,2010-02-01 10:32:08,2010-03-22 09:13:35,8383
933,5867,7088,13888,"48 days, 22:51:00",2013-02-06 07:12:16,2010-02-01 10:32:08,2010-03-22 09:23:08,4112
96,1744,2466,4306,"48 days, 22:51:40",2013-02-06 06:22:44,2010-02-01 10:32:08,2010-03-22 09:23:48,9286
1149,229,482,1860,"48 days, 22:53:09",2013-02-02 05:45:51,2010-02-01 10:32:08,2010-03-22 09:25:17,8543
1529,3385,4060,8974,"48 days, 22:54:39",2013-02-07 11:26:58,2010-02-01 10:32:08,2010-03-22 09:26:47,8282
59,196,1134,1389,"48 days, 23:25:11",2013-02-05 11:20:53,2010-02-01 10:32:08,2010-03-22 09:57:19,1510
86,404,772,1262,"48 days, 23:30:06",2013-02-02 07:29:05,2010-02-01 10:32:08,2010-03-22 10:02:14,8420
1338,1403,1472,4213,"48 days, 23:31:18",2013-02-05 02:29:58,2010-02-01 10:32:08,2010-03-22 10:03:26,9970
259,1379,1666,3304,"48 days, 23:33:25",2013-02-06 07:57:47,2010-02-01 10:32:08,2010-03-22 10:05:33,7873
16,619,996,1631,"48 days, 23:45:00",2013-02-06 05:04:58,2010-02-01 10:32:08,2010-03-22 10:17:08,763
1399,14,81,1494,"48 days, 23:57:58",2013-02-05 06:17:01,2010-02-01 10:32:08,2010-03-22 10:30:06,7602
42,29,109,180,"49 days, 0:12:41",2013-02-01 09:54:11,2011-11-04 06:52:44,2011-12-23 07:05:25,1216
159,730,1166,2055,"49 days, 0:17:00",2013-02-05 03:58:14,2010-02-01 10:32:08,2010-03-22 10:49:08,9722
983,668,1789,3440,"49 days, 0:27:17",2013-02-05 07:25:30,2010-02-01 10:32:08,2010-03-22 10:59:25,6307
1128,893,2027,4048,"49 days, 0:40:13",2013-02-07 08:57:12,2010-02-01 10:32:08,2010-03-22 11:12:21,4193
939,495,739,2173,"49 days, 1:06:57",2013-02-03 04:56:28,2010-02-01 10:32:08,2010-03-22 11:39:05,8489
877,11,54,942,"49 days, 2:26:44",2013-02-05 07:21:05,2010-05-11 02:50:59,2010-06-29 05:17:43,3705
70,21,95,186,"49 days, 2:36:49",2013-02-06 10:20:57,2010-10-20 01:51:31,2010-12-08 04:28:20,3372
731,295,622,1648,"49 days, 2:37:14",2013-02-01 07:46:21,2010-03-27 01:19:21,2010-05-15 03:56:35,1131
152,486,876,1514,"49 days, 3:58:26",2013-02-07 01:43:39,2010-02-26 03:51:04,2010-04-16 07:49:30,6814
582,8,46,636,"49 days, 5:54:31",2013-02-02 06:01:36,2010-04-01 04:24:36,2010-05-20 10:19:07,3971
608,3421,3230,7259,"49 days, 13:31:25",2013-02-07 02:23:53,2010-02-01 10:32:08,2010-03-23 00:03:33,3768
213,6001,6845,13059,"49 days, 13:47:18",2013-02-07 11:29:32,2010-02-01 10:32:08,2010-03-23 00:19:26,4568
845,6315,5685,12845,"49 days, 14:34:26",2013-02-07 03:44:15,2010-02-01 10:32:08,2010-03-23 01:06:34,833
568,6472,5211,12251,"49 days, 14:54:11",2013-02-08 00:46:09,2010-02-01 10:32:08,2010-03-23 01:26:19,5477
1066,2285,3358,6709,"49 days, 15:01:47",2013-02-06 07:56:14,2010-02-01 10:32:08,2010-03-23 01:33:55,1360
1643,4872,6814,13329,"49 days, 15:24:57",2013-02-06 04:50:01,2010-02-01 10:32:08,2010-03-23 01:57:05,5393
622,626,1362,2610,"49 days, 15:30:18",2013-02-04 07:03:59,2010-02-01 10:32:08,2010-03-23 02:02:26,3608
1339,25,227,1591,"49 days, 15:31:28",2013-02-01 01:07:38,2010-02-01 10:32:08,2010-03-23 02:03:36,7751
550,2900,4661,8111,"49 days, 15:35:06",2013-02-08 02:20:35,2010-02-01 10:32:08,2010-03-23 02:07:14,5193
18,50,332,400,"49 days, 15:39:12",2013-02-06 01:13:02,2010-02-01 10:32:08,2010-03-23 02:11:20,3475
678,1393,2220,4291,"49 days, 15:44:35",2013-02-05 10:25:11,2010-02-01 10:32:08,2010-03-23 02:16:43,8767
250,4400,4657,9307,"49 days, 15:45:32",2013-02-06 07:49:24,2010-02-01 10:32:08,2010-03-23 02:17:40,5788
349,2612,3788,6749,"49 days, 15:45:38",2013-02-06 08:57:37,2010-02-01 10:32:08,2010-03-23 02:17:46,4055
655,2090,3400,6145,"49 days, 16:01:21",2013-02-09 01:37:14,2010-02-01 10:32:08,2010-03-23 02:33:29,7192
252,861,1369,2482,"49 days, 16:05:49",2013-02-04 07:14:56,2010-02-01 10:32:08,2010-03-23 02:37:57,6312
1884,1131,1613,4628,"49 days, 16:31:04",2013-02-07 04:27:00,2010-02-01 10:32:08,2010-03-23 03:03:12,6372
558,697,1192,2447,"49 days, 16:33:22",2013-02-06 06:56:57,2010-02-01 10:32:08,2010-03-23 03:05:30,4810
110,1349,2122,3581,"49 days, 16:48:03",2013-02-07 05:43:14,2010-02-01 10:32:08,2010-03-23 03:20:11,2783
1636,1284,2595,5515,"49 days, 16:53:03",2013-02-07 08:58:10,2010-02-01 10:32:08,2010-03-23 03:25:11,5830
1223,1180,2432,4835,"49 days, 17:03:19",2013-02-25 01:49:24,2010-02-01 10:32:08,2010-03-23 03:35:27,7337
464,323,680,1467,"49 days, 17:39:09",2013-02-03 10:01:41,2010-02-01 10:32:08,2010-03-23 04:11:17,7950
513,1787,2618,4918,"49 days, 17:40:17",2013-02-06 06:56:54,2010-02-01 10:32:08,2010-03-23 04:12:25,8770
456,204,654,1314,"49 days, 18:10:33",2013-02-07 00:22:03,2010-02-01 10:32:08,2010-03-23 04:42:41,34
236,999,2102,3337,"49 days, 18:21:18",2013-02-04 01:28:10,2010-02-01 10:32:08,2010-03-23 04:53:26,9289
193,4948,7004,12145,"49 days, 18:30:33",2013-02-06 08:16:14,2010-02-01 10:32:08,2010-03-23 05:02:41,6413
249,155,497,901,"49 days, 18:34:02",2013-02-06 09:27:06,2010-02-01 10:32:08,2010-03-23 05:06:10,5628
1288,0,1,1289,"49 days, 18:37:30",2013-01-27 08:26:37,2012-06-12 05:26:31,2012-08-01 00:04:01,800
919,726,1393,3038,"49 days, 18:37:50",2013-02-06 11:20:59,2010-02-01 10:32:08,2010-03-23 05:09:58,3330
2171,2340,3402,7913,"49 days, 18:59:31",2013-02-07 07:39:48,2010-02-01 10:32:08,2010-03-23 05:31:39,8544
309,205,160,674,"49 days, 19:18:57",2013-01-11 10:06:43,2013-01-11 10:06:43,2013-03-02 05:25:40,5794
568,31,193,792,"49 days, 19:21:11",2013-02-03 01:18:15,2010-02-01 10:32:08,2010-03-23 05:53:19,5445
1748,844,1481,4073,"49 days, 19:41:08",2013-02-04 11:43:58,2010-02-01 10:32:08,2010-03-23 06:13:16,4363
694,4461,5274,10429,"49 days, 19:48:48",2013-02-07 02:25:27,2010-02-01 10:32:08,2010-03-23 06:20:56,5508
882,235,377,1494,"49 days, 20:03:13",2013-02-04 03:15:48,2010-02-01 10:32:08,2010-03-23 06:35:21,5685
456,25,147,628,"49 days, 20:03:49",2013-01-25 04:35:12,2010-02-01 10:32:08,2010-03-23 06:35:57,2009
405,1708,2491,4604,"49 days, 20:07:28",2013-02-06 10:00:28,2010-02-01 10:32:08,2010-03-23 06:39:36,7890
241,156,462,859,"49 days, 20:08:20",2013-02-06 04:44:02,2010-02-01 10:32:08,2010-03-23 06:40:28,2541
1083,2704,3023,6810,"49 days, 20:15:50",2013-02-07 03:43:31,2010-02-01 10:32:08,2010-03-23 06:47:58,6402
8,815,1171,1994,"49 days, 20:30:08",2013-02-06 05:17:43,2010-02-01 10:32:08,2010-03-23 07:02:16,1077
545,154,284,983,"49 days, 20:40:24",2013-02-02 09:33:42,2010-02-01 10:32:08,2010-03-23 07:12:32,5593
1046,19,74,1139,"49 days, 20:41:26",2013-02-02 03:06:03,2010-02-01 10:32:08,2010-03-23 07:13:34,1087
611,108,275,994,"49 days, 21:03:05",2013-01-31 00:48:08,2010-02-01 10:32:08,2010-03-23 07:35:13,5551
131,350,580,1061,"49 days, 21:11:08",2013-02-06 04:46:34,2010-02-01 10:32:08,2010-03-23 07:43:16,3038
928,75,309,1312,"49 days, 21:23:18",2013-02-05 05:44:32,2010-03-29 11:55:29,2010-05-18 09:18:47,7728
870,24,181,1075,"49 days, 21:43:19",2013-02-07 01:57:41,2010-03-26 09:06:06,2010-05-15 06:49:25,217
710,1026,2038,3774,"49 days, 21:47:32",2013-02-06 01:43:32,2010-02-01 10:32:08,2010-03-23 08:19:40,8352
1430,269,871,2570,"49 days, 21:53:46",2013-01-29 10:22:48,2010-02-01 10:32:08,2010-03-23 08:25:54,6327
71,357,1022,1450,"49 days, 22:15:39",2013-02-06 07:10:08,2010-02-01 10:32:08,2010-03-23 08:47:47,1900
293,2465,2030,4788,"49 days, 22:31:19",2013-02-06 08:55:09,2010-02-01 10:32:08,2010-03-23 09:03:27,4119
885,297,827,2009,"49 days, 22:43:22",2013-02-04 11:07:07,2010-02-01 10:32:08,2010-03-23 09:15:30,2160
285,930,1370,2585,"49 days, 23:10:21",2013-02-06 10:00:02,2010-02-01 10:32:08,2010-03-23 09:42:29,1805
47,1343,2256,3646,"49 days, 23:23:06",2013-02-05 04:47:11,2010-02-01 10:32:08,2010-03-23 09:55:14,6766
1423,511,845,2779,"49 days, 23:26:29",2013-02-04 02:24:50,2010-02-01 10:32:08,2010-03-23 09:58:37,4540
271,95,507,873,"49 days, 23:30:37",2013-02-06 04:27:21,2010-02-01 10:32:08,2010-03-23 10:02:45,1337
791,172,491,1454,"49 days, 23:55:00",2013-02-05 04:24:45,2010-02-01 10:32:08,2010-03-23 10:27:08,5018
936,1289,2247,4472,"50 days, 0:20:58",2013-02-07 11:20:42,2010-02-01 10:32:08,2010-03-23 10:53:06,7906
390,212,537,1139,"50 days, 0:21:14",2013-02-02 10:42:24,2010-02-01 10:32:08,2010-03-23 10:53:22,1995
402,2977,3604,6983,"50 days, 0:23:16",2013-02-06 09:11:01,2010-02-01 10:32:08,2010-03-23 10:55:24,5251
1487,2059,1941,5487,"50 days, 0:30:06",2013-02-06 10:43:16,2010-02-01 10:32:08,2010-03-23 11:02:14,3059
422,2069,2742,5233,"50 days, 0:36:31",2013-02-06 04:22:19,2010-02-01 10:32:08,2010-03-23 11:08:39,4864
1415,367,624,2406,"50 days, 0:38:43",2013-02-06 09:30:16,2010-02-01 10:32:08,2010-03-23 11:10:51,6089
382,7076,7760,15218,"50 days, 0:40:56",2013-02-06 06:24:57,2010-02-01 10:32:08,2010-03-23 11:13:04,2088
426,459,884,1769,"50 days, 0:46:00",2013-02-06 01:13:16,2010-04-11 07:04:03,2010-05-31 07:50:03,7541
1041,1804,2832,5677,"50 days, 0:46:02",2013-02-07 06:07:08,2010-02-01 10:32:08,2010-03-23 11:18:10,4185
257,268,535,1060,"50 days, 1:05:19",2013-02-03 07:20:13,2010-02-01 10:32:08,2010-03-23 11:37:27,7954
129,359,736,1224,"50 days, 1:11:08",2013-02-06 08:20:09,2010-02-01 10:32:08,2010-03-23 11:43:16,2232
17,587,1467,2071,"50 days, 1:16:49",2013-02-05 05:50:32,2010-02-01 10:32:08,2010-03-23 11:48:57,864
1268,0,0,1268,"50 days, 2:13:30",2013-01-18 03:19:16,2010-12-17 01:23:39,2011-02-05 03:37:09,2675
239,646,883,1768,"50 days, 3:12:41",2013-02-05 11:13:16,2010-04-04 02:44:31,2010-05-24 05:57:12,1638
4,94,192,290,"50 days, 3:36:27",2013-01-11 01:49:13,2013-01-11 01:49:13,2013-03-02 05:25:40,8674
35,200,355,590,"50 days, 4:06:52",2013-02-04 00:48:17,2010-03-22 04:04:02,2010-05-11 08:10:54,3918
489,3850,4786,9125,"50 days, 14:00:46",2013-02-07 03:42:28,2010-02-01 10:32:08,2010-03-24 00:32:54,8002
144,642,1402,2188,"50 days, 14:03:56",2013-02-05 11:31:06,2010-02-01 10:32:08,2010-03-24 00:36:04,3026
2053,5327,5000,12380,"50 days, 14:07:08",2013-02-11 07:05:27,2010-02-01 10:32:08,2010-03-24 00:39:16,4084
217,1480,1359,3056,"50 days, 14:15:48",2013-02-06 02:09:37,2010-02-01 10:32:08,2010-03-24 00:47:56,1550
7,1237,1509,2753,"50 days, 14:17:36",2013-02-05 06:22:20,2010-02-01 10:32:08,2010-03-24 00:49:44,3746
42,2576,4026,6644,"50 days, 14:27:29",2013-02-06 02:50:12,2010-02-01 10:32:08,2010-03-24 00:59:37,2146
820,3228,2819,6867,"50 days, 14:27:37",2013-02-07 09:38:07,2010-02-01 10:32:08,2010-03-24 00:59:45,7676
4,379,680,1063,"50 days, 14:29:59",2013-02-05 03:25:54,2010-02-01 10:32:08,2010-03-24 01:02:07,8657
827,47,378,1252,"50 days, 14:57:33",2013-02-02 02:45:50,2010-02-01 10:32:08,2010-03-24 01:29:41,7037
563,5114,5482,11159,"50 days, 15:03:09",2013-02-13 02:57:58,2010-02-01 10:32:08,2010-03-24 01:35:17,756
1,158,399,558,"50 days, 15:11:35",2013-02-06 06:51:32,2010-02-01 10:32:08,2010-03-24 01:43:43,8745
430,300,548,1278,"50 days, 15:30:24",2013-01-31 02:09:28,2010-02-01 10:32:08,2010-03-24 02:02:32,4416
1279,3,85,1367,"50 days, 16:13:57",2013-01-18 07:44:45,2010-02-01 10:32:08,2010-03-24 02:46:05,3988
762,1733,3055,5550,"50 days, 16:28:29",2013-02-07 02:20:53,2010-02-01 10:32:08,2010-03-24 03:00:37,2304
33,285,444,762,"50 days, 16:31:54",2013-02-02 07:00:36,2010-02-01 10:32:08,2010-03-24 03:04:02,5638
801,4438,5056,10295,"50 days, 17:06:07",2013-02-06 10:37:24,2010-02-01 10:32:08,2010-03-24 03:38:15,7159
1495,3583,4282,9360,"50 days, 17:16:59",2013-02-07 11:03:59,2010-02-01 10:32:08,2010-03-24 03:49:07,4866
439,5276,5641,11356,"50 days, 17:18:53",2013-02-06 04:46:26,2010-02-01 10:32:08,2010-03-24 03:51:01,7228
632,6042,5242,11916,"50 days, 17:35:41",2013-02-06 09:01:11,2010-02-01 10:32:08,2010-03-24 04:07:49,2441
1805,4477,3433,9715,"50 days, 17:37:14",2013-02-07 03:24:56,2010-02-01 10:32:08,2010-03-24 04:09:22,2344
700,790,1722,3212,"50 days, 17:41:10",2013-02-05 03:03:52,2010-02-01 10:32:08,2010-03-24 04:13:18,4990
388,200,425,1013,"50 days, 17:41:44",2013-02-05 07:10:28,2010-02-01 10:32:08,2010-03-24 04:13:52,2748
146,700,1201,2047,"50 days, 17:44:21",2013-02-05 11:49:15,2010-02-01 10:32:08,2010-03-24 04:16:29,4063
18,244,791,1053,"50 days, 17:47:47",2013-02-06 00:21:40,2010-05-12 10:58:12,2010-07-02 04:45:59,2038
1066,0,44,1110,"50 days, 18:03:40",2013-01-30 00:40:53,2010-02-01 10:32:08,2010-03-24 04:35:48,203
259,1863,1644,3766,"50 days, 18:15:23",2013-02-07 00:34:38,2010-02-01 10:32:08,2010-03-24 04:47:31,6534
1173,1806,2811,5790,"50 days, 18:15:37",2013-02-07 00:22:55,2010-02-01 10:32:08,2010-03-24 04:47:45,1623
4,310,351,665,"50 days, 18:32:08",2013-02-05 08:03:24,2010-02-01 10:32:08,2010-03-24 05:04:16,1875
159,299,999,1457,"50 days, 18:49:34",2013-02-05 11:44:45,2010-02-01 10:32:08,2010-03-24 05:21:42,4180
1546,2791,2615,6952,"50 days, 19:02:41",2013-02-06 10:28:58,2010-02-01 10:32:08,2010-03-24 05:34:49,4122
268,1658,2063,3989,"50 days, 19:14:00",2013-02-06 07:02:12,2010-02-01 10:32:08,2010-03-24 05:46:08,7917
1286,1373,2788,5447,"50 days, 19:35:18",2013-02-07 04:11:42,2010-02-01 10:32:08,2010-03-24 06:07:26,8916
529,4785,5584,10898,"50 days, 19:37:17",2013-02-07 01:56:37,2010-02-01 10:32:08,2010-03-24 06:09:25,8899
458,583,734,1775,"50 days, 19:49:51",2013-02-03 01:30:46,2010-02-01 10:32:08,2010-03-24 06:21:59,5089
1032,67,94,1193,"50 days, 20:13:12",2013-01-30 10:09:12,2010-02-01 10:32:08,2010-03-24 06:45:20,2428
47,2737,3105,5889,"50 days, 20:15:52",2013-02-06 10:30:29,2010-02-01 10:32:08,2010-03-24 06:48:00,2994
1616,438,687,2741,"50 days, 20:17:19",2013-02-07 10:09:38,2010-02-01 10:32:08,2010-03-24 06:49:27,8495
106,25,183,314,"50 days, 20:53:39",2013-02-06 01:00:03,2010-02-01 10:32:08,2010-03-24 07:25:47,815
659,4039,4346,9044,"50 days, 21:21:01",2013-02-07 07:18:56,2010-02-01 10:32:08,2010-03-24 07:53:09,9958
58,1221,1787,3066,"50 days, 21:23:52",2013-02-07 05:53:20,2010-02-01 10:32:08,2010-03-24 07:56:00,2364
1138,1347,1994,4479,"50 days, 21:41:09",2013-02-06 11:07:05,2010-02-01 10:32:08,2010-03-24 08:13:17,3694
428,387,755,1570,"50 days, 22:02:10",2013-02-03 11:05:01,2010-02-01 10:32:08,2010-03-24 08:34:18,2486
633,2,27,662,"50 days, 22:19:29",2013-01-20 02:18:24,2012-02-10 06:24:49,2012-04-01 04:44:18,5049
65,639,1085,1789,"50 days, 23:23:17",2013-02-04 10:28:08,2010-02-01 10:32:08,2010-03-24 09:55:25,6325
762,1282,1389,3433,"50 days, 23:30:26",2013-02-05 08:47:35,2010-02-01 10:32:08,2010-03-24 10:02:34,5418
247,4549,5243,10039,"50 days, 23:35:18",2013-02-06 11:25:01,2010-02-01 10:32:08,2010-03-24 10:07:26,584
163,2011,3112,5286,"50 days, 23:35:57",2013-02-08 02:56:08,2010-02-01 10:32:08,2010-03-24 10:08:05,4042
112,3139,4563,7814,"50 days, 23:46:24",2013-02-07 02:44:07,2010-02-01 10:32:08,2010-03-24 10:18:32,1663
1396,1716,2871,5983,"50 days, 23:53:09",2013-02-05 11:16:47,2010-02-01 10:32:08,2010-03-24 10:25:17,1241
887,4231,4812,9930,"50 days, 23:54:18",2013-02-05 09:11:16,2010-02-01 10:32:08,2010-03-24 10:26:26,5824
1609,2597,2612,6818,"51 days, 0:02:14",2013-02-07 04:17:01,2010-02-01 10:32:08,2010-03-24 10:34:22,2778
427,375,415,1217,"51 days, 0:19:25",2013-01-29 08:29:20,2010-02-01 10:32:08,2010-03-24 10:51:33,7084
1046,499,884,2429,"51 days, 0:24:37",2013-02-05 05:43:04,2010-02-01 10:32:08,2010-03-24 10:56:45,8355
695,1358,2523,4576,"51 days, 0:45:45",2013-02-06 00:19:12,2010-02-01 10:32:08,2010-03-24 11:17:53,5307
674,3180,4666,8520,"51 days, 0:56:51",2013-02-07 00:07:08,2010-02-01 10:32:08,2010-03-24 11:28:59,1917
658,4612,3674,8944,"51 days, 1:03:41",2013-02-06 11:28:18,2010-02-01 10:32:08,2010-03-24 11:35:49,5
1027,665,1146,2838,"51 days, 1:06:36",2013-02-05 11:25:22,2010-02-01 10:32:08,2010-03-24 11:38:44,7264
331,1372,1947,3650,"51 days, 1:15:18",2013-02-04 05:06:27,2010-02-01 10:32:08,2010-03-24 11:47:26,685
807,3751,3805,8363,"51 days, 1:15:30",2013-02-04 05:16:11,2010-02-01 10:32:08,2010-03-24 11:47:38,785
104,750,1644,2498,"51 days, 1:19:30",2013-02-06 02:31:36,2010-02-01 10:32:08,2010-03-24 11:51:38,4190
240,555,1436,2231,"51 days, 3:53:23",2013-02-06 01:24:56,2010-05-05 07:53:09,2010-06-25 11:46:32,2633
454,220,446,1120,"51 days, 14:48:33",2013-02-03 09:00:51,2010-02-01 10:32:08,2010-03-25 01:20:41,8015
921,2826,3089,6836,"51 days, 15:19:56",2013-02-06 04:03:04,2010-02-01 10:32:08,2010-03-25 01:52:04,8709
1021,2209,2662,5892,"51 days, 15:21:55",2013-02-07 00:37:07,2010-02-01 10:32:08,2010-03-25 01:54:03,318
1561,7058,6000,14619,"51 days, 15:58:09",2013-02-06 10:40:40,2010-02-01 10:32:08,2010-03-25 02:30:17,6793
296,2339,3159,5794,"51 days, 16:33:58",2013-02-06 10:03:54,2010-02-01 10:32:08,2010-03-25 03:06:06,4473
293,715,1271,2279,"51 days, 16:39:32",2013-02-05 11:43:51,2010-02-01 10:32:08,2010-03-25 03:11:40,9584
53,1763,2201,4017,"51 days, 16:40:33",2013-02-05 10:00:32,2010-02-01 10:32:08,2010-03-25 03:12:41,8201
1045,47,209,1301,"51 days, 16:45:02",2013-01-30 05:03:40,2010-06-19 11:53:53,2010-08-10 04:38:55,9290
678,1752,1983,4413,"51 days, 16:48:56",2013-02-10 09:49:30,2010-02-01 10:32:08,2010-03-25 03:21:04,4058
1086,140,357,1583,"51 days, 17:06:27",2013-02-05 02:43:10,2010-02-01 10:32:08,2010-03-25 03:38:35,5753
15,102,392,509,"51 days, 17:21:35",2013-02-01 05:58:46,2010-02-01 10:32:08,2010-03-25 03:53:43,9861
38,106,184,328,"51 days, 17:23:20",2013-02-04 09:39:43,2010-02-01 10:32:08,2010-03-25 03:55:28,5875
521,2555,3717,6793,"51 days, 17:27:37",2013-02-06 01:02:56,2010-02-01 10:32:08,2010-03-25 03:59:45,4017
98,1191,1767,3056,"51 days, 17:41:20",2013-02-04 09:13:53,2010-02-01 10:32:08,2010-03-25 04:13:28,1546
438,7,138,583,"51 days, 17:46:35",2013-02-02 04:28:58,2010-02-01 10:32:08,2010-03-25 04:18:43,6510
873,69,196,1138,"51 days, 17:56:42",2013-02-02 11:43:45,2010-02-01 10:32:08,2010-03-25 04:28:50,5227
383,2044,2858,5285,"51 days, 18:02:23",2013-02-07 03:06:29,2010-02-01 10:32:08,2010-03-25 04:34:31,1118
24,208,538,770,"51 days, 18:22:17",2013-02-06 01:32:24,2010-02-01 10:32:08,2010-03-25 04:54:25,7280
140,263,374,777,"51 days, 18:28:19",2013-02-05 09:32:23,2010-02-01 10:32:08,2010-03-25 05:00:27,1637
672,3089,2928,6689,"51 days, 18:30:21",2013-02-07 00:06:46,2010-02-01 10:32:08,2010-03-25 05:02:29,9157
187,6209,6150,12546,"51 days, 18:37:31",2013-02-06 08:49:44,2010-02-01 10:32:08,2010-03-25 05:09:39,1647
579,2862,5581,9022,"51 days, 18:59:50",2013-02-06 05:40:53,2010-02-01 10:32:08,2010-03-25 05:31:58,9366
962,3149,4315,8426,"51 days, 19:39:37",2013-02-07 08:21:11,2010-02-01 10:32:08,2010-03-25 06:11:45,4441
2708,5627,5269,13604,"51 days, 19:39:38",2013-02-05 07:27:15,2010-02-01 10:32:08,2010-03-25 06:11:46,8006
222,28,240,490,"51 days, 20:28:39",2013-02-03 05:25:18,2010-02-01 10:32:08,2010-03-25 07:00:47,6936
603,2738,2735,6076,"51 days, 20:37:01",2013-02-07 01:11:49,2010-02-01 10:32:08,2010-03-25 07:09:09,1915
444,607,1150,2201,"51 days, 20:40:45",2013-02-06 09:08:59,2010-02-01 10:32:08,2010-03-25 07:12:53,9982
450,1000,1190,2640,"51 days, 20:49:47",2013-02-07 03:45:11,2010-02-01 10:32:08,2010-03-25 07:21:55,1961
1096,2075,3658,6829,"51 days, 21:21:22",2013-02-06 09:26:59,2010-02-01 10:32:08,2010-03-25 07:53:30,6366
860,5407,6859,13126,"51 days, 21:27:05",2013-02-10 10:08:12,2010-02-01 10:32:08,2010-03-25 07:59:13,5775
370,6757,6988,14115,"51 days, 22:15:57",2013-02-10 05:00:51,2010-02-04 08:08:51,2010-03-28 06:24:48,8687
271,675,1120,2066,"51 days, 22:20:17",2013-02-06 05:29:05,2010-02-01 10:32:08,2010-03-25 08:52:25,8085
548,800,1060,2408,"51 days, 22:27:55",2013-02-05 02:26:29,2010-02-01 10:32:08,2010-03-25 09:00:03,5199
1067,1800,3578,6445,"51 days, 22:39:02",2013-02-08 11:21:02,2010-02-01 10:32:08,2010-03-25 09:11:10,6223
902,160,611,1673,"51 days, 22:52:45",2013-02-05 04:52:37,2010-02-01 10:32:08,2010-03-25 09:24:53,6522
1785,2378,3249,7412,"51 days, 23:32:41",2013-02-06 05:33:28,2010-02-01 10:32:08,2010-03-25 10:04:49,3987
893,394,921,2208,"52 days, 0:03:32",2013-02-04 09:00:20,2010-02-01 10:32:08,2010-03-25 10:35:40,1469
24,21,86,131,"52 days, 0:03:40",2013-02-04 10:07:12,2010-02-01 10:32:08,2010-03-25 10:35:48,7412
59,520,587,1166,"52 days, 0:47:15",2013-02-05 02:31:48,2010-02-01 10:32:08,2010-03-25 11:19:23,6787
746,673,979,2398,"52 days, 0:54:46",2013-02-06 09:41:06,2010-02-01 10:32:08,2010-03-25 11:26:54,1504
389,387,708,1484,"52 days, 1:09:09",2013-02-07 01:40:25,2010-03-15 08:07:19,2010-05-06 09:16:28,3684
1128,7689,7574,16391,"52 days, 1:22:59",2013-02-06 09:23:29,2010-02-01 10:32:08,2010-03-25 11:55:07,3489
1070,0,8,1078,"52 days, 3:25:37",2013-01-25 01:53:36,2010-05-18 01:42:30,2010-07-09 05:08:07,3535
345,49,174,568,"52 days, 6:19:58",2013-02-05 01:32:15,2010-02-28 03:57:59,2010-04-21 10:17:57,907
406,23,40,469,"52 days, 9:21:09",2013-01-31 11:15:36,2012-06-09 02:11:14,2012-07-31 11:32:23,1341
913,2786,3207,6906,"52 days, 13:44:20",2013-02-07 07:06:38,2010-02-01 10:32:08,2010-03-26 00:16:28,4118
224,2612,2962,5798,"52 days, 13:44:24",2013-02-05 10:00:27,2010-02-01 10:32:08,2010-03-26 00:16:32,8809
458,29,427,914,"52 days, 13:47:33",2013-02-05 07:42:34,2010-02-01 10:32:08,2010-03-26 00:19:41,2989
2561,2743,3465,8769,"52 days, 14:50:11",2013-02-07 07:51:06,2010-02-01 10:32:08,2010-03-26 01:22:19,7945
322,1659,2547,4528,"52 days, 14:51:42",2013-02-07 05:10:36,2010-02-01 10:32:08,2010-03-26 01:23:50,1652
961,20,258,1239,"52 days, 15:47:09",2013-01-30 09:33:08,2010-02-01 10:32:08,2010-03-26 02:19:17,1933
199,6729,5802,12730,"52 days, 16:29:07",2013-02-07 04:26:24,2010-02-01 10:32:08,2010-03-26 03:01:15,7168
603,3,22,628,"52 days, 17:18:03",2013-01-11 09:15:29,2010-10-27 09:06:39,2010-12-19 02:24:42,851
1738,9108,7784,18630,"52 days, 17:31:43",2013-02-07 06:04:43,2010-02-01 10:32:08,2010-03-26 04:03:51,1886
1943,1600,2749,6292,"52 days, 17:45:04",2013-02-07 08:02:43,2010-02-01 10:32:08,2010-03-26 04:17:12,4589
325,740,750,1815,"52 days, 17:58:46",2013-02-05 10:38:11,2010-02-01 10:32:08,2010-03-26 04:30:54,5968
528,6122,4922,11572,"52 days, 18:19:58",2013-02-06 07:55:08,2010-02-01 10:32:08,2010-03-26 04:52:06,5409
1870,4118,4018,10006,"52 days, 18:27:28",2013-02-07 05:46:26,2010-02-01 10:32:08,2010-03-26 04:59:36,8679
593,2651,2636,5880,"52 days, 18:55:21",2013-02-06 01:41:25,2010-02-01 10:32:08,2010-03-26 05:27:29,15
538,1398,1943,3879,"52 days, 20:17:36",2013-02-06 04:30:10,2010-02-01 10:32:08,2010-03-26 06:49:44,1951
370,210,453,1033,"52 days, 20:25:33",2013-02-06 10:13:42,2010-02-01 10:32:08,2010-03-26 06:57:41,1580
155,633,689,1477,"52 days, 20:29:00",2013-02-05 10:51:37,2010-03-26 05:37:22,2010-05-18 02:06:22,380
506,1836,3369,5711,"52 days, 20:36:31",2013-02-07 11:24:41,2010-02-01 10:32:08,2010-03-26 07:08:39,5298
1,14,141,156,"52 days, 20:54:52",2013-02-01 00:00:51,2010-07-12 07:15:42,2010-09-03 04:10:34,6708
1001,519,942,2462,"52 days, 21:27:24",2013-02-07 02:23:04,2010-02-01 10:32:08,2010-03-26 07:59:32,3769
94,504,694,1292,"52 days, 21:43:22",2013-02-05 11:01:38,2010-02-01 10:32:08,2010-03-26 08:15:30,9317
82,2820,3299,6201,"52 days, 22:03:58",2013-02-06 07:33:11,2010-02-01 10:32:08,2010-03-26 08:36:06,7636
1512,1482,2094,5088,"52 days, 22:15:18",2013-02-05 07:54:00,2010-02-01 10:32:08,2010-03-26 08:47:26,4050
1419,1071,1034,3524,"52 days, 22:25:41",2013-02-07 01:10:50,2010-02-01 10:32:08,2010-03-26 08:57:49,6918
45,6782,4501,11328,"52 days, 22:33:32",2013-02-10 05:49:53,2010-02-01 10:32:08,2010-03-26 09:05:40,9529
597,3039,5300,8936,"52 days, 22:33:59",2013-02-06 11:30:46,2010-02-01 10:32:08,2010-03-26 09:06:07,7401
1324,1137,1732,4193,"52 days, 22:35:03",2013-02-07 08:56:19,2010-02-01 10:32:08,2010-03-26 09:07:11,4018
1254,840,1711,3805,"52 days, 22:39:13",2013-02-06 08:52:19,2010-02-01 10:32:08,2010-03-26 09:11:21,9675
9,623,1040,1672,"52 days, 22:43:04",2013-02-06 04:08:30,2010-02-01 10:32:08,2010-03-26 09:15:12,4248
706,338,498,1542,"52 days, 22:54:00",2013-02-02 08:21:20,2010-02-01 10:32:08,2010-03-26 09:26:08,2855
2519,7650,7352,17521,"52 days, 22:54:56",2013-02-07 03:08:10,2010-02-01 10:32:08,2010-03-26 09:27:04,8940
790,428,807,2025,"52 days, 23:19:10",2013-02-05 07:32:33,2010-02-01 10:32:08,2010-03-26 09:51:18,4570
985,185,868,2038,"52 days, 23:21:37",2013-02-05 00:58:31,2010-02-01 10:32:08,2010-03-26 09:53:45,2619
1112,771,1719,3602,"52 days, 23:27:38",2013-02-06 11:14:21,2010-02-01 10:32:08,2010-03-26 09:59:46,9299
25,157,405,587,"52 days, 23:48:37",2013-02-01 00:08:24,2010-02-01 10:32:08,2010-03-26 10:20:45,7909
367,10,96,473,"53 days, 0:15:14",2013-01-24 02:41:32,2010-02-01 10:32:08,2010-03-26 10:47:22,4587
752,3485,4818,9055,"53 days, 0:29:09",2013-02-06 10:06:32,2010-02-01 10:32:08,2010-03-26 11:01:17,8725
886,10176,5816,16878,"53 days, 0:33:44",2013-02-07 10:00:32,2010-02-01 10:32:08,2010-03-26 11:05:52,5852
871,1528,2761,5160,"53 days, 0:37:13",2013-02-04 09:18:47,2010-02-01 10:32:08,2010-03-26 11:09:21,6679
32,58,91,181,"53 days, 0:56:20",2013-01-19 06:20:20,2010-02-01 10:32:08,2010-03-26 11:28:28,5046
30,1884,2222,4136,"53 days, 6:06:39",2013-02-05 11:31:47,2010-03-21 02:13:43,2010-05-13 08:20:22,7232
745,0,4,749,"53 days, 13:28:17",2013-02-01 02:18:23,2010-10-23 11:16:49,2010-12-16 00:45:06,4080
7,380,943,1330,"53 days, 13:36:28",2013-02-07 04:27:36,2010-02-01 10:32:08,2010-03-27 00:08:36,6398
1081,397,788,2266,"53 days, 13:39:19",2013-02-07 08:54:35,2010-02-01 10:32:08,2010-03-27 00:11:27,6284
278,928,1296,2502,"53 days, 13:39:54",2013-02-06 09:16:07,2010-02-01 10:32:08,2010-03-27 00:12:02,3786
336,467,959,1762,"53 days, 13:42:58",2013-02-05 02:05:21,2010-02-01 10:32:08,2010-03-27 00:15:06,3436
855,762,960,2577,"53 days, 13:46:54",2013-02-06 07:00:33,2010-02-01 10:32:08,2010-03-27 00:19:02,4488
160,353,493,1006,"53 days, 13:51:59",2013-01-31 04:03:00,2010-02-01 10:32:08,2010-03-27 00:24:07,8539
13,1076,1843,2932,"53 days, 13:57:21",2013-02-06 11:19:59,2010-02-01 10:32:08,2010-03-27 00:29:29,5661
536,1120,2442,4098,"53 days, 14:16:11",2013-02-07 05:43:18,2010-02-01 10:32:08,2010-03-27 00:48:19,7360
531,3755,3648,7934,"53 days, 14:19:12",2013-02-10 06:47:17,2010-02-01 10:32:08,2010-03-27 00:51:20,2914
1020,167,479,1666,"53 days, 14:34:54",2013-02-06 00:00:40,2010-02-01 10:32:08,2010-03-27 01:07:02,9474
127,4334,5020,9481,"53 days, 14:56:10",2013-02-06 11:30:25,2010-02-01 10:32:08,2010-03-27 01:28:18,1088
307,586,1336,2229,"53 days, 15:05:39",2013-02-06 02:34:36,2010-02-01 10:32:08,2010-03-27 01:37:47,5826
1017,629,929,2575,"53 days, 15:22:29",2013-02-06 06:34:40,2010-02-01 10:32:08,2010-03-27 01:54:37,4873
745,339,1097,2181,"53 days, 15:29:37",2013-02-10 02:25:01,2010-02-01 10:32:08,2010-03-27 02:01:45,9491
44,80,390,514,"53 days, 15:50:04",2013-02-04 00:39:18,2010-02-01 10:32:08,2010-03-27 02:22:12,4199
262,3604,2894,6760,"53 days, 15:55:03",2013-02-10 10:13:15,2010-02-01 10:32:08,2010-03-27 02:27:11,4090
684,817,1274,2775,"53 days, 15:55:31",2013-02-06 00:19:06,2010-02-01 10:32:08,2010-03-27 02:27:39,5940
345,4489,3966,8800,"53 days, 16:00:11",2013-02-06 10:28:31,2010-02-01 10:32:08,2010-03-27 02:32:19,2437
625,2004,2846,5475,"53 days, 16:58:08",2013-02-07 06:06:05,2010-02-01 10:32:08,2010-03-27 03:30:16,9000
231,321,722,1274,"53 days, 17:20:18",2013-02-06 11:14:06,2010-02-01 10:32:08,2010-03-27 03:52:26,1139
413,431,403,1247,"53 days, 17:37:56",2013-02-02 00:18:40,2010-02-01 10:32:08,2010-03-27 04:10:04,6943
117,4162,8196,12475,"53 days, 17:45:19",2013-02-07 00:36:05,2010-02-01 10:32:08,2010-03-27 04:17:27,2691
396,409,452,1257,"53 days, 17:49:49",2013-02-03 00:56:19,2010-02-01 10:32:08,2010-03-27 04:21:57,7095
135,366,1069,1570,"53 days, 18:28:45",2013-02-05 04:25:31,2010-02-01 10:32:08,2010-03-27 05:00:53,4328
1046,1049,1287,3382,"53 days, 18:34:41",2013-02-05 02:48:09,2010-02-01 10:32:08,2010-03-27 05:06:49,8444
833,129,206,1168,"53 days, 18:34:58",2013-02-03 11:44:40,2010-02-01 10:32:08,2010-03-27 05:07:06,7593
475,580,1282,2337,"53 days, 18:37:56",2013-02-05 05:42:52,2010-02-01 10:32:08,2010-03-27 05:10:04,6250
586,1200,1613,3399,"53 days, 18:40:37",2013-02-08 07:01:24,2010-02-01 10:32:08,2010-03-27 05:12:45,6079
1246,3551,5043,9840,"53 days, 18:40:43",2013-02-06 05:34:58,2010-02-01 10:32:08,2010-03-27 05:12:51,7812
911,236,655,1802,"53 days, 19:03:59",2013-02-05 01:34:03,2010-02-01 10:32:08,2010-03-27 05:36:07,9255
103,2191,2932,5226,"53 days, 19:07:01",2013-02-07 00:12:28,2010-02-01 10:32:08,2010-03-27 05:39:09,3281
117,188,515,820,"53 days, 19:09:21",2013-02-02 11:48:40,2010-02-01 10:32:08,2010-03-27 05:41:29,6384
226,1808,3249,5283,"53 days, 19:12:25",2013-02-07 03:45:14,2010-02-01 10:32:08,2010-03-27 05:44:33,7857
476,102,360,938,"53 days, 19:13:21",2013-02-04 01:48:17,2010-02-01 10:32:08,2010-03-27 05:45:29,4355
1305,128,415,1848,"53 days, 19:28:16",2013-02-03 01:47:51,2010-02-01 10:32:08,2010-03-27 06:00:24,7003
973,229,208,1410,"53 days, 19:28:27",2013-01-31 06:28:35,2010-02-01 10:32:08,2010-03-27 06:00:35,1600
9,537,1315,1861,"53 days, 19:39:35",2013-02-09 04:14:18,2010-02-01 10:32:08,2010-03-27 06:11:43,3683
684,784,1444,2912,"53 days, 19:48:43",2013-02-08 02:59:17,2010-02-01 10:32:08,2010-03-27 06:20:51,3265
74,142,587,803,"53 days, 19:57:30",2013-02-06 10:23:23,2010-02-01 10:32:08,2010-03-27 06:29:38,1482
479,1140,2401,4020,"53 days, 19:59:14",2013-02-05 06:48:16,2010-03-16 05:02:32,2010-05-09 01:01:46,4147
1409,1968,3307,6684,"53 days, 20:02:10",2013-02-07 02:42:11,2010-02-01 10:32:08,2010-03-27 06:34:18,6571
54,339,519,912,"53 days, 20:19:34",2013-02-05 05:00:15,2010-02-01 10:32:08,2010-03-27 06:51:42,7436
297,2359,2256,4912,"53 days, 20:19:58",2013-02-06 11:07:41,2010-02-01 10:32:08,2010-03-27 06:52:06,9964
1238,5153,5477,11868,"53 days, 20:33:58",2013-02-10 04:32:08,2010-02-01 10:32:08,2010-03-27 07:06:06,4250
53,157,212,422,"53 days, 21:00:44",2013-02-01 01:06:13,2010-02-01 10:32:08,2010-03-27 07:32:52,8702
1,30,120,151,"53 days, 21:26:55",2013-02-06 06:18:36,2010-02-01 10:32:08,2010-03-27 07:59:03,710
605,2117,3496,6218,"53 days, 22:09:40",2013-02-06 03:16:37,2010-02-01 10:32:08,2010-03-27 08:41:48,9787
858,122,452,1432,"53 days, 22:26:44",2013-02-07 03:53:45,2010-02-01 10:32:08,2010-03-27 08:58:52,2233
98,62,183,343,"53 days, 22:28:22",2013-02-03 02:43:05,2010-04-30 06:34:51,2010-06-23 05:03:13,588
1912,3079,3845,8836,"53 days, 22:49:11",2013-02-06 10:53:53,2010-02-01 10:32:08,2010-03-27 09:21:19,5068
344,1926,3056,5326,"53 days, 23:08:06",2013-02-14 01:38:25,2010-02-01 10:32:08,2010-03-27 09:40:14,944
194,2936,3685,6815,"53 days, 23:09:04",2013-02-06 06:10:29,2010-02-01 10:32:08,2010-03-27 09:41:12,9617
517,1728,2499,4744,"53 days, 23:18:51",2013-02-07 01:20:36,2010-02-01 10:32:08,2010-03-27 09:50:59,4089
1184,436,1161,2781,"53 days, 23:30:27",2013-02-07 06:54:14,2010-02-01 10:32:08,2010-03-27 10:02:35,2810
1566,2499,2827,6892,"53 days, 23:30:39",2013-02-06 07:47:15,2010-02-01 10:32:08,2010-03-27 10:02:47,2014
64,560,813,1437,"53 days, 23:35:09",2013-02-03 01:01:48,2010-02-01 10:32:08,2010-03-27 10:07:17,8348
1297,0,0,1297,"53 days, 23:52:14",2013-01-31 04:12:34,2011-04-04 06:57:08,2011-05-28 06:49:22,8236
251,1534,1340,3125,"54 days, 0:03:08",2013-02-04 11:11:55,2010-02-01 10:32:08,2010-03-27 10:35:16,5228
1360,3425,2673,7458,"54 days, 0:07:14",2013-02-07 07:47:17,2010-02-01 10:32:08,2010-03-27 10:39:22,7683
276,150,602,1028,"54 days, 0:42:17",2013-02-04 08:22:51,2010-02-01 10:32:08,2010-03-27 11:14:25,7932
83,4636,6757,11476,"54 days, 0:53:31",2013-02-07 11:59:56,2010-02-01 10:32:08,2010-03-27 11:25:39,8007
396,3351,3945,7692,"54 days, 1:24:49",2013-02-07 07:36:47,2010-02-01 10:32:08,2010-03-27 11:56:57,5671
1037,64,381,1482,"54 days, 1:27:28",2013-02-07 04:46:31,2010-02-01 10:32:08,2010-03-27 11:59:36,4620
952,31,119,1102,"54 days, 1:38:17",2013-02-03 04:48:18,2010-10-20 02:13:33,2010-12-13 03:51:50,2008
1237,150,124,1511,"54 days, 13:29:24",2013-01-30 11:55:58,2010-02-01 10:32:08,2010-03-28 00:01:32,5435
360,2898,2662,5920,"54 days, 13:29:49",2013-02-06 04:43:21,2010-02-01 10:32:08,2010-03-28 00:01:57,6078
29,556,833,1418,"54 days, 13:47:27",2013-02-06 11:03:10,2010-02-01 10:32:08,2010-03-28 00:19:35,6932
111,150,345,606,"54 days, 14:05:53",2013-02-01 11:04:48,2010-02-01 10:32:08,2010-03-28 00:38:01,2640
463,2086,1889,4438,"54 days, 14:15:09",2013-02-07 07:07:27,2010-02-01 10:32:08,2010-03-28 00:47:17,3106
39,162,269,470,"54 days, 14:40:09",2013-02-06 09:50:24,2010-02-01 10:32:08,2010-03-28 01:12:17,9618
100,1144,1721,2965,"54 days, 14:59:08",2013-02-05 11:51:16,2010-02-01 10:32:08,2010-03-28 01:31:16,8988
560,707,1398,2665,"54 days, 15:05:35",2013-02-05 05:07:56,2010-02-01 10:32:08,2010-03-28 01:37:43,2781
718,968,1955,3641,"54 days, 15:11:08",2013-02-06 04:58:34,2010-02-01 10:32:08,2010-03-28 01:43:16,9472
501,2003,2116,4620,"54 days, 15:52:13",2013-02-06 05:43:23,2010-02-01 10:32:08,2010-03-28 02:24:21,6834
283,277,412,972,"54 days, 15:55:08",2013-02-02 10:39:37,2010-02-01 10:32:08,2010-03-28 02:27:16,7119
1786,1594,2318,5698,"54 days, 16:39:36",2013-02-05 08:33:18,2010-02-01 10:32:08,2010-03-28 03:11:44,683
1170,928,1253,3351,"54 days, 16:51:37",2013-02-05 08:04:28,2010-02-01 10:32:08,2010-03-28 03:23:45,6205
478,4006,3947,8431,"54 days, 16:54:24",2013-02-07 02:23:03,2010-02-01 10:32:08,2010-03-28 03:26:32,2602
49,590,1472,2111,"54 days, 18:03:11",2013-02-04 10:59:27,2010-02-01 10:32:08,2010-03-28 04:35:19,2515
252,736,1320,2308,"54 days, 18:33:34",2013-02-05 08:47:34,2010-02-01 10:32:08,2010-03-28 05:05:42,3511
1212,778,1013,3003,"54 days, 18:37:12",2013-02-06 05:05:45,2010-02-01 10:32:08,2010-03-28 05:09:20,7242
45,232,360,637,"54 days, 18:48:31",2013-02-02 03:30:35,2010-02-01 10:32:08,2010-03-28 05:20:39,6662
44,924,1276,2244,"54 days, 19:10:07",2013-02-06 00:29:47,2010-02-14 07:57:01,2010-04-10 03:07:08,312
146,220,597,963,"54 days, 19:17:17",2013-02-07 01:39:47,2010-02-01 10:32:08,2010-03-28 05:49:25,3913
454,625,1202,2281,"54 days, 19:19:16",2013-02-07 01:04:08,2010-05-03 09:17:17,2010-06-27 04:36:33,9115
925,587,929,2441,"54 days, 19:46:44",2013-02-06 06:10:31,2010-02-01 10:32:08,2010-03-28 06:18:52,5573
22,378,606,1006,"54 days, 19:53:50",2013-02-06 09:19:08,2010-02-01 10:32:08,2010-03-28 06:25:58,9379
841,75,248,1164,"54 days, 20:08:59",2013-02-03 06:44:53,2010-02-01 10:32:08,2010-03-28 06:41:07,6193
352,1632,2602,4586,"54 days, 20:14:42",2013-02-07 07:25:44,2010-02-01 10:32:08,2010-03-28 06:46:50,4801
1894,983,1564,4441,"54 days, 20:15:50",2013-02-05 05:59:30,2010-02-01 10:32:08,2010-03-28 06:47:58,2185
582,1,0,583,"54 days, 20:17:05",2013-01-24 06:18:41,2011-06-01 10:21:22,2011-07-26 06:38:27,1462
994,4650,7023,12667,"54 days, 20:50:11",2013-02-07 07:15:53,2010-02-01 10:32:08,2010-03-28 07:22:19,4241
51,510,1261,1822,"54 days, 20:56:43",2013-02-07 04:33:48,2010-02-01 10:32:08,2010-03-28 07:28:51,5595
438,664,1356,2458,"54 days, 21:02:56",2013-02-03 06:16:17,2010-02-01 10:32:08,2010-03-28 07:35:04,6671
1094,443,1095,2632,"54 days, 21:44:12",2013-02-05 02:55:53,2010-02-01 10:32:08,2010-03-28 08:16:20,132
987,0,36,1023,"54 days, 22:01:07",2013-01-30 00:00:15,2011-06-30 09:57:31,2011-08-24 07:58:38,708
779,334,367,1480,"54 days, 22:06:03",2013-01-29 11:53:46,2010-02-01 10:32:08,2010-03-28 08:38:11,9196
376,308,651,1335,"54 days, 22:18:14",2013-02-06 09:09:55,2010-03-12 07:38:08,2010-05-06 05:56:22,54
47,941,2208,3196,"54 days, 22:47:25",2013-02-06 04:39:31,2010-02-01 10:32:08,2010-03-28 09:19:33,1741
312,24,140,476,"54 days, 22:50:42",2013-02-04 05:51:56,2010-02-01 10:32:08,2010-03-28 09:22:50,7460
658,0,39,697,"54 days, 22:57:32",2013-01-30 03:32:54,2010-03-03 05:14:17,2010-04-27 04:11:49,5587
468,854,1132,2454,"54 days, 23:06:43",2013-02-07 05:33:49,2010-02-01 10:32:08,2010-03-28 09:38:51,7746
757,938,1358,3053,"54 days, 23:27:04",2013-02-04 10:25:54,2010-02-01 10:32:08,2010-03-28 09:59:12,1661
296,364,618,1278,"55 days, 0:00:36",2013-01-30 07:30:16,2010-02-01 10:32:08,2010-03-28 10:32:44,8113
65,2333,2440,4838,"55 days, 0:08:32",2013-02-09 08:38:39,2010-02-01 10:32:08,2010-03-28 10:40:40,166
1321,1,76,1398,"55 days, 0:46:04",2013-02-02 09:45:37,2010-02-01 10:32:08,2010-03-28 11:18:12,3629
892,2280,4300,7472,"55 days, 1:11:55",2013-02-05 03:54:41,2010-02-01 10:32:08,2010-03-28 11:44:03,1952
1468,2409,3312,7189,"55 days, 1:26:12",2013-02-04 05:51:34,2010-02-01 10:32:08,2010-03-28 11:58:20,3253
340,155,415,910,"55 days, 4:14:56",2013-02-05 06:23:46,2010-03-19 02:38:54,2010-05-13 06:53:50,4032
427,28,90,545,"55 days, 6:55:58",2013-02-05 02:41:46,2011-09-20 00:53:07,2011-11-14 07:49:05,5777
881,1392,1964,4237,"55 days, 13:47:39",2013-02-07 03:36:48,2010-02-01 10:32:08,2010-03-29 00:19:47,3801
810,541,562,1913,"55 days, 13:51:03",2013-02-02 00:03:49,2010-02-01 10:32:08,2010-03-29 00:23:11,116
81,2559,2691,5331,"55 days, 13:52:28",2013-02-04 10:29:36,2010-02-01 10:32:08,2010-03-29 00:24:36,1080
120,9,139,268,"55 days, 14:04:01",2013-02-01 05:03:12,2010-02-01 10:32:08,2010-03-29 00:36:09,6080
5,281,834,1120,"55 days, 14:09:24",2013-02-06 02:59:47,2010-02-01 10:32:08,2010-03-29 00:41:32,1171
720,63,237,1020,"55 days, 14:41:25",2013-02-06 05:13:19,2010-02-01 10:32:08,2010-03-29 01:13:33,6044
91,60,84,235,"55 days, 14:44:39",2013-01-31 07:28:18,2010-02-01 10:32:08,2010-03-29 01:16:47,1943
468,622,1100,2190,"55 days, 14:48:07",2013-02-07 02:41:54,2010-02-01 10:32:08,2010-03-29 01:20:15,2358
231,1984,3045,5260,"55 days, 15:17:39",2013-02-06 05:28:37,2010-02-01 10:32:08,2010-03-29 01:49:47,7123
24,1425,1633,3082,"55 days, 15:29:06",2013-02-06 10:35:10,2010-02-01 10:32:08,2010-03-29 02:01:14,1383
1057,4795,4919,10771,"55 days, 15:33:44",2013-02-07 08:43:07,2010-02-01 10:32:08,2010-03-29 02:05:52,5051
1057,1586,2058,4701,"55 days, 15:36:52",2013-02-06 05:39:22,2010-02-01 10:32:08,2010-03-29 02:09:00,6580
55,2097,2074,4226,"55 days, 16:27:41",2013-02-07 04:06:33,2010-02-01 10:32:08,2010-03-29 02:59:49,9023
1096,723,1404,3223,"55 days, 16:27:44",2013-02-07 07:35:20,2010-02-01 10:32:08,2010-03-29 02:59:52,6541
212,3804,4685,8701,"55 days, 18:07:49",2013-02-08 11:45:06,2010-02-01 10:32:08,2010-03-29 04:39:57,9944
693,2926,2823,6442,"55 days, 18:08:24",2013-02-07 05:48:59,2010-02-01 10:32:08,2010-03-29 04:40:32,394
721,2,0,723,"55 days, 18:17:39",2013-01-22 06:48:18,2011-08-25 07:42:21,2011-10-20 02:00:00,170
16,394,822,1232,"55 days, 18:40:16",2013-02-05 05:53:14,2010-02-01 10:32:08,2010-03-29 05:12:24,8142
405,227,943,1575,"55 days, 18:41:58",2013-02-06 07:29:30,2010-02-01 10:32:08,2010-03-29 05:14:06,7395
1315,2675,5098,9088,"55 days, 19:24:49",2013-02-07 03:45:52,2010-02-01 10:32:08,2010-03-29 05:56:57,935
905,15,211,1131,"55 days, 19:43:45",2013-02-03 06:28:03,2010-04-07 06:55:54,2010-06-02 02:39:39,3301
190,3088,3605,6883,"55 days, 19:53:42",2013-02-06 04:36:25,2010-02-01 10:32:08,2010-03-29 06:25:50,965
805,2078,1583,4466,"55 days, 20:17:26",2013-02-06 11:03:40,2010-02-01 10:32:08,2010-03-29 06:49:34,222
222,218,482,922,"55 days, 20:27:30",2013-02-06 09:55:20,2010-02-01 10:32:08,2010-03-29 06:59:38,6389
587,472,426,1485,"55 days, 20:34:34",2013-02-04 03:20:57,2010-02-01 10:32:08,2010-03-29 07:06:42,6378
9,754,1258,2021,"55 days, 20:41:14",2013-02-06 01:58:47,2010-02-01 10:32:08,2010-03-29 07:13:22,8173
33,472,782,1287,"55 days, 20:45:13",2013-02-02 04:44:20,2010-02-01 10:32:08,2010-03-29 07:17:21,5426
556,1833,2602,4991,"55 days, 20:50:00",2013-02-07 05:25:21,2010-02-01 10:32:08,2010-03-29 07:22:08,5134
492,691,1385,2568,"55 days, 21:16:20",2013-02-06 03:53:49,2010-02-01 10:32:08,2010-03-29 07:48:28,4813
1030,0,0,1030,"55 days, 21:27:36",2013-01-13 10:51:13,2012-10-12 04:13:13,2012-12-07 01:40:49,5868
206,400,1163,1769,"55 days, 21:43:43",2013-02-04 11:33:51,2010-02-01 10:32:08,2010-03-29 08:15:51,6570
656,865,1154,2675,"55 days, 21:48:03",2013-02-07 02:16:56,2010-02-01 10:32:08,2010-03-29 08:20:11,1366
42,894,1282,2218,"55 days, 21:49:38",2013-02-05 05:03:29,2010-02-01 10:32:08,2010-03-29 08:21:46,4835
328,477,602,1407,"55 days, 21:54:23",2013-02-06 04:06:33,2010-02-01 10:32:08,2010-03-29 08:26:31,6942
417,928,1285,2630,"55 days, 22:07:54",2013-02-05 10:43:23,2010-02-01 10:32:08,2010-03-29 08:40:02,1342
742,170,264,1176,"55 days, 22:25:40",2013-01-30 06:55:55,2010-02-01 10:32:08,2010-03-29 08:57:48,6221
1320,1120,3400,5840,"55 days, 22:45:11",2013-02-06 09:35:06,2010-02-01 10:32:08,2010-03-29 09:17:19,3409
325,390,1217,1932,"55 days, 22:49:56",2013-02-05 10:41:30,2010-03-18 09:15:11,2010-05-13 08:05:07,3722
49,708,823,1580,"55 days, 22:54:25",2013-02-04 01:41:44,2010-02-01 10:32:08,2010-03-29 09:26:33,3880
274,108,244,626,"55 days, 23:03:14",2013-02-02 02:45:11,2010-02-01 10:32:08,2010-03-29 09:35:22,2312
418,718,1539,2675,"55 days, 23:09:10",2013-02-06 07:57:26,2010-02-01 10:32:08,2010-03-29 09:41:18,7367
1702,794,1843,4339,"55 days, 23:36:48",2013-02-06 06:52:59,2010-02-01 10:32:08,2010-03-29 10:08:56,4460
207,5967,7322,13496,"55 days, 23:38:26",2013-02-06 10:18:38,2010-02-01 10:32:08,2010-03-29 10:10:34,5711
1469,3034,3782,8285,"56 days, 0:25:46",2013-02-06 04:31:13,2010-02-01 10:32:08,2010-03-29 10:57:54,5971
1206,39,180,1425,"56 days, 0:50:10",2013-02-06 02:00:51,2010-06-13 10:48:24,2010-08-08 11:38:34,2825
451,4033,5320,9804,"56 days, 1:15:05",2013-02-07 01:52:40,2010-02-01 10:32:08,2010-03-29 11:47:13,9008
10,216,368,594,"56 days, 1:23:10",2013-02-04 08:48:18,2010-02-01 10:32:08,2010-03-29 11:55:18,5998
568,2,44,614,"56 days, 10:41:33",2013-01-30 09:19:30,2012-09-08 00:02:56,2012-11-03 10:44:29,2000
969,231,555,1755,"56 days, 13:28:21",2013-02-07 11:18:52,2010-02-01 10:32:08,2010-03-30 00:00:29,2356
290,856,1071,2217,"56 days, 13:35:03",2013-02-09 04:04:28,2010-02-01 10:32:08,2010-03-30 00:07:11,2593
776,201,253,1230,"56 days, 14:10:01",2013-02-06 07:04:12,2010-02-01 10:32:08,2010-03-30 00:42:09,6437
367,357,910,1634,"56 days, 14:32:47",2013-02-07 00:24:24,2010-02-01 10:32:08,2010-03-30 01:04:55,9925
820,1130,1856,3806,"56 days, 14:49:46",2013-02-07 01:55:41,2010-02-01 10:32:08,2010-03-30 01:21:54,4964
229,417,561,1207,"56 days, 15:25:37",2013-02-05 05:28:37,2010-02-01 10:32:08,2010-03-30 01:57:45,1666
2183,4435,6979,13597,"56 days, 15:33:30",2013-02-06 11:54:47,2010-02-01 10:32:08,2010-03-30 02:05:38,1685
1044,4488,5701,11233,"56 days, 16:33:38",2013-02-07 02:28:52,2010-02-01 10:32:08,2010-03-30 03:05:46,7031
665,563,910,2138,"56 days, 16:34:24",2013-02-07 01:26:38,2010-02-01 10:32:08,2010-03-30 03:06:32,7704
449,1405,2528,4382,"56 days, 16:53:23",2013-02-05 03:19:09,2010-02-01 10:32:08,2010-03-30 03:25:31,4085
251,89,354,694,"56 days, 17:43:25",2013-02-02 00:44:16,2010-02-01 10:32:08,2010-03-30 04:15:33,14
32,184,503,719,"56 days, 18:06:36",2013-02-05 09:12:55,2010-02-01 10:32:08,2010-03-30 04:38:44,5612
1044,859,1532,3435,"56 days, 18:21:52",2013-02-05 07:25:02,2010-02-01 10:32:08,2010-03-30 04:54:00,5364
38,539,1237,1814,"56 days, 18:29:53",2013-02-07 03:41:08,2010-02-01 10:32:08,2010-03-30 05:02:01,6459
908,1143,2148,4199,"56 days, 18:38:58",2013-02-05 01:37:09,2010-02-01 10:32:08,2010-03-30 05:11:06,4006
282,3978,4352,8612,"56 days, 18:55:57",2013-02-10 07:35:04,2010-02-01 10:32:08,2010-03-30 05:28:05,5045
246,302,774,1322,"56 days, 19:38:47",2013-02-07 04:17:46,2010-02-01 10:32:08,2010-03-30 06:10:55,4815
10,575,1135,1720,"56 days, 19:42:51",2013-02-05 08:30:03,2010-02-01 10:32:08,2010-03-30 06:14:59,5946
468,422,685,1575,"56 days, 20:03:26",2013-02-04 11:20:07,2010-02-01 10:32:08,2010-03-30 06:35:34,5338
985,766,1122,2873,"56 days, 20:05:51",2013-02-02 04:50:34,2010-02-01 10:32:08,2010-03-30 06:37:59,8942
926,287,366,1579,"56 days, 20:37:33",2013-02-05 06:28:26,2010-06-07 04:37:46,2010-08-03 01:15:19,5211
269,335,621,1225,"56 days, 20:45:00",2013-02-05 10:43:48,2010-02-01 10:32:08,2010-03-30 07:17:08,1803
910,2367,3618,6895,"56 days, 20:54:43",2013-02-06 03:25:11,2010-02-01 10:32:08,2010-03-30 07:26:51,93
1031,246,671,1948,"56 days, 21:04:37",2013-02-06 05:03:04,2010-02-01 10:32:08,2010-03-30 07:36:45,2733
516,848,1324,2688,"56 days, 21:12:48",2013-02-13 06:41:48,2010-02-01 10:32:08,2010-03-30 07:44:56,4783
873,5664,6800,13337,"56 days, 21:12:58",2013-02-07 06:53:04,2010-02-01 10:32:08,2010-03-30 07:45:06,4121
588,700,960,2248,"56 days, 21:38:05",2013-02-05 09:35:28,2010-02-01 10:32:08,2010-03-30 08:10:13,2397
218,309,736,1263,"56 days, 22:14:40",2013-02-05 04:22:08,2010-02-01 10:32:08,2010-03-30 08:46:48,7103
365,29,345,739,"56 days, 22:35:51",2013-02-02 06:53:14,2010-04-05 08:53:52,2010-06-01 07:29:43,8552
119,2613,4279,7011,"56 days, 23:18:50",2013-02-05 08:22:42,2010-02-01 10:32:08,2010-03-30 09:50:58,8924
618,743,1068,2429,"56 days, 23:37:45",2013-02-06 09:55:46,2010-02-01 10:32:08,2010-03-30 10:09:53,529
1149,532,428,2109,"56 days, 23:55:06",2013-02-06 09:21:33,2010-02-01 10:32:08,2010-03-30 10:27:14,8691
297,666,889,1852,"57 days, 0:08:55",2013-02-03 06:35:27,2010-02-01 10:32:08,2010-03-30 10:41:03,2857
98,1544,1525,3167,"57 days, 0:15:11",2013-02-06 04:55:21,2010-03-23 10:57:09,2010-05-19 11:12:20,9173
112,730,1046,1888,"57 days, 0:20:00",2013-02-04 07:29:48,2010-02-01 10:32:08,2010-03-30 10:52:08,8047
438,93,484,1015,"57 days, 0:33:55",2013-02-03 10:26:07,2010-02-01 10:32:08,2010-03-30 11:06:03,2650
166,207,393,766,"57 days, 0:34:24",2013-02-05 00:39:46,2010-07-10 01:09:55,2010-09-05 01:44:19,6653
958,3,7,968,"57 days, 0:55:09",2013-01-26 09:51:49,2010-02-01 10:32:08,2010-03-30 11:27:17,7180
69,101,710,880,"57 days, 1:06:05",2013-02-04 11:26:42,2010-02-01 10:32:08,2010-03-30 11:38:13,5220
1272,196,479,1947,"57 days, 1:19:09",2013-02-05 05:17:44,2010-02-01 10:32:08,2010-03-30 11:51:17,1978
67,475,974,1516,"57 days, 7:08:26",2013-02-07 01:35:31,2010-02-15 00:25:07,2010-04-13 07:33:33,5951
1895,1650,2227,5772,"57 days, 13:28:40",2013-02-06 05:44:45,2010-02-01 10:32:08,2010-03-31 00:00:48,975
674,1143,1568,3385,"57 days, 14:13:26",2013-02-05 07:08:35,2010-02-01 10:32:08,2010-03-31 00:45:34,71
173,4999,7068,12240,"57 days, 14:26:54",2013-02-08 02:19:40,2010-02-01 10:32:08,2010-03-31 00:59:02,8038
215,461,955,1631,"57 days, 14:32:39",2013-02-03 04:30:31,2010-02-01 10:32:08,2010-03-31 01:04:47,3803
125,888,1218,2231,"57 days, 14:39:54",2013-02-04 06:33:44,2010-02-01 10:32:08,2010-03-31 01:12:02,6471
190,204,375,769,"57 days, 15:01:26",2013-02-05 09:44:50,2010-02-01 10:32:08,2010-03-31 01:33:34,7482
522,570,955,2047,"57 days, 15:20:24",2013-02-06 11:46:25,2010-02-01 10:32:08,2010-03-31 01:52:32,7527
1203,160,626,1989,"57 days, 15:24:26",2013-02-06 04:25:32,2010-02-01 10:32:08,2010-03-31 01:56:34,5480
397,420,1236,2053,"57 days, 15:55:59",2013-02-07 05:20:15,2010-02-01 10:32:08,2010-03-31 02:28:07,494
149,1046,1570,2765,"57 days, 16:01:44",2013-02-07 08:08:36,2010-02-01 10:32:08,2010-03-31 02:33:52,4461
151,128,212,491,"57 days, 16:16:26",2013-01-25 01:56:49,2010-02-01 10:32:08,2010-03-31 02:48:34,3266
23,92,286,401,"57 days, 16:38:09",2013-02-05 10:41:22,2010-02-01 10:32:08,2010-03-31 03:10:17,6542
641,22,152,815,"57 days, 16:43:40",2013-02-04 03:02:37,2010-02-26 11:09:55,2010-04-25 03:53:35,9368
88,2889,3455,6432,"57 days, 16:45:49",2013-02-05 09:03:33,2010-02-01 10:32:08,2010-03-31 03:17:57,4246
632,2233,3207,6072,"57 days, 16:52:50",2013-02-06 10:19:22,2010-02-01 10:32:08,2010-03-31 03:24:58,4486
227,825,1228,2280,"57 days, 18:07:51",2013-02-05 07:09:47,2010-02-01 10:32:08,2010-03-31 04:39:59,1678
329,3574,3824,7727,"57 days, 18:31:19",2013-02-05 02:48:45,2010-02-01 10:32:08,2010-03-31 05:03:27,7846
1748,1564,2292,5604,"57 days, 18:57:24",2013-02-07 02:26:45,2010-02-01 10:32:08,2010-03-31 05:29:32,5571
87,5812,5923,11822,"57 days, 18:58:51",2013-02-07 05:36:25,2010-02-01 10:32:08,2010-03-31 05:30:59,1091
164,708,1329,2201,"57 days, 19:14:08",2013-02-02 10:11:27,2010-02-01 10:32:08,2010-03-31 05:46:16,7895
1463,6328,8140,15931,"57 days, 19:24:51",2013-02-07 01:44:23,2010-02-01 10:32:08,2010-03-31 05:56:59,2255
948,777,1124,2849,"57 days, 19:56:45",2013-02-06 04:58:11,2010-02-01 10:32:08,2010-03-31 06:28:53,4483
539,3361,3368,7268,"57 days, 19:57:59",2013-02-06 05:25:22,2010-02-01 10:32:08,2010-03-31 06:30:07,6381
4,28,308,340,"57 days, 20:05:52",2013-02-03 00:59:32,2010-04-22 10:53:09,2010-06-19 06:59:01,2579
854,3748,3418,8020,"57 days, 20:10:06",2013-02-09 01:03:27,2010-02-01 10:32:08,2010-03-31 06:42:14,9742
252,1876,2081,4209,"57 days, 20:13:45",2013-02-06 00:17:22,2010-02-01 10:32:08,2010-03-31 06:45:53,8125
285,66,236,587,"57 days, 20:25:42",2013-02-06 10:24:12,2010-02-01 10:32:08,2010-03-31 06:57:50,4725
1259,2328,2644,6231,"57 days, 20:33:26",2013-02-07 02:27:55,2010-02-01 10:32:08,2010-03-31 07:05:34,1347
115,170,292,577,"57 days, 20:38:08",2013-02-04 05:38:48,2010-04-03 09:56:52,2010-05-31 06:35:00,1705
236,5854,6388,12478,"57 days, 21:40:42",2013-02-07 10:31:57,2010-02-01 10:32:08,2010-03-31 08:12:50,5839
280,504,707,1491,"57 days, 21:46:09",2013-02-05 03:13:39,2010-02-24 04:04:02,2010-04-23 01:50:11,3336
4,948,1596,2548,"57 days, 21:52:09",2013-02-09 09:48:45,2010-02-01 10:32:08,2010-03-31 08:24:17,4020
671,812,1046,2529,"57 days, 22:22:39",2013-02-04 06:12:00,2010-02-01 10:32:08,2010-03-31 08:54:47,9197
1253,2582,3216,7051,"57 days, 22:35:16",2013-02-07 03:13:08,2010-02-01 10:32:08,2010-03-31 09:07:24,1684
711,554,1267,2532,"57 days, 22:35:50",2013-02-07 03:55:51,2010-02-23 02:26:41,2010-04-22 01:02:31,4310
724,2413,2054,5191,"57 days, 22:45:34",2013-02-06 11:51:07,2010-02-01 10:32:08,2010-03-31 09:17:42,5815
247,174,390,811,"57 days, 22:51:59",2013-02-01 04:50:25,2010-02-01 10:32:08,2010-03-31 09:24:07,8945
6,2445,2722,5173,"57 days, 22:58:18",2013-02-06 10:22:49,2010-02-01 10:32:08,2010-03-31 09:30:26,3087
720,360,677,1757,"57 days, 22:58:33",2013-02-06 03:33:04,2010-02-01 10:32:08,2010-03-31 09:30:41,558
186,115,251,552,"57 days, 22:59:04",2013-02-03 08:08:04,2010-03-26 01:30:21,2010-05-23 00:29:25,5412
264,866,1441,2571,"57 days, 23:04:37",2013-02-05 05:33:18,2010-04-19 02:23:11,2010-06-16 01:27:48,7047
18,52,517,587,"57 days, 23:31:04",2013-02-03 02:57:51,2010-02-01 10:32:08,2010-03-31 10:03:12,733
618,304,448,1370,"57 days, 23:34:45",2013-02-06 05:01:50,2010-03-14 03:09:56,2010-05-11 02:44:41,3638
401,56,380,837,"58 days, 0:08:44",2013-02-04 02:19:34,2010-02-01 10:32:08,2010-03-31 10:40:52,7340
702,732,1604,3038,"58 days, 1:02:52",2013-02-06 00:43:13,2010-02-01 10:32:08,2010-03-31 11:35:00,1286
144,202,267,613,"58 days, 1:11:40",2013-01-29 04:10:10,2010-02-01 10:32:08,2010-03-31 11:43:48,7012
626,403,612,1641,"58 days, 1:16:41",2013-02-01 04:57:33,2010-02-01 10:32:08,2010-03-31 11:48:49,1584
327,30,141,498,"58 days, 1:24:13",2013-01-29 02:49:57,2010-02-01 10:32:08,2010-03-31 11:56:21,902
1307,2,13,1322,"58 days, 2:45:30",2013-02-01 04:19:33,2011-12-16 03:31:53,2012-02-12 06:17:23,3767
248,850,2109,3207,"58 days, 9:49:28",2013-02-05 08:13:47,2010-02-14 01:43:30,2010-04-13 11:32:58,8721
504,366,304,1174,"58 days, 14:05:41",2013-02-01 06:19:06,2010-02-01 10:32:08,2010-04-01 00:37:49,1602
592,2249,3226,6067,"58 days, 14:15:26",2013-02-06 07:43:29,2010-02-01 10:32:08,2010-04-01 00:47:34,9972
22,234,646,902,"58 days, 14:18:56",2013-02-11 00:27:21,2010-02-01 10:32:08,2010-04-01 00:51:04,955
655,1756,2416,4827,"58 days, 14:19:02",2013-02-06 10:34:23,2010-02-01 10:32:08,2010-04-01 00:51:10,9320
564,695,1194,2453,"58 days, 14:42:51",2013-02-06 10:39:53,2010-02-01 10:32:08,2010-04-01 01:14:59,199
153,789,1520,2462,"58 days, 15:20:05",2013-02-06 08:42:08,2010-02-01 10:32:08,2010-04-01 01:52:13,2285
65,2866,4081,7012,"58 days, 15:36:31",2013-02-06 02:48:29,2010-02-01 10:32:08,2010-04-01 02:08:39,6978
1039,1799,2509,5347,"58 days, 16:02:23",2013-02-10 06:20:01,2010-02-01 10:32:08,2010-04-01 02:34:31,3456
1309,1412,2409,5130,"58 days, 16:18:55",2013-02-06 06:30:11,2010-02-01 10:32:08,2010-04-01 02:51:03,6164
368,1161,2487,4016,"58 days, 16:31:17",2013-02-06 05:49:25,2010-02-01 10:32:08,2010-04-01 03:03:25,3764
31,523,653,1207,"58 days, 17:08:00",2013-02-04 07:03:18,2010-02-01 10:32:08,2010-04-01 03:40:08,9006
1093,2419,2894,6406,"58 days, 17:12:51",2013-02-06 08:39:19,2010-02-01 10:32:08,2010-04-01 03:44:59,7944
637,2,97,736,"58 days, 17:36:53",2013-01-27 10:42:08,2010-12-16 09:42:40,2011-02-13 03:19:33,8516
437,41,68,546,"58 days, 17:42:48",2013-02-01 02:32:05,2010-02-01 10:32:08,2010-04-01 04:14:56,6699
92,231,419,742,"58 days, 18:11:32",2013-02-06 06:03:32,2010-04-17 06:04:58,2010-06-15 00:16:30,7259
575,827,1861,3263,"58 days, 18:29:48",2013-02-05 09:36:58,2010-02-01 10:32:08,2010-04-01 05:01:56,5665
289,636,1386,2311,"58 days, 18:36:14",2013-02-06 04:39:38,2010-02-01 10:32:08,2010-04-01 05:08:22,167
903,186,340,1429,"58 days, 18:54:53",2013-02-06 03:53:21,2010-02-01 10:32:08,2010-04-01 05:27:01,8574
482,789,776,2047,"58 days, 18:57:47",2013-02-05 05:20:25,2010-02-01 10:32:08,2010-04-01 05:29:55,7318
16,202,391,609,"58 days, 19:09:25",2013-02-04 08:56:50,2010-02-01 10:32:08,2010-04-01 05:41:33,2425
519,203,757,1479,"58 days, 19:33:50",2013-02-03 11:00:48,2010-02-01 10:32:08,2010-04-01 06:05:58,1650
158,1288,2675,4121,"58 days, 19:43:13",2013-02-04 06:46:03,2010-02-01 10:32:08,2010-04-01 06:15:21,4988
382,288,394,1064,"58 days, 19:53:53",2013-02-05 02:39:41,2010-09-29 09:51:56,2010-11-27 05:45:49,7553
33,1455,1462,2950,"58 days, 20:13:12",2013-02-04 04:27:39,2010-02-01 10:32:08,2010-04-01 06:45:20,291
336,81,305,722,"58 days, 20:19:59",2013-01-31 01:41:18,2010-02-01 10:32:08,2010-04-01 06:52:07,5056
550,7403,7380,15333,"58 days, 20:36:50",2013-02-07 05:42:17,2010-02-01 10:32:08,2010-04-01 07:08:58,2290
76,74,196,346,"58 days, 20:42:36",2013-02-06 04:49:44,2010-02-01 10:32:08,2010-04-01 07:14:44,3597
329,1663,2254,4246,"58 days, 20:44:28",2013-02-05 04:21:46,2010-02-01 10:32:08,2010-04-01 07:16:36,476
336,447,701,1484,"58 days, 21:09:46",2013-02-07 05:05:19,2010-02-01 10:32:08,2010-04-01 07:41:54,5363
1373,904,1023,3300,"58 days, 21:59:01",2013-02-10 02:03:41,2010-02-01 10:32:08,2010-04-01 08:31:09,1841
120,386,606,1112,"58 days, 22:03:16",2013-02-03 11:46:22,2010-02-01 10:32:08,2010-04-01 08:35:24,7014
866,914,1000,2780,"58 days, 22:09:15",2013-02-06 10:50:20,2010-02-01 10:32:08,2010-04-01 08:41:23,2888
43,1909,2133,4085,"58 days, 22:15:49",2013-02-06 02:41:55,2010-02-01 10:32:08,2010-04-01 08:47:57,8261
441,3050,3683,7174,"58 days, 22:42:22",2013-02-06 03:36:23,2010-02-01 10:32:08,2010-04-01 09:14:30,9027
25,24,245,294,"58 days, 22:56:40",2013-01-27 04:28:56,2010-07-28 10:49:56,2010-09-25 09:46:36,3893
159,636,917,1712,"58 days, 23:56:09",2013-02-05 11:09:25,2010-02-01 10:32:08,2010-04-01 10:28:17,2528
107,2931,2991,6029,"59 days, 0:03:35",2013-02-07 02:18:11,2010-02-01 10:32:08,2010-04-01 10:35:43,4843
104,481,1349,1934,"59 days, 0:13:12",2013-02-04 09:19:30,2010-02-01 10:32:08,2010-04-01 10:45:20,4691
893,4850,4829,10572,"59 days, 0:14:27",2013-02-06 04:12:41,2010-02-01 10:32:08,2010-04-01 10:46:35,7468
2250,688,1643,4581,"59 days, 0:38:33",2013-02-07 04:17:26,2010-02-01 10:32:08,2010-04-01 11:10:41,4235
822,4278,3494,8594,"59 days, 1:02:33",2013-02-06 11:28:48,2010-02-01 10:32:08,2010-04-01 11:34:41,4075
204,1350,2254,3808,"59 days, 1:03:54",2013-02-07 07:13:07,2010-02-01 10:32:08,2010-04-01 11:36:02,7918
636,874,2101,3611,"59 days, 2:07:23",2013-02-07 01:49:31,2010-03-07 07:30:57,2010-05-05 09:38:20,4627
1361,142,331,1834,"59 days, 3:22:52",2013-02-03 00:07:47,2010-02-28 03:38:38,2010-04-28 07:01:30,3620
328,64,263,655,"59 days, 4:25:36",2013-02-04 02:51:34,2010-08-30 04:15:12,2010-10-28 08:40:48,9752
341,1610,2209,4160,"59 days, 14:06:40",2013-02-06 08:06:23,2010-02-01 10:32:08,2010-04-02 00:38:48,473
1262,1147,1424,3833,"59 days, 14:20:54",2013-02-05 09:57:19,2010-02-01 10:32:08,2010-04-02 00:53:02,6321
354,67,146,567,"59 days, 14:24:55",2013-01-30 07:12:05,2010-02-01 10:32:08,2010-04-02 00:57:03,5525
1867,9211,8509,19587,"59 days, 14:39:49",2013-02-07 05:16:07,2010-02-01 10:32:08,2010-04-02 01:11:57,336
755,1252,1799,3806,"59 days, 14:46:20",2013-02-05 11:04:47,2010-02-01 10:32:08,2010-04-02 01:18:28,5837
75,177,830,1082,"59 days, 15:16:30",2013-02-04 11:56:18,2010-02-01 10:32:08,2010-04-02 01:48:38,997
741,1994,2789,5524,"59 days, 15:20:58",2013-02-06 11:56:26,2010-02-01 10:32:08,2010-04-02 01:53:06,1824
415,1523,3362,5300,"59 days, 15:30:37",2013-02-07 02:58:23,2010-02-01 10:32:08,2010-04-02 02:02:45,2465
928,2301,3295,6524,"59 days, 15:31:08",2013-02-07 04:59:11,2010-02-01 10:32:08,2010-04-02 02:03:16,2934
58,1149,1284,2491,"59 days, 15:47:44",2013-02-06 11:37:04,2010-02-01 10:32:08,2010-04-02 02:19:52,8365
1198,97,197,1492,"59 days, 15:52:42",2013-01-31 07:43:18,2010-02-01 10:32:08,2010-04-02 02:24:50,1784
295,803,1069,2167,"59 days, 15:55:11",2013-02-05 03:38:06,2010-02-01 10:32:08,2010-04-02 02:27:19,2836
134,642,1530,2306,"59 days, 17:27:56",2013-02-07 04:39:12,2010-02-01 10:32:08,2010-04-02 04:00:04,6480
1301,990,991,3282,"59 days, 18:11:45",2013-02-05 03:15:18,2010-02-01 10:32:08,2010-04-02 04:43:53,4611
512,272,828,1612,"59 days, 18:15:54",2013-02-05 07:19:47,2010-02-01 10:32:08,2010-04-02 04:48:02,7009
803,196,396,1395,"59 days, 18:22:29",2013-02-06 11:06:40,2010-02-01 10:32:08,2010-04-02 04:54:37,1599
1283,19,80,1382,"59 days, 18:29:16",2013-02-07 10:13:43,2010-02-01 10:32:08,2010-04-02 05:01:24,399
266,1878,2932,5076,"59 days, 18:34:30",2013-02-06 01:25:39,2010-02-19 09:07:12,2010-04-20 03:41:42,3974
370,3148,3122,6640,"59 days, 18:45:15",2013-02-09 09:32:34,2010-02-01 10:32:08,2010-04-02 05:17:23,3141
1409,114,311,1834,"59 days, 18:46:58",2013-02-04 00:18:19,2010-02-01 10:32:08,2010-04-02 05:19:06,7046
67,419,488,974,"59 days, 18:50:42",2013-02-07 02:07:13,2010-02-01 10:32:08,2010-04-02 05:22:50,6210
394,5157,6767,12318,"59 days, 18:56:17",2013-02-07 03:02:37,2010-02-01 10:32:08,2010-04-02 05:28:25,7245
912,267,562,1741,"59 days, 19:54:16",2013-02-03 05:53:40,2010-02-01 10:32:08,2010-04-02 06:26:24,5589
96,2839,3054,5989,"59 days, 20:07:07",2013-02-06 11:28:14,2010-02-01 10:32:08,2010-04-02 06:39:15,6239
886,925,1478,3289,"59 days, 20:21:16",2013-02-05 02:30:44,2010-02-01 10:32:08,2010-04-02 06:53:24,2287
341,666,944,1951,"59 days, 20:38:41",2013-02-06 02:33:18,2010-02-01 10:32:08,2010-04-02 07:10:49,5041
1486,770,1993,4249,"59 days, 20:39:16",2013-02-05 05:22:51,2010-02-01 10:32:08,2010-04-02 07:11:24,9638
219,3680,4315,8214,"59 days, 20:49:47",2013-02-05 02:54:04,2010-02-01 10:32:08,2010-04-02 07:21:55,7834
898,249,490,1637,"59 days, 20:58:06",2013-02-04 09:17:57,2010-02-01 10:32:08,2010-04-02 07:30:14,2480
448,194,53,695,"59 days, 21:08:25",2013-02-03 03:55:43,2010-10-06 04:17:06,2010-12-05 01:25:31,331
406,1159,2167,3732,"59 days, 21:21:00",2013-02-05 10:34:15,2010-02-01 10:32:08,2010-04-02 07:53:08,4065
1228,5914,5622,12764,"59 days, 21:39:41",2013-02-06 07:40:30,2010-02-01 10:32:08,2010-04-02 08:11:49,1348
6,293,355,654,"59 days, 22:23:19",2013-02-05 01:53:17,2010-02-01 10:32:08,2010-04-02 08:55:27,4874
118,1289,2251,3658,"59 days, 22:25:53",2013-02-06 09:50:25,2010-02-01 10:32:08,2010-04-02 08:58:01,7738
35,566,950,1551,"59 days, 22:31:29",2013-02-06 05:18:17,2010-02-01 10:32:08,2010-04-02 09:03:37,7445
954,20,20,994,"59 days, 22:47:28",2013-02-01 11:23:29,2010-02-01 10:32:08,2010-04-02 09:19:36,7743
363,1057,1298,2718,"59 days, 23:04:05",2013-02-04 01:03:12,2010-02-01 10:32:08,2010-04-02 09:36:13,4855
393,274,177,844,"59 days, 23:28:43",2013-01-31 02:33:06,2010-02-01 10:32:08,2010-04-02 10:00:51,7239
744,2303,2793,5840,"59 days, 23:42:21",2013-02-08 06:34:44,2010-02-01 10:32:08,2010-04-02 10:14:29,9022
286,5,50,341,"59 days, 23:44:01",2013-01-31 04:08:30,2010-03-28 10:40:08,2010-05-27 10:24:09,154
1099,1742,1717,4558,"60 days, 0:01:10",2013-02-06 11:28:03,2010-02-01 10:32:08,2010-04-02 10:33:18,138
78,156,563,797,"60 days, 0:02:43",2013-02-02 11:53:33,2010-02-01 10:32:08,2010-04-02 10:34:51,2588
232,1231,1410,2873,"60 days, 0:12:29",2013-02-06 08:18:25,2010-02-01 10:32:08,2010-04-02 10:44:37,1609
338,1059,2619,4016,"60 days, 0:22:31",2013-02-07 04:31:40,2010-02-01 10:32:08,2010-04-02 10:54:39,547
63,1659,2031,3753,"60 days, 0:35:03",2013-02-04 04:21:12,2010-02-01 10:32:08,2010-04-02 11:07:11,4029
148,2036,3466,5650,"60 days, 1:24:17",2013-02-06 07:08:07,2010-02-01 10:32:08,2010-04-02 11:56:25,3510
503,978,2652,4133,"60 days, 2:30:03",2013-02-07 00:16:01,2010-03-16 07:33:39,2010-05-15 10:03:42,6435
564,18,40,622,"60 days, 2:49:34",2013-01-29 05:14:46,2010-03-21 05:19:05,2010-05-20 08:08:39,5793
586,167,416,1169,"60 days, 3:05:35",2013-02-01 04:38:56,2010-03-27 00:46:44,2010-05-26 03:52:19,8250
881,1528,1468,3877,"60 days, 4:14:27",2013-02-07 04:26:48,2010-03-12 04:15:03,2010-05-11 08:29:30,550
914,372,1108,2394,"60 days, 15:01:35",2013-02-05 04:11:48,2010-02-01 10:32:08,2010-04-03 01:33:43,2644
235,1142,2222,3599,"60 days, 15:06:29",2013-02-06 11:44:25,2010-02-01 10:32:08,2010-04-03 01:38:37,8638
3,233,279,515,"60 days, 15:41:41",2013-02-05 04:26:02,2010-02-01 10:32:08,2010-04-03 02:13:49,7136
55,468,588,1111,"60 days, 16:02:49",2013-02-05 08:43:10,2010-02-01 10:32:08,2010-04-03 02:34:57,9427
542,3568,3498,7608,"60 days, 16:09:43",2013-02-07 01:56:05,2010-02-01 10:32:08,2010-04-03 02:41:51,2213
246,227,799,1272,"60 days, 16:23:29",2013-02-02 03:39:44,2010-02-01 10:32:08,2010-04-03 02:55:37,5190
83,131,469,683,"60 days, 17:05:39",2013-02-05 05:01:12,2010-03-07 10:25:38,2010-05-07 03:31:17,9582
493,20,107,620,"60 days, 17:32:12",2013-02-08 06:48:37,2010-02-01 10:32:08,2010-04-03 04:04:20,7151
24,3815,3039,6878,"60 days, 17:47:39",2013-02-04 10:02:41,2010-02-01 10:32:08,2010-04-03 04:19:47,6606
1205,2908,3526,7639,"60 days, 18:51:53",2013-02-12 00:05:54,2010-02-01 10:32:08,2010-04-03 05:24:01,7631
10,301,1114,1425,"60 days, 18:52:38",2013-02-03 00:14:48,2010-02-01 10:32:08,2010-04-03 05:24:46,2860
837,140,467,1444,"60 days, 18:53:24",2013-02-06 10:46:05,2010-02-01 10:32:08,2010-04-03 05:25:32,776
725,511,1165,2401,"60 days, 19:01:31",2013-02-04 06:00:48,2010-02-01 10:32:08,2010-04-03 05:33:39,5015
3,242,719,964,"60 days, 19:03:17",2013-02-06 06:19:01,2010-02-01 10:32:08,2010-04-03 05:35:25,8933
100,1811,2097,4008,"60 days, 19:31:25",2013-02-06 10:05:12,2010-02-01 10:32:08,2010-04-03 06:03:33,3124
961,2,62,1025,"60 days, 19:33:47",2013-01-28 00:19:57,2010-05-18 11:41:52,2010-07-18 07:15:39,2403
1117,654,1015,2786,"60 days, 19:40:33",2013-02-03 00:16:52,2010-02-01 10:32:08,2010-04-03 06:12:41,7129
930,0,0,930,"60 days, 20:07:54",2013-01-28 11:43:00,2010-02-01 10:32:08,2010-04-03 06:40:02,1310
1171,2406,3050,6627,"60 days, 20:38:37",2013-02-06 09:23:48,2010-02-01 10:32:08,2010-04-03 07:10:45,7263
26,3606,3998,7630,"60 days, 20:57:18",2013-02-06 06:44:23,2010-02-01 10:32:08,2010-04-03 07:29:26,3911
31,836,695,1562,"60 days, 21:16:05",2013-02-06 07:07:53,2010-02-01 10:32:08,2010-04-03 07:48:13,2559
931,1651,2087,4669,"60 days, 21:43:00",2013-02-06 11:20:42,2010-02-01 10:32:08,2010-04-03 08:15:08,86
696,593,1488,2777,"60 days, 22:06:30",2013-02-06 09:16:51,2010-02-01 10:32:08,2010-04-03 08:38:38,777
743,823,1015,2581,"60 days, 22:51:05",2013-02-04 08:50:31,2010-02-01 10:32:08,2010-04-03 09:23:13,5146
596,1132,2359,4087,"60 days, 22:51:43",2013-02-05 07:14:10,2010-02-01 10:32:08,2010-04-03 09:23:51,8436
488,6,41,535,"60 days, 22:59:26",2013-02-04 01:23:54,2010-07-13 07:05:13,2010-09-12 06:04:39,7469
807,1670,2956,5433,"60 days, 23:01:12",2013-02-07 07:22:52,2010-02-01 10:32:08,2010-04-03 09:33:20,3085
229,660,906,1795,"60 days, 23:12:32",2013-02-05 08:11:10,2010-02-01 10:32:08,2010-04-03 09:44:40,393
26,10,532,568,"60 days, 23:31:32",2013-01-31 05:01:19,2010-02-01 10:32:08,2010-04-03 10:03:40,2458
257,1395,2426,4078,"60 days, 23:49:45",2013-02-07 06:07:38,2010-02-01 10:32:08,2010-04-03 10:21:53,7557
223,759,784,1766,"60 days, 23:52:51",2013-02-03 08:29:04,2010-02-01 10:32:08,2010-04-03 10:24:59,7819
3,634,552,1189,"61 days, 0:09:52",2013-02-04 06:59:12,2010-02-01 10:32:08,2010-04-03 10:42:00,4726
149,2722,4848,7719,"61 days, 0:18:56",2013-02-06 02:50:19,2010-02-01 10:32:08,2010-04-03 10:51:04,4695
201,3701,2788,6690,"61 days, 0:25:53",2013-02-06 05:59:57,2010-02-01 10:32:08,2010-04-03 10:58:01,2353
860,615,1092,2567,"61 days, 0:40:40",2013-02-06 01:42:10,2010-02-01 10:32:08,2010-04-03 11:12:48,9349
190,283,477,950,"61 days, 0:50:26",2013-02-04 00:42:31,2010-02-01 10:32:08,2010-04-03 11:22:34,5258
587,471,1091,2149,"61 days, 1:19:14",2013-02-02 01:34:55,2010-02-01 10:32:08,2010-04-03 11:51:22,745
531,2,26,559,"61 days, 6:38:38",2013-02-02 06:48:05,2010-06-03 01:25:50,2010-08-03 08:04:28,5391
1354,0,7,1361,"61 days, 13:59:57",2013-01-31 00:11:42,2010-02-01 10:32:08,2010-04-04 00:32:05,3950
1373,48,323,1744,"61 days, 14:00:34",2013-02-05 01:52:29,2010-02-01 10:32:08,2010-04-04 00:32:42,7630
1214,58,140,1412,"61 days, 14:36:39",2013-02-03 07:45:00,2010-02-01 10:32:08,2010-04-04 01:08:47,6468
484,763,3254,4501,"61 days, 14:44:33",2013-02-07 07:19:52,2010-02-01 10:32:08,2010-04-04 01:16:41,4607
95,712,1159,1966,"61 days, 15:02:51",2013-02-04 02:33:36,2010-02-01 10:32:08,2010-04-04 01:34:59,8675
26,199,465,690,"61 days, 15:10:55",2013-01-31 10:14:13,2010-02-01 10:32:08,2010-04-04 01:43:03,96
8,70,260,338,"61 days, 15:13:38",2013-01-25 08:18:06,2010-02-01 10:32:08,2010-04-04 01:45:46,5600
331,1246,1750,3327,"61 days, 15:19:47",2013-02-04 06:35:35,2010-02-01 10:32:08,2010-04-04 01:51:55,2041
1313,334,1245,2892,"61 days, 15:20:58",2013-02-02 04:48:05,2010-02-01 10:32:08,2010-04-04 01:53:06,6382
1813,1374,2060,5247,"61 days, 15:49:07",2013-02-07 10:09:18,2010-02-01 10:32:08,2010-04-04 02:21:15,1706
563,432,702,1697,"61 days, 17:40:26",2013-02-05 07:07:09,2010-02-01 10:32:08,2010-04-04 04:12:34,8411
3,379,613,995,"61 days, 17:41:58",2013-02-06 05:35:50,2010-02-01 10:32:08,2010-04-04 04:14:06,4857
435,749,1689,2873,"61 days, 18:05:59",2013-02-06 03:37:30,2010-02-01 10:32:08,2010-04-04 04:38:07,762
319,49,81,449,"61 days, 18:06:39",2013-01-31 10:51:07,2010-02-01 10:32:08,2010-04-04 04:38:47,879
416,757,1637,2810,"61 days, 18:14:03",2013-02-06 06:43:47,2010-02-01 10:32:08,2010-04-04 04:46:11,7231
272,725,1145,2142,"61 days, 18:22:27",2013-02-06 08:12:54,2010-02-01 10:32:08,2010-04-04 04:54:35,6593
1260,0,59,1319,"61 days, 18:50:29",2013-01-28 07:45:30,2010-02-01 10:32:08,2010-04-04 05:22:37,3066
786,663,1711,3160,"61 days, 20:04:20",2013-02-05 07:50:45,2010-02-01 10:32:08,2010-04-04 06:36:28,3588
59,6505,5637,12201,"61 days, 20:05:04",2013-02-07 06:00:29,2010-02-01 10:32:08,2010-04-04 06:37:12,5184
670,1260,2841,4771,"61 days, 20:38:44",2013-02-06 05:30:55,2010-02-01 10:32:08,2010-04-04 07:10:52,5421
463,4831,4053,9347,"61 days, 20:50:33",2013-02-15 04:48:43,2010-02-01 10:32:08,2010-04-04 07:22:41,2922
361,306,737,1404,"61 days, 20:52:31",2013-02-04 09:15:44,2010-04-15 05:22:55,2010-06-16 02:15:26,5554
1233,326,870,2429,"61 days, 20:53:11",2013-02-07 05:15:47,2010-02-01 10:32:08,2010-04-04 07:25:19,5108
208,706,775,1689,"61 days, 20:54:26",2013-02-05 08:36:43,2010-02-01 10:32:08,2010-04-04 07:26:34,5568
224,829,1393,2446,"61 days, 21:01:58",2013-02-19 06:59:35,2010-02-01 10:32:08,2010-04-04 07:34:06,2154
613,1876,3797,6286,"61 days, 21:25:05",2013-02-06 10:01:12,2010-02-01 10:32:08,2010-04-04 07:57:13,4688
155,480,866,1501,"61 days, 21:36:35",2013-02-07 04:36:08,2010-02-01 10:32:08,2010-04-04 08:08:43,1675
661,1247,2362,4270,"61 days, 22:17:24",2013-02-05 02:04:39,2010-02-01 10:32:08,2010-04-04 08:49:32,5965
164,236,355,755,"61 days, 22:36:40",2013-01-31 00:44:53,2010-02-22 02:54:23,2010-04-25 01:31:03,8534
145,423,549,1117,"61 days, 22:42:04",2013-02-07 07:17:00,2010-04-18 10:21:43,2010-06-19 09:03:47,2977
1165,199,784,2148,"61 days, 22:49:12",2013-02-02 11:13:51,2010-02-01 10:32:08,2010-04-04 09:21:20,4165
328,1383,1883,3594,"61 days, 22:51:06",2013-02-07 06:52:01,2010-02-01 10:32:08,2010-04-04 09:23:14,2208
412,748,868,2028,"61 days, 22:52:51",2013-02-04 06:50:40,2010-02-01 10:32:08,2010-04-04 09:24:59,9199
266,2811,2952,6029,"61 days, 23:20:55",2013-02-03 10:30:25,2010-02-01 10:32:08,2010-04-04 09:53:03,593
218,1290,1331,2839,"61 days, 23:21:33",2013-02-05 10:20:36,2010-02-01 10:32:08,2010-04-04 09:53:41,7045
11,2386,2915,5312,"61 days, 23:29:36",2013-02-07 10:02:23,2010-02-01 10:32:08,2010-04-04 10:01:44,2457
343,2989,3246,6578,"61 days, 23:41:06",2013-02-07 06:07:58,2010-02-01 10:32:08,2010-04-04 10:13:14,1421
1472,353,978,2803,"61 days, 23:42:30",2013-02-05 01:18:03,2010-02-01 10:32:08,2010-04-04 10:14:38,5920
408,1963,2410,4781,"61 days, 23:46:40",2013-02-06 11:32:22,2010-02-01 10:32:08,2010-04-04 10:18:48,5163
572,701,999,2272,"62 days, 0:39:37",2013-02-04 00:41:14,2010-02-01 10:32:08,2010-04-04 11:11:45,6396
362,13,213,588,"62 days, 1:38:10",2013-02-06 06:37:07,2010-06-02 01:19:37,2010-08-03 02:57:47,3733
9,49,169,227,"62 days, 2:14:27",2013-02-01 01:58:34,2010-09-26 05:57:09,2010-11-27 08:11:36,7100
365,74,70,509,"62 days, 2:23:00",2013-02-04 09:34:34,2011-01-10 03:14:58,2011-03-13 05:37:58,8212
993,712,1532,3237,"62 days, 14:07:49",2013-02-07 00:40:07,2010-02-01 10:32:08,2010-04-05 00:39:57,9042
102,675,1134,1911,"62 days, 14:08:59",2013-02-06 11:49:19,2010-02-01 10:32:08,2010-04-05 00:41:07,5422
405,71,179,655,"62 days, 14:35:32",2013-02-04 05:50:52,2010-02-01 10:32:08,2010-04-05 01:07:40,3178
827,547,909,2283,"62 days, 14:46:43",2013-02-05 01:09:28,2010-02-01 10:32:08,2010-04-05 01:18:51,5682
165,313,898,1376,"62 days, 14:56:42",2013-02-04 06:13:06,2010-02-01 10:32:08,2010-04-05 01:28:50,4392
367,370,620,1357,"62 days, 15:05:28",2013-02-06 01:27:40,2010-02-01 10:32:08,2010-04-05 01:37:36,8994
1293,1,36,1330,"62 days, 15:11:40",2013-01-31 09:19:24,2010-02-01 10:32:08,2010-04-05 01:43:48,8118
462,2399,2317,5178,"62 days, 15:23:35",2013-02-05 11:20:06,2010-02-01 10:32:08,2010-04-05 01:55:43,7753
648,5,93,746,"62 days, 15:59:37",2013-01-21 10:29:26,2010-02-01 10:32:08,2010-04-05 02:31:45,1937
177,524,788,1489,"62 days, 16:04:59",2013-02-06 09:37:34,2010-02-01 10:32:08,2010-04-05 02:37:07,5756
21,3251,3206,6478,"62 days, 16:25:02",2013-02-25 05:41:07,2010-02-01 10:32:08,2010-04-05 02:57:10,5036
62,47,314,423,"62 days, 16:34:39",2013-01-31 00:01:03,2010-02-01 10:32:08,2010-04-05 03:06:47,6591
442,468,853,1763,"62 days, 16:40:14",2013-02-07 00:51:09,2010-02-01 10:32:08,2010-04-05 03:12:22,4039
37,271,655,963,"62 days, 17:15:53",2013-02-05 10:22:22,2010-02-01 10:32:08,2010-04-05 03:48:01,4830
31,986,1378,2395,"62 days, 17:28:00",2013-02-06 01:01:05,2010-02-01 10:32:08,2010-04-05 04:00:08,3542
836,7,96,939,"62 days, 17:28:39",2013-01-26 05:00:34,2010-02-01 10:32:08,2010-04-05 04:00:47,7255
764,174,382,1320,"62 days, 17:43:13",2013-02-03 01:33:30,2010-02-01 10:32:08,2010-04-05 04:15:21,7627
42,3122,3452,6616,"62 days, 18:32:03",2013-02-07 01:42:27,2010-02-01 10:32:08,2010-04-05 05:04:11,8639
80,1326,2137,3543,"62 days, 18:58:56",2013-02-06 08:59:40,2010-02-01 10:32:08,2010-04-05 05:31:04,4258
725,71,407,1203,"62 days, 19:05:57",2013-02-04 07:46:51,2010-02-01 10:32:08,2010-04-05 05:38:05,3313
146,1207,1990,3343,"62 days, 19:10:52",2013-02-06 06:30:37,2010-02-01 10:32:08,2010-04-05 05:43:00,5496
76,257,689,1022,"62 days, 19:12:45",2013-02-07 01:18:36,2010-02-01 10:32:08,2010-04-05 05:44:53,8293
455,750,1114,2319,"62 days, 19:12:48",2013-02-04 10:37:32,2010-02-01 10:32:08,2010-04-05 05:44:56,5484
178,259,373,810,"62 days, 19:14:05",2013-02-05 00:42:38,2010-02-01 10:32:08,2010-04-05 05:46:13,143
111,983,1183,2277,"62 days, 19:21:29",2013-02-02 08:10:01,2010-02-01 10:32:08,2010-04-05 05:53:37,7701
1063,460,715,2238,"62 days, 20:49:37",2013-02-05 02:35:19,2010-02-01 10:32:08,2010-04-05 07:21:45,3910
64,1041,1105,2210,"62 days, 21:28:12",2013-02-06 08:25:59,2010-02-01 10:32:08,2010-04-05 08:00:20,8104
520,1120,1554,3194,"62 days, 21:39:39",2013-02-06 08:59:45,2010-02-01 10:32:08,2010-04-05 08:11:47,7035
1266,3416,4013,8695,"62 days, 21:41:05",2013-02-06 10:26:14,2010-02-01 10:32:08,2010-04-05 08:13:13,6310
382,1994,2742,5118,"62 days, 21:51:27",2013-02-07 07:32:18,2010-02-01 10:32:08,2010-04-05 08:23:35,4315
251,554,1357,2162,"62 days, 22:42:03",2013-02-05 03:35:48,2010-02-01 10:32:08,2010-04-05 09:14:11,3664
43,416,558,1017,"63 days, 0:10:56",2013-02-07 05:55:29,2010-02-01 10:32:08,2010-04-05 10:43:04,1662
469,24,278,771,"63 days, 0:18:15",2013-01-30 08:08:49,2010-02-01 10:32:08,2010-04-05 10:50:23,3010
1114,4874,4840,10828,"63 days, 1:02:29",2013-02-06 11:08:18,2010-02-01 10:32:08,2010-04-05 11:34:37,7613
59,646,881,1586,"63 days, 1:28:50",2013-02-06 07:31:12,2010-03-28 08:35:20,2010-05-30 10:04:10,7453
462,13,84,559,"63 days, 2:32:36",2013-02-06 06:27:42,2011-06-22 08:05:46,2011-08-24 10:38:22,5451
359,31,237,627,"63 days, 4:10:05",2013-02-05 04:05:51,2010-08-31 07:20:43,2010-11-02 11:30:48,598
1404,88,419,1911,"63 days, 13:44:31",2013-02-02 10:05:42,2010-02-01 10:32:08,2010-04-06 00:16:39,2591
520,331,1266,2117,"63 days, 14:20:31",2013-02-05 06:02:27,2010-02-01 10:32:08,2010-04-06 00:52:39,4690
89,40,260,389,"63 days, 14:25:02",2013-01-31 07:10:28,2010-02-01 10:32:08,2010-04-06 00:57:10,9859
677,24,174,875,"63 days, 14:36:57",2013-02-01 02:59:14,2010-02-01 10:32:08,2010-04-06 01:09:05,4782
267,660,1002,1929,"63 days, 14:58:00",2013-02-07 04:16:35,2010-02-01 10:32:08,2010-04-06 01:30:08,4300
1558,2862,3707,8127,"63 days, 15:16:23",2013-02-07 00:20:39,2010-02-01 10:32:08,2010-04-06 01:48:31,2066
118,215,434,767,"63 days, 15:22:26",2013-02-06 04:34:51,2010-02-01 10:32:08,2010-04-06 01:54:34,9662
482,317,525,1324,"63 days, 16:19:58",2013-01-30 11:26:42,2010-02-01 10:32:08,2010-04-06 02:52:06,287
133,675,1489,2297,"63 days, 16:50:51",2013-02-07 06:20:47,2010-02-01 10:32:08,2010-04-06 03:22:59,8911
641,626,1096,2363,"63 days, 16:51:01",2013-02-06 10:16:08,2010-02-01 10:32:08,2010-04-06 03:23:09,4412
623,3325,4746,8694,"63 days, 16:58:26",2013-02-05 07:52:02,2010-02-01 10:32:08,2010-04-06 03:30:34,5384
828,1473,1673,3974,"63 days, 17:45:38",2013-02-06 10:34:47,2010-02-01 10:32:08,2010-04-06 04:17:46,6137
142,1913,1995,4050,"63 days, 18:00:55",2013-02-06 00:30:05,2010-02-01 10:32:08,2010-04-06 04:33:03,3080
221,304,626,1151,"63 days, 18:32:26",2013-02-06 05:55:18,2010-02-01 10:32:08,2010-04-06 05:04:34,183
0,22,105,127,"63 days, 19:16:34",2013-01-30 01:58:18,2011-05-09 07:54:45,2011-07-12 03:11:19,9407
143,628,908,1679,"63 days, 19:35:58",2013-02-07 09:26:25,2010-02-01 10:32:08,2010-04-06 06:08:06,2080
70,25,124,219,"63 days, 20:15:29",2013-02-01 04:42:59,2010-02-01 10:32:08,2010-04-06 06:47:37,1611
241,585,795,1621,"63 days, 20:18:16",2013-02-04 11:59:24,2010-02-01 10:32:08,2010-04-06 06:50:24,1868
622,1523,2462,4607,"63 days, 20:22:59",2013-02-07 08:34:04,2010-02-01 10:32:08,2010-04-06 06:55:07,5696
1024,1252,2034,4310,"63 days, 20:31:16",2013-02-07 07:51:02,2010-02-01 10:32:08,2010-04-06 07:03:24,4566
186,113,370,669,"63 days, 20:50:55",2013-01-31 04:51:37,2010-02-01 10:32:08,2010-04-06 07:23:03,4548
739,2154,4948,7841,"63 days, 21:07:02",2013-02-06 11:00:50,2010-02-01 10:32:08,2010-04-06 07:39:10,1427
43,961,1223,2227,"63 days, 21:14:12",2013-02-04 11:51:22,2010-02-01 10:32:08,2010-04-06 07:46:20,1853
376,194,345,915,"63 days, 21:16:57",2013-02-08 03:33:40,2010-04-11 10:17:02,2010-06-14 07:33:59,35
113,48,215,376,"63 days, 21:22:54",2013-01-29 10:45:18,2010-06-16 10:24:31,2010-08-19 07:47:25,6429
482,212,410,1104,"63 days, 21:30:58",2013-02-01 11:59:23,2010-02-01 10:32:08,2010-04-06 08:03:06,418
45,156,307,508,"63 days, 22:16:06",2013-02-03 01:33:46,2010-02-01 10:32:08,2010-04-06 08:48:14,3448
280,251,199,730,"63 days, 22:22:26",2013-01-31 02:11:00,2010-02-01 10:32:08,2010-04-06 08:54:34,3551
1180,256,659,2095,"63 days, 22:25:25",2013-02-06 09:52:36,2010-02-01 10:32:08,2010-04-06 08:57:33,9885
444,821,1023,2288,"63 days, 22:50:41",2013-02-07 07:29:12,2010-02-01 10:32:08,2010-04-06 09:22:49,2780
1086,5910,5501,12497,"63 days, 23:20:09",2013-02-07 03:17:40,2010-02-01 10:32:08,2010-04-06 09:52:17,8980
1032,7,60,1099,"63 days, 23:55:24",2013-02-04 06:26:29,2010-02-01 10:32:08,2010-04-06 10:27:32,9575
331,8,78,417,"64 days, 0:45:37",2013-01-26 08:35:39,2010-02-01 10:32:08,2010-04-06 11:17:45,8224
364,909,1509,2782,"64 days, 1:22:46",2013-02-06 09:46:10,2010-02-01 10:32:08,2010-04-06 11:54:54,5369
460,1211,2900,4571,"64 days, 13:32:40",2013-02-07 03:25:17,2010-02-01 10:32:08,2010-04-07 00:04:48,4455
588,3054,2971,6613,"64 days, 13:35:45",2013-02-07 11:05:13,2010-02-01 10:32:08,2010-04-07 00:07:53,587
614,654,1613,2881,"64 days, 13:51:22",2013-02-05 03:41:40,2010-02-01 10:32:08,2010-04-07 00:23:30,2548
308,1999,2867,5174,"64 days, 14:05:03",2013-02-04 10:17:50,2010-02-01 10:32:08,2010-04-07 00:37:11,7569
392,181,556,1129,"64 days, 14:14:24",2013-02-02 02:01:57,2010-02-01 10:32:08,2010-04-07 00:46:32,3509
1084,1292,2165,4541,"64 days, 14:24:19",2013-02-07 08:13:52,2010-02-01 10:32:08,2010-04-07 00:56:27,8297
243,2081,2583,4907,"64 days, 14:37:38",2013-02-07 06:26:30,2010-02-01 10:32:08,2010-04-07 01:09:46,2018
735,3,107,845,"64 days, 14:51:48",2013-01-27 02:55:25,2010-02-01 10:32:08,2010-04-07 01:23:56,1838
100,379,1128,1607,"64 days, 14:58:59",2013-02-05 07:05:07,2010-02-01 10:32:08,2010-04-07 01:31:07,7848
1184,123,256,1563,"64 days, 15:00:09",2013-02-04 03:15:30,2010-02-01 10:32:08,2010-04-07 01:32:17,6338
182,109,171,462,"64 days, 15:24:57",2013-02-02 04:32:07,2010-02-01 10:32:08,2010-04-07 01:57:05,4533
787,776,997,2560,"64 days, 15:32:42",2013-02-04 07:01:13,2010-02-01 10:32:08,2010-04-07 02:04:50,545
2082,1830,2239,6151,"64 days, 15:39:15",2013-02-06 02:13:36,2010-02-01 10:32:08,2010-04-07 02:11:23,8313
1450,269,427,2146,"64 days, 15:42:30",2013-02-02 11:31:04,2010-02-01 10:32:08,2010-04-07 02:14:38,1083
335,2183,2274,4792,"64 days, 15:54:56",2013-02-09 11:58:24,2010-02-01 10:32:08,2010-04-07 02:27:04,5743
365,256,719,1340,"64 days, 16:07:50",2013-02-07 02:55:36,2010-02-01 10:32:08,2010-04-07 02:39:58,7528
30,254,300,584,"64 days, 16:27:55",2013-02-03 10:34:00,2010-02-01 10:32:08,2010-04-07 03:00:03,549
49,205,705,959,"64 days, 17:27:02",2013-02-04 08:18:04,2010-02-01 10:32:08,2010-04-07 03:59:10,9746
71,803,1645,2519,"64 days, 17:28:22",2013-02-05 00:49:38,2010-02-01 10:32:08,2010-04-07 04:00:30,6801
920,457,677,2054,"64 days, 17:31:30",2013-02-05 09:08:11,2010-02-01 10:32:08,2010-04-07 04:03:38,8346
340,53,213,606,"64 days, 18:22:30",2013-02-12 05:47:57,2010-02-01 10:32:08,2010-04-07 04:54:38,5608
32,2319,3962,6313,"64 days, 18:28:22",2013-02-07 02:48:00,2010-02-01 10:32:08,2010-04-07 05:00:30,9314
866,19,137,1022,"64 days, 18:40:00",2013-02-04 06:08:22,2010-02-01 10:32:08,2010-04-07 05:12:08,9026
766,0,6,772,"64 days, 18:47:53",2013-01-31 05:43:15,2010-02-01 10:32:08,2010-04-07 05:20:01,3134
646,1,11,658,"64 days, 19:18:18",2013-01-29 06:07:23,2010-02-01 10:32:08,2010-04-07 05:50:26,2831
885,1591,2187,4663,"64 days, 19:43:53",2013-02-05 07:03:35,2010-02-01 10:32:08,2010-04-07 06:16:01,5025
199,193,115,507,"64 days, 20:00:28",2013-02-10 01:10:28,2010-02-01 10:32:08,2010-04-07 06:32:36,5055
1295,7932,5636,14863,"64 days, 20:29:55",2013-02-07 00:23:40,2010-02-01 10:32:08,2010-04-07 07:02:03,471
903,320,594,1817,"64 days, 20:37:42",2013-02-06 03:27:00,2010-04-12 03:30:48,2010-06-16 00:08:30,9031
448,1024,1403,2875,"64 days, 20:43:44",2013-02-07 01:15:28,2010-02-01 10:32:08,2010-04-07 07:15:52,9283
419,583,1469,2471,"64 days, 21:49:02",2013-02-05 03:01:14,2010-02-01 10:32:08,2010-04-07 08:21:10,5687
397,354,370,1121,"64 days, 22:30:18",2013-02-04 00:25:38,2010-02-01 10:32:08,2010-04-07 09:02:26,341
1206,194,255,1655,"64 days, 22:38:11",2013-02-03 08:58:41,2010-02-01 10:32:08,2010-04-07 09:10:19,2712
593,3022,4163,7778,"64 days, 23:18:18",2013-02-07 07:46:17,2010-02-01 10:32:08,2010-04-07 09:50:26,5290
319,810,1571,2700,"65 days, 0:01:05",2013-02-06 11:30:23,2010-02-01 10:32:08,2010-04-07 10:33:13,8148
879,1672,2762,5313,"65 days, 0:20:52",2013-02-04 10:14:51,2010-02-01 10:32:08,2010-04-07 10:53:00,1817
37,114,288,439,"65 days, 0:31:11",2013-02-05 09:13:06,2010-11-06 09:44:04,2011-01-10 10:15:15,8683
947,806,2215,3968,"65 days, 0:41:41",2013-02-06 03:29:38,2010-02-01 10:32:08,2010-04-07 11:13:49,7371
972,713,1469,3154,"65 days, 0:57:56",2013-02-07 03:05:07,2010-02-01 10:32:08,2010-04-07 11:30:04,2690
945,561,743,2249,"65 days, 1:02:19",2013-02-06 05:57:35,2010-02-01 10:32:08,2010-04-07 11:34:27,572
89,1417,1891,3397,"65 days, 1:06:59",2013-02-06 02:27:36,2010-02-01 10:32:08,2010-04-07 11:39:07,4073
817,4019,4259,9095,"65 days, 1:08:39",2013-02-06 05:06:32,2010-02-01 10:32:08,2010-04-07 11:40:47,7431
597,2774,3303,6674,"65 days, 1:26:09",2013-02-07 07:22:37,2010-02-01 10:32:08,2010-04-07 11:58:17,5294
489,921,1453,2863,"65 days, 13:51:17",2013-02-06 11:20:52,2010-02-01 10:32:08,2010-04-08 00:23:25,4346
1753,1230,1878,4861,"65 days, 14:22:46",2013-02-06 00:59:05,2010-02-01 10:32:08,2010-04-08 00:54:54,9682
208,669,1412,2289,"65 days, 14:29:01",2013-02-06 09:05:21,2010-02-01 10:32:08,2010-04-08 01:01:09,3036
294,985,1467,2746,"65 days, 14:33:46",2013-02-06 08:34:26,2010-02-01 10:32:08,2010-04-08 01:05:54,9632
106,741,1465,2312,"65 days, 14:34:35",2013-02-05 07:55:33,2010-02-01 10:32:08,2010-04-08 01:06:43,8757
52,29,93,174,"65 days, 15:06:15",2013-02-06 06:36:23,2011-01-17 09:41:30,2011-03-24 00:47:45,2302
106,116,473,695,"65 days, 15:32:28",2013-02-03 00:51:00,2010-02-01 10:32:08,2010-04-08 02:04:36,4203
1303,3643,4217,9163,"65 days, 16:13:00",2013-02-07 03:03:14,2010-02-01 10:32:08,2010-04-08 02:45:08,1093
23,330,237,590,"65 days, 16:38:53",2013-01-31 08:04:54,2010-02-01 10:32:08,2010-04-08 03:11:01,8508
174,1884,2811,4869,"65 days, 16:56:15",2013-02-07 09:38:10,2010-02-01 10:32:08,2010-04-08 03:28:23,339
335,2712,5201,8248,"65 days, 17:44:37",2013-02-07 06:36:20,2010-02-01 10:32:08,2010-04-08 04:16:45,9090
658,1498,1423,3579,"65 days, 17:49:05",2013-02-07 07:19:23,2010-02-01 10:32:08,2010-04-08 04:21:13,2553
1003,1373,1747,4123,"65 days, 17:50:47",2013-02-05 07:25:54,2010-02-01 10:32:08,2010-04-08 04:22:55,6449
310,870,2005,3185,"65 days, 18:13:21",2013-02-07 03:13:54,2010-02-01 10:32:08,2010-04-08 04:45:29,1382
316,344,519,1179,"65 days, 18:18:57",2013-02-05 06:38:26,2010-02-01 10:32:08,2010-04-08 04:51:05,3416
33,1598,2702,4333,"65 days, 18:49:00",2013-02-07 00:25:55,2010-02-01 10:32:08,2010-04-08 05:21:08,4576
30,336,766,1132,"65 days, 19:31:42",2013-02-07 06:19:02,2010-02-01 10:32:08,2010-04-08 06:03:50,9243
152,291,396,839,"65 days, 19:37:22",2013-02-04 10:40:38,2010-02-01 10:32:08,2010-04-08 06:09:30,1336
236,401,542,1179,"65 days, 19:40:34",2013-02-06 10:17:01,2010-03-06 08:11:05,2010-05-11 03:51:39,5524
530,22,144,696,"65 days, 20:05:02",2013-01-30 01:40:27,2010-02-01 10:32:08,2010-04-08 06:37:10,3813
436,343,821,1600,"65 days, 20:05:15",2013-02-05 11:49:26,2010-02-01 10:32:08,2010-04-08 06:37:23,5987
434,4194,4199,8827,"65 days, 20:06:23",2013-02-06 05:31:07,2010-02-01 10:32:08,2010-04-08 06:38:31,9265
338,42,386,766,"65 days, 20:08:24",2013-02-02 09:33:05,2010-02-01 10:32:08,2010-04-08 06:40:32,3847
53,181,695,929,"65 days, 20:11:41",2013-02-05 02:47:38,2010-02-01 10:32:08,2010-04-08 06:43:49,4534
198,880,2165,3243,"65 days, 20:42:48",2013-02-06 02:45:51,2010-02-01 10:32:08,2010-04-08 07:14:56,6447
1685,1828,2882,6395,"65 days, 21:00:58",2013-02-07 04:36:32,2010-02-01 10:32:08,2010-04-08 07:33:06,2960
84,690,1061,1835,"65 days, 21:01:12",2013-02-06 03:34:49,2010-02-01 10:32:08,2010-04-08 07:33:20,2862
238,249,302,789,"65 days, 21:34:18",2013-02-02 05:16:38,2010-02-01 10:32:08,2010-04-08 08:06:26,3458
9,835,1124,1968,"65 days, 21:37:09",2013-02-06 08:18:40,2010-02-01 10:32:08,2010-04-08 08:09:17,1409
231,1129,2230,3590,"65 days, 21:40:25",2013-02-06 00:22:24,2010-02-01 10:32:08,2010-04-08 08:12:33,1010
1252,99,546,1897,"65 days, 21:45:19",2013-02-06 02:22:47,2010-02-01 10:32:08,2010-04-08 08:17:27,8417
1230,1037,842,3109,"65 days, 22:05:02",2013-02-04 01:12:12,2010-02-01 10:32:08,2010-04-08 08:37:10,6822
107,2772,3465,6344,"65 days, 22:22:04",2013-02-06 08:56:15,2010-02-01 10:32:08,2010-04-08 08:54:12,5225
52,646,1329,2027,"65 days, 22:38:39",2013-02-07 01:47:49,2010-02-01 10:32:08,2010-04-08 09:10:47,1287
222,8,116,346,"65 days, 22:39:34",2013-01-22 03:56:33,2010-02-01 10:32:08,2010-04-08 09:11:42,1061
473,1267,1962,3702,"65 days, 22:41:45",2013-02-04 09:39:51,2010-02-01 10:32:08,2010-04-08 09:13:53,9405
285,1930,2060,4275,"65 days, 22:50:30",2013-02-05 07:54:11,2010-02-01 10:32:08,2010-04-08 09:22:38,435
214,67,166,447,"65 days, 23:28:23",2013-01-29 05:27:23,2010-02-01 10:32:08,2010-04-08 10:00:31,7861
698,1918,1874,4490,"65 days, 23:32:48",2013-02-07 07:07:57,2010-02-01 10:32:08,2010-04-08 10:04:56,5231
993,1597,2829,5419,"65 days, 23:40:18",2013-02-07 06:40:04,2010-02-01 10:32:08,2010-04-08 10:12:26,2051
518,1197,1525,3240,"65 days, 23:59:05",2013-02-05 07:42:27,2010-02-01 10:32:08,2010-04-08 10:31:13,1840
74,1662,2218,3954,"66 days, 0:00:20",2013-02-06 04:56:42,2010-02-01 10:32:08,2010-04-08 10:32:28,7721
924,1404,1804,4132,"66 days, 0:14:21",2013-02-06 09:10:39,2010-02-01 10:32:08,2010-04-08 10:46:29,673
485,183,679,1347,"66 days, 0:20:36",2013-02-06 08:27:45,2010-02-01 10:32:08,2010-04-08 10:52:44,1144
497,751,1281,2529,"66 days, 0:23:32",2013-02-04 06:01:22,2010-03-08 07:57:08,2010-05-13 08:20:40,8890
597,5,108,710,"66 days, 0:41:37",2013-02-01 11:28:29,2010-02-01 10:32:08,2010-04-08 11:13:45,57
7,614,858,1479,"66 days, 0:57:40",2013-02-06 08:13:45,2010-02-01 10:32:08,2010-04-08 11:29:48,3546
79,276,627,982,"66 days, 1:03:33",2013-02-06 09:17:42,2010-02-01 10:32:08,2010-04-08 11:35:41,7705
599,18,224,841,"66 days, 1:13:25",2013-02-07 01:41:39,2010-02-01 10:32:08,2010-04-08 11:45:33,4624
1708,1595,3347,6650,"66 days, 1:21:04",2013-02-15 06:14:07,2010-02-01 10:32:08,2010-04-08 11:53:12,2412
12,215,264,491,"66 days, 2:02:46",2013-02-03 10:54:02,2010-07-23 07:16:32,2010-09-27 09:19:18,4746
732,0,6,738,"66 days, 4:30:19",2013-01-29 10:41:40,2010-10-12 02:02:08,2010-12-17 06:32:27,3442
885,1028,1110,3023,"66 days, 6:26:43",2013-02-05 00:01:06,2010-03-03 01:33:14,2010-05-08 07:59:57,1768
1193,3377,5181,9751,"66 days, 13:36:45",2013-02-05 04:51:39,2010-02-01 10:32:08,2010-04-09 00:08:53,7877
463,1328,2217,4008,"66 days, 14:49:10",2013-02-05 04:55:29,2010-02-01 10:32:08,2010-04-09 01:21:18,9451
82,948,1832,2862,"66 days, 15:09:11",2013-02-07 01:29:03,2010-02-01 10:32:08,2010-04-09 01:41:19,5880
584,292,303,1179,"66 days, 15:23:53",2013-02-03 11:25:11,2010-02-01 10:32:08,2010-04-09 01:56:01,3013
696,705,991,2392,"66 days, 15:35:21",2013-02-08 09:42:03,2010-02-01 10:32:08,2010-04-09 02:07:29,4558
1190,645,1661,3496,"66 days, 16:18:55",2013-02-06 00:18:53,2010-02-01 10:32:08,2010-04-09 02:51:03,3602
218,148,231,597,"66 days, 16:25:53",2013-01-31 11:07:06,2010-02-01 10:32:08,2010-04-09 02:58:01,5030
1104,2704,2306,6114,"66 days, 16:43:13",2013-02-07 01:01:41,2010-02-01 10:32:08,2010-04-09 03:15:21,7214
815,159,216,1190,"66 days, 16:50:01",2013-01-30 11:14:21,2010-02-01 10:32:08,2010-04-09 03:22:09,6075
785,3764,3772,8321,"66 days, 18:11:58",2013-02-05 06:28:32,2010-02-01 10:32:08,2010-04-09 04:44:06,7604
271,161,208,640,"66 days, 18:21:22",2013-02-06 03:31:28,2010-02-01 10:32:08,2010-04-09 04:53:30,8569
1372,5474,6827,13673,"66 days, 18:35:01",2013-02-07 01:04:43,2010-02-01 10:32:08,2010-04-09 05:07:09,3321
140,415,1179,1734,"66 days, 18:38:12",2013-02-06 07:13:17,2010-02-01 10:32:08,2010-04-09 05:10:20,686
401,247,430,1078,"66 days, 18:39:01",2013-02-03 08:43:26,2010-02-01 10:32:08,2010-04-09 05:11:09,8030
997,113,208,1318,"66 days, 18:42:33",2013-01-28 07:10:05,2010-02-01 10:32:08,2010-04-09 05:14:41,5701
602,473,707,1782,"66 days, 19:05:46",2013-02-02 07:14:17,2010-02-01 10:32:08,2010-04-09 05:37:54,9963
242,780,1359,2381,"66 days, 19:17:35",2013-02-07 06:48:53,2010-02-01 10:32:08,2010-04-09 05:49:43,2685
416,531,966,1913,"66 days, 19:37:16",2013-02-04 06:00:35,2010-02-01 10:32:08,2010-04-09 06:09:24,4092
503,17,97,617,"66 days, 19:55:26",2013-02-05 05:35:30,2010-06-17 04:18:08,2010-08-23 00:13:34,9147
58,765,839,1662,"66 days, 20:04:57",2013-02-06 04:41:47,2010-02-01 10:32:08,2010-04-09 06:37:05,9694
547,3012,4911,8470,"66 days, 20:29:24",2013-02-06 06:33:36,2010-02-01 10:32:08,2010-04-09 07:01:32,7664
660,293,718,1671,"66 days, 20:51:00",2013-01-31 11:51:59,2010-02-01 10:32:08,2010-04-09 07:23:08,3148
64,480,753,1297,"66 days, 20:59:03",2013-02-03 11:59:11,2010-02-01 10:32:08,2010-04-09 07:31:11,9658
105,631,1419,2155,"66 days, 21:07:29",2013-02-05 04:36:59,2010-02-01 10:32:08,2010-04-09 07:39:37,4872
68,71,218,357,"66 days, 21:14:04",2013-02-06 10:07:19,2010-02-01 10:32:08,2010-04-09 07:46:12,928
453,3033,4389,7875,"66 days, 21:14:11",2013-02-06 09:34:14,2010-02-01 10:32:08,2010-04-09 07:46:19,3237
1284,127,188,1599,"66 days, 21:57:29",2013-02-06 01:59:58,2010-02-01 10:32:08,2010-04-09 08:29:37,9319
84,22,286,392,"66 days, 22:52:27",2013-02-06 10:35:51,2010-02-01 10:32:08,2010-04-09 09:24:35,4012
35,194,349,578,"66 days, 22:53:29",2013-02-02 07:01:28,2010-02-01 10:32:08,2010-04-09 09:25:37,8093
1308,687,1428,3423,"66 days, 23:09:31",2013-02-07 03:49:54,2010-02-01 10:32:08,2010-04-09 09:41:39,8974
151,1029,1487,2667,"66 days, 23:20:21",2013-02-07 06:43:44,2010-02-01 10:32:08,2010-04-09 09:52:29,9363
499,4418,4761,9678,"67 days, 0:04:15",2013-02-07 10:57:55,2010-02-01 10:32:08,2010-04-09 10:36:23,653
336,1,83,420,"67 days, 0:25:27",2013-02-02 08:49:45,2011-01-30 09:07:48,2011-04-07 09:33:15,1513
873,593,1533,2999,"67 days, 0:34:06",2013-02-07 07:11:52,2010-02-01 10:32:08,2010-04-09 11:06:14,53
175,436,636,1247,"67 days, 0:37:12",2013-02-05 03:45:46,2010-02-01 10:32:08,2010-04-09 11:09:20,3756
61,3989,5844,9894,"67 days, 0:45:38",2013-02-07 11:58:01,2010-02-01 10:32:08,2010-04-09 11:17:46,9507
53,680,2068,2801,"67 days, 0:50:11",2013-02-07 04:39:05,2010-02-01 10:32:08,2010-04-09 11:22:19,8343
341,437,527,1305,"67 days, 0:53:31",2013-02-06 11:47:32,2010-02-01 10:32:08,2010-04-09 11:25:39,8869
1202,416,612,2230,"67 days, 0:53:46",2013-02-06 05:48:34,2010-02-01 10:32:08,2010-04-09 11:25:54,3192
191,367,708,1266,"67 days, 1:02:23",2013-02-06 03:02:09,2010-02-01 10:32:08,2010-04-09 11:34:31,9685
307,203,344,854,"67 days, 1:17:47",2013-02-07 02:23:59,2010-02-01 10:32:08,2010-04-09 11:49:55,8719
283,31,178,492,"67 days, 3:41:17",2013-02-03 02:30:59,2010-03-31 07:43:16,2010-06-06 11:24:33,4016
598,239,345,1182,"67 days, 4:13:36",2013-02-05 01:43:06,2010-06-05 01:55:18,2010-08-11 06:08:54,3927
201,100,391,692,"67 days, 5:30:17",2013-02-06 05:33:11,2010-05-16 04:25:07,2010-07-22 09:55:24,3471
16,31,248,295,"67 days, 13:30:39",2013-02-06 07:20:59,2010-02-01 10:32:08,2010-04-10 00:02:47,5714
821,2497,2274,5592,"67 days, 13:36:28",2013-02-06 09:50:10,2010-02-01 10:32:08,2010-04-10 00:08:36,3068
209,414,481,1104,"67 days, 14:05:37",2013-02-05 11:20:11,2010-02-01 10:32:08,2010-04-10 00:37:45,2678
46,393,563,1002,"67 days, 14:31:27",2013-02-07 01:38:32,2010-02-01 10:32:08,2010-04-10 01:03:35,9980
1192,0,9,1201,"67 days, 15:01:55",2013-02-04 11:27:48,2010-02-01 10:32:08,2010-04-10 01:34:03,7317
837,1522,1497,3856,"67 days, 15:18:54",2013-02-05 05:18:02,2010-02-01 10:32:08,2010-04-10 01:51:02,414
394,2995,3252,6641,"67 days, 15:43:10",2013-02-04 08:34:40,2010-02-01 10:32:08,2010-04-10 02:15:18,1903
59,3781,5058,8898,"67 days, 15:54:53",2013-02-07 01:20:17,2010-02-01 10:32:08,2010-04-10 02:27:01,4200
527,1789,1611,3927,"67 days, 15:58:00",2013-02-05 02:30:01,2010-02-01 10:32:08,2010-04-10 02:30:08,383
382,295,452,1129,"67 days, 16:18:50",2013-02-06 09:55:57,2010-02-01 10:32:08,2010-04-10 02:50:58,8893
738,1411,2194,4343,"67 days, 16:22:12",2013-02-06 09:22:25,2010-02-01 10:32:08,2010-04-10 02:54:20,7152
199,8469,6183,14851,"67 days, 16:25:12",2013-02-07 07:44:07,2010-02-01 10:32:08,2010-04-10 02:57:20,3380
139,11,77,227,"67 days, 16:40:18",2013-01-11 10:06:00,2011-09-16 07:47:42,2011-11-23 00:28:00,5123
1076,0,0,1076,"67 days, 16:58:00",2013-01-28 06:15:58,2011-09-05 11:48:00,2011-11-12 04:46:00,2433
24,348,736,1108,"67 days, 17:11:22",2013-02-06 11:08:04,2010-02-01 10:32:08,2010-04-10 03:43:30,5567
39,145,249,433,"67 days, 18:01:34",2013-02-04 05:20:01,2010-02-01 10:32:08,2010-04-10 04:33:42,7934
382,2556,3537,6475,"67 days, 18:08:29",2013-02-06 05:31:32,2010-02-01 10:32:08,2010-04-10 04:40:37,1011
247,82,46,375,"67 days, 18:14:09",2013-01-24 08:34:08,2010-02-01 10:32:08,2010-04-10 04:46:17,3866
596,405,765,1766,"67 days, 18:55:55",2013-02-04 07:41:57,2010-02-01 10:32:08,2010-04-10 05:28:03,531
1,738,428,1167,"67 days, 19:01:03",2013-02-05 03:00:09,2010-02-01 10:32:08,2010-04-10 05:33:11,3298
54,878,1479,2411,"67 days, 19:48:08",2013-02-06 07:31:16,2010-02-01 10:32:08,2010-04-10 06:20:16,5354
1012,2,15,1029,"67 days, 19:56:11",2013-01-29 07:17:41,2010-02-01 10:32:08,2010-04-10 06:28:19,7570
2082,1725,2383,6190,"67 days, 20:02:26",2013-02-05 05:49:58,2010-02-01 10:32:08,2010-04-10 06:34:34,5414
397,622,1410,2429,"67 days, 20:16:15",2013-02-04 00:15:57,2010-02-01 10:32:08,2010-04-10 06:48:23,5586
49,1817,3237,5103,"67 days, 20:30:42",2013-02-07 04:54:13,2010-02-01 10:32:08,2010-04-10 07:02:50,7595
4,4,71,79,"67 days, 21:22:58",2013-01-31 05:21:26,2010-07-31 09:48:02,2010-10-07 07:11:00,1987
592,100,273,965,"67 days, 21:45:03",2013-02-06 11:13:20,2010-02-01 10:32:08,2010-04-10 08:17:11,2945
341,7,45,393,"67 days, 22:06:56",2013-01-29 07:18:22,2010-02-01 10:32:08,2010-04-10 08:39:04,4943
29,2577,3124,5730,"67 days, 22:07:23",2013-02-07 01:17:49,2010-02-01 10:32:08,2010-04-10 08:39:31,5057
760,300,396,1456,"67 days, 22:25:01",2013-01-31 05:41:15,2010-02-01 10:32:08,2010-04-10 08:57:09,9730
132,598,555,1285,"67 days, 22:34:49",2013-02-05 05:46:59,2010-02-01 10:32:08,2010-04-10 09:06:57,179
292,2,35,329,"67 days, 23:26:14",2013-01-07 06:02:50,2011-07-28 09:22:08,2011-10-04 08:48:22,6400
473,59,237,769,"67 days, 23:37:37",2013-01-31 00:02:51,2010-02-01 10:32:08,2010-04-10 10:09:45,7782
1246,1851,2283,5380,"67 days, 23:48:03",2013-02-06 05:51:25,2010-02-01 10:32:08,2010-04-10 10:20:11,3406
464,454,1057,1975,"68 days, 0:31:59",2013-02-07 07:46:42,2010-02-01 10:32:08,2010-04-10 11:04:07,7548
588,186,535,1309,"68 days, 1:04:57",2013-02-06 05:51:01,2010-02-01 10:32:08,2010-04-10 11:37:05,1121
42,50,236,328,"68 days, 3:54:07",2013-02-03 07:57:46,2010-06-25 01:26:06,2010-09-01 05:20:13,6309
73,179,271,523,"68 days, 13:57:03",2013-01-29 10:59:01,2010-02-01 10:32:08,2010-04-11 00:29:11,8063
374,143,276,793,"68 days, 13:59:47",2013-02-06 06:55:28,2010-02-01 10:32:08,2010-04-11 00:31:55,8861
775,1608,1293,3676,"68 days, 15:14:43",2013-02-06 07:41:48,2010-02-01 10:32:08,2010-04-11 01:46:51,129
1151,1142,1600,3893,"68 days, 16:09:06",2013-02-06 06:50:57,2010-02-01 10:32:08,2010-04-11 02:41:14,1788
615,139,321,1075,"68 days, 16:47:30",2013-02-02 06:03:38,2010-02-01 10:32:08,2010-04-11 03:19:38,9204
446,211,594,1251,"68 days, 17:15:29",2013-02-06 11:53:12,2010-02-01 10:32:08,2010-04-11 03:47:37,8557
881,4362,5075,10318,"68 days, 17:21:54",2013-02-06 09:54:03,2010-02-01 10:32:08,2010-04-11 03:54:02,6682
96,2336,2082,4514,"68 days, 18:09:48",2013-02-06 08:06:40,2010-02-01 10:32:08,2010-04-11 04:41:56,6490
26,10,135,171,"68 days, 19:20:39",2013-02-03 01:46:27,2010-02-01 10:32:08,2010-04-11 05:52:47,5932
745,1468,1058,3271,"68 days, 19:29:52",2013-02-06 05:31:34,2010-02-01 10:32:08,2010-04-11 06:02:00,840
721,169,522,1412,"68 days, 20:12:33",2013-02-06 10:56:26,2010-02-01 10:32:08,2010-04-11 06:44:41,6069
72,151,388,611,"68 days, 20:40:34",2013-01-28 11:34:30,2010-02-01 10:32:08,2010-04-11 07:12:42,7652
1669,413,686,2768,"68 days, 20:49:02",2013-02-06 11:27:53,2010-02-01 10:32:08,2010-04-11 07:21:10,2892
777,653,1395,2825,"68 days, 21:09:51",2013-02-06 10:17:11,2010-02-01 10:32:08,2010-04-11 07:41:59,7472
1471,479,378,2328,"68 days, 21:52:01",2013-02-06 05:55:45,2010-02-01 10:32:08,2010-04-11 08:24:09,7959
922,2,6,930,"68 days, 21:56:52",2013-02-01 05:49:32,2011-07-20 04:43:38,2011-09-27 02:40:30,2724
1154,165,520,1839,"68 days, 22:37:19",2013-02-02 04:09:34,2010-02-01 10:32:08,2010-04-11 09:09:27,7086
448,1170,1267,2885,"68 days, 22:55:48",2013-02-06 03:51:21,2010-02-01 10:32:08,2010-04-11 09:27:56,7808
354,1080,1451,2885,"68 days, 23:05:06",2013-02-05 00:17:50,2010-02-01 10:32:08,2010-04-11 09:37:14,3268
655,5,18,678,"68 days, 23:27:44",2013-02-04 02:55:30,2010-02-01 10:32:08,2010-04-11 09:59:52,3426
745,396,628,1769,"68 days, 23:40:07",2013-02-06 04:43:07,2010-02-08 03:20:01,2010-04-18 03:00:08,3824
68,1644,2351,4063,"69 days, 0:19:52",2013-02-07 02:49:52,2010-02-01 10:32:08,2010-04-11 10:52:00,6891
595,6341,8476,15412,"69 days, 0:54:07",2013-02-08 05:58:30,2010-02-01 10:32:08,2010-04-11 11:26:15,2239
25,354,1034,1413,"69 days, 1:09:37",2013-02-06 01:24:01,2010-02-01 10:32:08,2010-04-11 11:41:45,6215
556,259,649,1464,"69 days, 13:33:19",2013-02-02 03:12:23,2010-02-01 10:32:08,2010-04-12 00:05:27,7854
297,884,949,2130,"69 days, 13:47:11",2013-02-03 06:25:41,2010-02-01 10:32:08,2010-04-12 00:19:19,3530
694,245,552,1491,"69 days, 14:00:33",2013-02-06 06:37:17,2010-02-01 10:32:08,2010-04-12 00:32:41,606
414,212,344,970,"69 days, 15:04:06",2013-01-27 10:03:54,2010-02-01 10:32:08,2010-04-12 01:36:14,8291
1308,327,450,2085,"69 days, 15:30:49",2013-02-03 11:42:56,2010-02-01 10:32:08,2010-04-12 02:02:57,7039
2055,4031,4488,10574,"69 days, 15:36:18",2013-02-08 03:00:59,2010-02-01 10:32:08,2010-04-12 02:08:26,4949
1010,842,1191,3043,"69 days, 15:40:24",2013-02-05 01:11:10,2010-02-01 10:32:08,2010-04-12 02:12:32,2485
754,489,794,2037,"69 days, 15:40:37",2013-02-05 00:35:23,2010-02-01 10:32:08,2010-04-12 02:12:45,8475
9,1227,1723,2959,"69 days, 16:32:56",2013-02-06 11:34:25,2010-02-01 10:32:08,2010-04-12 03:05:04,6460
704,218,188,1110,"69 days, 17:04:30",2013-02-06 00:56:24,2010-02-01 10:32:08,2010-04-12 03:36:38,7590
709,782,1154,2645,"69 days, 17:05:29",2013-02-11 11:54:44,2010-02-01 10:32:08,2010-04-12 03:37:37,8843
214,2541,3230,5985,"69 days, 17:29:48",2013-02-06 10:32:39,2010-02-01 10:32:08,2010-04-12 04:01:56,7916
446,2293,1915,4654,"69 days, 17:58:24",2013-02-05 04:18:32,2010-02-01 10:32:08,2010-04-12 04:30:32,7596
27,413,481,921,"69 days, 18:05:38",2013-02-05 01:31:31,2010-02-01 10:32:08,2010-04-12 04:37:46,9268
800,538,898,2236,"69 days, 18:08:03",2013-02-06 07:39:32,2010-02-01 10:32:08,2010-04-12 04:40:11,5265
226,1129,1400,2755,"69 days, 19:03:53",2013-02-06 05:40:22,2010-02-01 10:32:08,2010-04-12 05:36:01,8838
876,609,771,2256,"69 days, 19:52:15",2013-02-02 08:55:54,2010-02-01 10:32:08,2010-04-12 06:24:23,7859
700,200,449,1349,"69 days, 20:06:10",2013-02-01 09:55:52,2010-02-01 10:32:08,2010-04-12 06:38:18,1193
161,1134,1652,2947,"69 days, 20:37:27",2013-02-06 04:54:50,2010-02-01 10:32:08,2010-04-12 07:09:35,2348
623,463,364,1450,"69 days, 21:37:57",2013-02-02 03:06:26,2010-02-01 10:32:08,2010-04-12 08:10:05,9864
329,874,1567,2770,"69 days, 21:39:00",2013-02-07 02:52:25,2010-02-01 10:32:08,2010-04-12 08:11:08,817
58,2375,3032,5465,"69 days, 22:11:27",2013-02-05 07:57:54,2010-02-01 10:32:08,2010-04-12 08:43:35,650
708,1155,1994,3857,"69 days, 22:21:40",2013-02-06 07:51:12,2010-02-01 10:32:08,2010-04-12 08:53:48,9975
787,838,1306,2931,"69 days, 22:33:34",2013-02-04 04:36:41,2010-02-01 10:32:08,2010-04-12 09:05:42,4867
143,325,482,950,"69 days, 22:36:12",2013-02-05 06:52:00,2010-02-01 10:32:08,2010-04-12 09:08:20,8584
694,84,264,1042,"69 days, 22:56:12",2013-02-07 08:17:18,2010-02-01 10:32:08,2010-04-12 09:28:20,8096
171,533,1139,1843,"69 days, 23:31:39",2013-02-05 09:25:25,2010-02-01 10:32:08,2010-04-12 10:03:47,6545
13,231,516,760,"70 days, 0:14:20",2013-02-06 05:40:13,2010-02-01 10:32:08,2010-04-12 10:46:28,6532
153,5115,5104,10372,"70 days, 0:20:31",2013-02-07 03:44:01,2010-02-01 10:32:08,2010-04-12 10:52:39,8985
701,222,498,1421,"70 days, 0:58:15",2013-02-04 04:08:40,2010-02-01 10:32:08,2010-04-12 11:30:23,9850
699,13,89,801,"70 days, 1:40:35",2013-02-01 10:44:23,2010-10-03 08:52:28,2010-12-12 10:33:03,5284
514,396,609,1519,"70 days, 5:18:31",2013-02-02 09:03:34,2010-06-22 05:20:12,2010-08-31 10:38:43,885
137,502,636,1275,"70 days, 14:02:56",2013-02-06 06:00:34,2010-02-01 10:32:08,2010-04-13 00:35:04,7876
9,28,255,292,"70 days, 14:33:30",2013-01-29 10:58:32,2010-02-01 10:32:08,2010-04-13 01:05:38,1825
1225,4784,5549,11558,"70 days, 14:34:09",2013-02-07 00:36:05,2010-02-01 10:32:08,2010-04-13 01:06:17,8319
661,341,689,1691,"70 days, 14:45:52",2013-02-03 10:16:25,2010-02-01 10:32:08,2010-04-13 01:18:00,6265
9,5,97,111,"70 days, 15:12:50",2013-01-27 03:34:33,2010-02-01 10:32:08,2010-04-13 01:44:58,8443
785,266,345,1396,"70 days, 15:16:45",2013-02-03 00:12:19,2010-02-01 10:32:08,2010-04-13 01:48:53,9345
50,3816,3587,7453,"70 days, 16:30:30",2013-02-07 03:44:16,2010-02-01 10:32:08,2010-04-13 03:02:38,3044
641,78,218,937,"70 days, 17:10:47",2013-02-03 11:39:47,2010-02-01 10:32:08,2010-04-13 03:42:55,6247
641,38,147,826,"70 days, 17:37:42",2013-02-05 04:45:41,2010-02-01 10:32:08,2010-04-13 04:09:50,5851
295,117,330,742,"70 days, 18:21:03",2013-02-05 04:11:31,2010-02-01 10:32:08,2010-04-13 04:53:11,1164
1445,301,516,2262,"70 days, 19:20:16",2013-02-04 01:26:34,2010-02-01 10:32:08,2010-04-13 05:52:24,8103
276,295,566,1137,"70 days, 19:23:18",2013-02-06 01:01:58,2010-02-01 10:32:08,2010-04-13 05:55:26,7158
1181,240,637,2058,"70 days, 20:26:01",2013-02-06 08:13:34,2010-02-01 10:32:08,2010-04-13 06:58:09,1524
52,3811,4127,7990,"70 days, 20:51:01",2013-02-06 06:55:53,2010-02-01 10:32:08,2010-04-13 07:23:09,5043
64,111,164,339,"70 days, 21:45:24",2013-02-04 11:29:32,2010-02-01 10:32:08,2010-04-13 08:17:32,5052
553,25,379,957,"70 days, 22:06:01",2013-02-04 09:47:53,2010-02-01 10:32:08,2010-04-13 08:38:09,4712
1062,0,65,1127,"70 days, 22:21:20",2013-01-27 06:48:56,2010-02-01 10:32:08,2010-04-13 08:53:28,852
79,1261,2441,3781,"70 days, 22:48:15",2013-02-05 03:43:53,2010-02-01 10:32:08,2010-04-13 09:20:23,2322
14,1109,1322,2445,"70 days, 22:51:39",2013-02-04 07:54:49,2010-02-01 10:32:08,2010-04-13 09:23:47,2701
535,1753,2385,4673,"70 days, 23:01:18",2013-02-06 09:06:36,2010-02-01 10:32:08,2010-04-13 09:33:26,6710
394,488,796,1678,"71 days, 0:12:28",2013-02-06 10:04:43,2010-02-01 10:32:08,2010-04-13 10:44:36,5669
2522,6178,5226,13926,"71 days, 0:29:18",2013-02-07 08:21:02,2010-02-01 10:32:08,2010-04-13 11:01:26,372
52,239,460,751,"71 days, 0:59:39",2013-02-06 09:34:53,2010-02-01 10:32:08,2010-04-13 11:31:47,1809
530,1411,1863,3804,"71 days, 1:17:42",2013-02-07 07:44:33,2010-02-01 10:32:08,2010-04-13 11:49:50,7314
286,1163,876,2325,"71 days, 2:18:15",2013-02-03 10:52:08,2010-07-13 04:56:32,2010-09-22 07:14:47,3747
199,6,71,276,"71 days, 3:59:43",2013-01-21 03:32:30,2010-11-30 05:24:33,2011-02-09 09:24:16,621
926,3,10,939,"71 days, 4:52:56",2013-01-20 04:26:21,2010-05-13 05:44:10,2010-07-23 10:37:06,7533
344,537,1077,1958,"71 days, 14:11:48",2013-02-05 09:14:23,2010-02-01 10:32:08,2010-04-14 00:43:56,2352
71,117,353,541,"71 days, 14:22:51",2013-02-04 08:27:16,2010-02-01 10:32:08,2010-04-14 00:54:59,9099
90,236,393,719,"71 days, 14:40:15",2013-02-07 08:22:38,2010-02-01 10:32:08,2010-04-14 01:12:23,7523
1360,2315,3378,7053,"71 days, 14:45:36",2013-02-09 08:52:06,2010-02-01 10:32:08,2010-04-14 01:17:44,2688
1856,1296,1691,4843,"71 days, 14:51:53",2013-02-07 00:24:23,2010-02-01 10:32:08,2010-04-14 01:24:01,1204
180,5721,5316,11217,"71 days, 15:09:17",2013-02-06 07:01:25,2010-02-01 10:32:08,2010-04-14 01:41:25,1596
291,4020,4278,8589,"71 days, 15:45:04",2013-02-06 02:51:01,2010-02-01 10:32:08,2010-04-14 02:17:12,6783
87,1078,795,1960,"71 days, 15:47:01",2013-02-05 06:06:52,2010-02-01 10:32:08,2010-04-14 02:19:09,7793
636,968,1612,3216,"71 days, 16:21:29",2013-02-05 09:10:48,2010-02-01 10:32:08,2010-04-14 02:53:37,3024
72,641,755,1468,"71 days, 16:30:00",2013-02-05 09:51:19,2010-02-01 10:32:08,2010-04-14 03:02:08,6009
597,276,550,1423,"71 days, 16:42:36",2013-02-05 07:36:50,2010-02-01 10:32:08,2010-04-14 03:14:44,239
93,44,243,380,"71 days, 16:46:48",2013-02-03 11:53:32,2010-02-01 10:32:08,2010-04-14 03:18:56,2286
851,16,129,996,"71 days, 17:01:17",2013-02-02 01:28:48,2010-02-01 10:32:08,2010-04-14 03:33:25,2784
625,135,312,1072,"71 days, 17:08:34",2013-02-04 00:43:16,2010-02-01 10:32:08,2010-04-14 03:40:42,490
337,187,466,990,"71 days, 17:33:04",2013-01-30 07:25:27,2010-02-01 10:32:08,2010-04-14 04:05:12,4679
94,902,1117,2113,"71 days, 18:15:28",2013-02-06 06:49:48,2010-02-01 10:32:08,2010-04-14 04:47:36,8303
343,142,286,771,"71 days, 18:42:18",2013-02-08 00:47:25,2010-02-01 10:32:08,2010-04-14 05:14:26,948
799,2112,4515,7426,"71 days, 19:00:51",2013-02-06 07:28:56,2010-02-01 10:32:08,2010-04-14 05:32:59,9374
419,220,871,1510,"71 days, 19:14:26",2013-02-04 05:56:28,2010-02-01 10:32:08,2010-04-14 05:46:34,7510
104,20,111,235,"71 days, 19:22:57",2013-02-03 07:53:43,2010-09-10 06:27:11,2010-11-21 01:50:08,1125
1000,15,4,1019,"71 days, 19:28:40",2013-01-30 03:37:24,2010-12-17 09:09:31,2011-02-27 04:38:11,964
696,315,703,1714,"71 days, 19:46:52",2013-02-04 07:12:27,2010-02-01 10:32:08,2010-04-14 06:19:00,47
60,684,1281,2025,"71 days, 19:50:00",2013-02-03 08:28:02,2010-02-01 10:32:08,2010-04-14 06:22:08,741
181,4,65,250,"71 days, 19:53:04",2013-01-28 04:57:43,2011-12-03 06:33:21,2012-02-13 02:26:25,9821
1713,3460,3411,8584,"71 days, 20:55:29",2013-02-07 08:39:08,2010-02-01 10:32:08,2010-04-14 07:27:37,9398
114,1451,2060,3625,"71 days, 21:04:29",2013-02-06 08:57:07,2010-02-01 10:32:08,2010-04-14 07:36:37,4844
116,348,689,1153,"71 days, 21:13:45",2013-02-03 11:05:06,2010-02-01 10:32:08,2010-04-14 07:45:53,2108
2380,11484,6062,19926,"71 days, 21:26:45",2013-02-07 06:04:54,2010-02-01 10:32:08,2010-04-14 07:58:53,2259
331,753,1133,2217,"71 days, 21:44:07",2013-02-05 05:32:11,2010-02-01 10:32:08,2010-04-14 08:16:15,2809
94,303,817,1214,"71 days, 22:16:11",2013-02-03 10:51:38,2010-02-01 10:32:08,2010-04-14 08:48:19,2497
969,1886,2613,5468,"71 days, 23:01:04",2013-02-07 04:00:44,2010-02-01 10:32:08,2010-04-14 09:33:12,6422
582,1512,3609,5703,"71 days, 23:07:20",2013-02-04 08:04:09,2010-02-01 10:32:08,2010-04-14 09:39:28,6262
711,5,144,860,"71 days, 23:09:49",2013-01-31 08:34:15,2010-02-01 10:32:08,2010-04-14 09:41:57,7005
306,2492,3707,6505,"72 days, 0:23:51",2013-02-06 02:32:58,2010-02-01 10:32:08,2010-04-14 10:55:59,3327
12,7,80,99,"72 days, 0:36:43",2013-01-25 07:41:35,2010-07-19 07:52:19,2010-09-29 08:29:02,1085
2726,7741,6440,16907,"72 days, 0:41:32",2013-02-07 01:07:18,2010-02-01 10:32:08,2010-04-14 11:13:40,4485
1048,4596,3103,8747,"72 days, 0:45:51",2013-02-06 10:45:59,2010-02-01 10:32:08,2010-04-14 11:17:59,5157
379,96,223,698,"72 days, 0:53:56",2013-02-06 01:43:29,2010-02-01 10:32:08,2010-04-14 11:26:04,4041
1364,195,507,2066,"72 days, 5:54:58",2013-02-04 10:13:11,2010-04-21 01:20:51,2010-07-02 07:15:49,5731
744,10,74,828,"72 days, 9:23:35",2013-01-30 04:06:34,2010-06-27 02:03:32,2010-09-07 11:27:07,6572
2,255,420,677,"72 days, 13:33:09",2013-02-03 11:57:02,2010-02-01 10:32:08,2010-04-15 00:05:17,2552
606,623,651,1880,"72 days, 13:34:44",2013-02-02 06:18:40,2010-02-01 10:32:08,2010-04-15 00:06:52,4628
88,1012,1698,2798,"72 days, 13:50:51",2013-02-06 07:12:20,2010-02-01 10:32:08,2010-04-15 00:22:59,8735
33,273,388,694,"72 days, 14:27:54",2013-02-03 08:19:13,2010-02-01 10:32:08,2010-04-15 01:00:02,5064
418,201,203,822,"72 days, 14:41:52",2013-02-01 11:39:07,2010-02-01 10:32:08,2010-04-15 01:14:00,5382
322,885,1230,2437,"72 days, 15:03:12",2013-02-06 08:19:42,2010-02-01 10:32:08,2010-04-15 01:35:20,6317
432,122,368,922,"72 days, 15:08:00",2013-01-31 04:06:03,2010-02-01 10:32:08,2010-04-15 01:40:08,1046
290,150,213,653,"72 days, 16:00:45",2013-01-31 11:18:12,2010-02-01 10:32:08,2010-04-15 02:32:53,4028
593,217,413,1223,"72 days, 16:02:58",2013-02-06 00:55:04,2010-02-01 10:32:08,2010-04-15 02:35:06,5433
654,621,650,1925,"72 days, 16:03:33",2013-02-03 09:26:15,2010-02-01 10:32:08,2010-04-15 02:35:41,8044
93,5457,5253,10803,"72 days, 16:04:16",2013-02-06 08:57:57,2010-02-01 10:32:08,2010-04-15 02:36:24,9140
991,4605,4616,10212,"72 days, 16:17:02",2013-02-06 02:37:16,2010-02-01 10:32:08,2010-04-15 02:49:10,6158
41,504,1102,1647,"72 days, 16:22:20",2013-02-06 07:52:16,2010-02-01 10:32:08,2010-04-15 02:54:28,5315
98,497,799,1394,"72 days, 16:36:36",2013-02-08 09:03:28,2010-02-01 10:32:08,2010-04-15 03:08:44,6688
936,2553,3816,7305,"72 days, 16:49:55",2013-02-06 04:07:55,2010-02-01 10:32:08,2010-04-15 03:22:03,7856
337,27,290,654,"72 days, 16:58:30",2013-02-02 03:36:53,2010-02-01 10:32:08,2010-04-15 03:30:38,2214
338,402,1041,1781,"72 days, 17:21:49",2013-02-02 07:19:58,2010-02-01 10:32:08,2010-04-15 03:53:57,9783
1014,465,1157,2636,"72 days, 17:56:14",2013-02-05 05:30:50,2010-02-01 10:32:08,2010-04-15 04:28:22,6518
287,384,1464,2135,"72 days, 17:59:32",2013-02-06 09:36:06,2010-02-01 10:32:08,2010-04-15 04:31:40,3562
820,188,489,1497,"72 days, 18:08:08",2013-02-04 03:03:19,2010-02-01 10:32:08,2010-04-15 04:40:16,5035
221,975,1343,2539,"72 days, 18:10:48",2013-02-06 04:29:48,2010-02-01 10:32:08,2010-04-15 04:42:56,475
42,743,904,1689,"72 days, 18:16:48",2013-02-07 05:22:14,2010-02-01 10:32:08,2010-04-15 04:48:56,6907
1148,1340,2008,4496,"72 days, 18:42:26",2013-02-04 11:14:08,2010-02-01 10:32:08,2010-04-15 05:14:34,7027
112,537,698,1347,"72 days, 18:52:32",2013-02-06 04:45:16,2010-02-01 10:32:08,2010-04-15 05:24:40,9134
86,1707,2125,3918,"72 days, 20:23:09",2013-02-07 09:22:11,2010-02-01 10:32:08,2010-04-15 06:55:17,2276
1852,518,1147,3517,"72 days, 20:28:34",2013-02-07 01:49:45,2010-02-01 10:32:08,2010-04-15 07:00:42,9488
351,242,291,884,"72 days, 21:10:23",2013-02-01 03:08:56,2010-02-01 10:32:08,2010-04-15 07:42:31,7968
1338,143,794,2275,"72 days, 21:13:23",2013-02-02 10:43:59,2010-02-01 10:32:08,2010-04-15 07:45:31,3328
1091,322,396,1809,"72 days, 21:54:30",2013-02-03 03:22:51,2010-02-01 10:32:08,2010-04-15 08:26:38,8481
72,1299,1737,3108,"72 days, 22:07:25",2013-02-06 05:44:57,2010-02-01 10:32:08,2010-04-15 08:39:33,1243
139,165,329,633,"72 days, 22:14:50",2013-02-04 02:36:24,2010-02-01 10:32:08,2010-04-15 08:46:58,7069
271,1,58,330,"72 days, 22:27:45",2013-02-06 04:48:38,2010-02-01 10:32:08,2010-04-15 08:59:53,9768
1203,1516,1869,4588,"72 days, 22:54:10",2013-02-07 04:26:55,2010-02-01 10:32:08,2010-04-15 09:26:18,7886
335,16,136,487,"72 days, 23:00:22",2013-02-01 08:34:06,2010-04-07 11:59:30,2010-06-19 10:59:52,7720
709,522,1216,2447,"72 days, 23:14:00",2013-02-22 05:23:31,2010-02-01 10:32:08,2010-04-15 09:46:08,4637
50,1139,2404,3593,"72 days, 23:31:00",2013-02-07 10:49:16,2010-02-01 10:32:08,2010-04-15 10:03:08,6049
8,329,515,852,"72 days, 23:52:42",2013-02-07 02:58:40,2010-02-01 10:32:08,2010-04-15 10:24:50,8626
1087,1262,1677,4026,"73 days, 0:05:44",2013-02-06 06:23:11,2010-02-01 10:32:08,2010-04-15 10:37:52,1173
591,2404,2702,5697,"73 days, 0:08:16",2013-02-07 09:06:11,2010-02-01 10:32:08,2010-04-15 10:40:24,5237
64,6715,6490,13269,"73 days, 0:30:42",2013-02-06 04:28:34,2010-02-01 10:32:08,2010-04-15 11:02:50,702
908,851,1009,2768,"73 days, 0:32:24",2013-02-06 08:15:16,2010-02-01 10:32:08,2010-04-15 11:04:32,2422
1765,1736,2740,6241,"73 days, 0:37:44",2013-02-05 11:11:00,2010-02-01 10:32:08,2010-04-15 11:09:52,7862
260,917,922,2099,"73 days, 1:27:51",2013-02-06 00:17:57,2010-02-01 10:32:08,2010-04-15 11:59:59,8860
218,15,60,293,"73 days, 2:25:04",2013-02-01 02:50:45,2010-08-16 02:19:22,2010-10-28 04:44:26,4162
1836,941,1481,4258,"73 days, 14:01:22",2013-02-05 10:32:13,2010-02-01 10:32:08,2010-04-16 00:33:30,3196
140,511,574,1225,"73 days, 14:31:43",2013-02-04 02:10:04,2010-02-01 10:32:08,2010-04-16 01:03:51,8160
1129,424,960,2513,"73 days, 15:03:16",2013-02-05 09:57:34,2010-02-01 10:32:08,2010-04-16 01:35:24,2510
174,405,437,1016,"73 days, 15:14:10",2013-02-02 11:32:00,2010-05-01 11:49:06,2010-07-14 03:03:16,123
761,1746,1866,4373,"73 days, 16:30:53",2013-02-06 01:33:25,2010-02-01 10:32:08,2010-04-16 03:03:01,3234
46,459,798,1303,"73 days, 17:01:25",2013-02-06 08:02:31,2010-02-01 10:32:08,2010-04-16 03:33:33,1950
2617,5132,3771,11520,"73 days, 17:37:06",2013-02-07 04:11:46,2010-02-01 10:32:08,2010-04-16 04:09:14,8372
820,3993,5272,10085,"73 days, 18:06:48",2013-02-06 06:12:05,2010-02-01 10:32:08,2010-04-16 04:38:56,8736
46,6,73,125,"73 days, 18:38:09",2013-02-04 11:40:15,2010-02-01 10:32:08,2010-04-16 05:10:17,2050
667,886,1122,2675,"73 days, 18:41:22",2013-02-14 09:53:20,2010-02-01 10:32:08,2010-04-16 05:13:30,7797
35,345,508,888,"73 days, 19:05:19",2013-02-04 08:20:58,2010-02-01 10:32:08,2010-04-16 05:37:27,1579
1263,305,548,2116,"73 days, 19:35:36",2013-02-07 08:22:16,2010-02-01 10:32:08,2010-04-16 06:07:44,2535
635,21,32,688,"73 days, 20:04:51",2013-01-30 08:07:50,2010-02-01 10:32:08,2010-04-16 06:36:59,3682
1667,782,1292,3741,"73 days, 20:14:12",2013-02-07 08:26:17,2010-02-01 10:32:08,2010-04-16 06:46:20,8115
1298,7953,6272,15523,"73 days, 20:15:16",2013-02-06 03:01:42,2010-02-01 10:32:08,2010-04-16 06:47:24,8098
734,2307,1988,5029,"73 days, 20:43:57",2013-02-04 06:25:38,2010-02-01 10:32:08,2010-04-16 07:16:05,2845
1396,1388,1670,4454,"73 days, 21:19:04",2013-02-06 01:36:06,2010-02-01 10:32:08,2010-04-16 07:51:12,4719
1484,900,1218,3602,"73 days, 21:36:46",2013-02-07 10:25:22,2010-02-01 10:32:08,2010-04-16 08:08:54,7549
277,324,542,1143,"73 days, 21:40:27",2013-02-06 08:35:33,2010-02-01 10:32:08,2010-04-16 08:12:35,8928
11,133,175,319,"73 days, 22:23:56",2013-02-01 01:19:16,2010-02-01 10:32:08,2010-04-16 08:56:04,8233
957,1205,1966,4128,"73 days, 23:01:13",2013-02-06 02:44:34,2010-02-01 10:32:08,2010-04-16 09:33:21,9943
39,904,1396,2339,"73 days, 23:06:44",2013-02-04 11:04:25,2010-02-01 10:32:08,2010-04-16 09:38:52,4730
103,162,360,625,"73 days, 23:18:37",2013-02-04 10:45:23,2010-02-01 10:32:08,2010-04-16 09:50:45,9231
153,666,896,1715,"73 days, 23:22:06",2013-02-06 07:22:21,2010-03-12 11:06:09,2010-05-25 10:28:15,5268
87,2721,2476,5284,"73 days, 23:27:45",2013-02-15 02:24:45,2010-02-01 10:32:08,2010-04-16 09:59:53,422
11,356,846,1213,"73 days, 23:35:32",2013-02-05 04:31:03,2010-02-01 10:32:08,2010-04-16 10:07:40,2852
399,2,74,475,"73 days, 23:41:10",2013-01-31 00:41:30,2010-11-23 07:45:32,2011-02-05 07:26:42,9306
627,988,1679,3294,"74 days, 0:16:19",2013-02-07 04:01:19,2010-02-01 10:32:08,2010-04-16 10:48:27,552
93,186,477,756,"74 days, 0:22:00",2013-02-06 01:51:06,2010-02-01 10:32:08,2010-04-16 10:54:08,7074
161,1057,1606,2824,"74 days, 0:41:32",2013-02-06 10:35:36,2010-02-01 10:32:08,2010-04-16 11:13:40,1225
71,310,626,1007,"74 days, 1:08:49",2013-02-06 08:57:14,2010-02-01 10:32:08,2010-04-16 11:40:57,3848
271,3,39,313,"74 days, 1:21:31",2012-12-21 10:04:05,2010-06-24 09:14:28,2010-09-06 10:35:59,6863
367,628,748,1743,"74 days, 8:19:02",2013-02-05 05:05:15,2010-04-20 00:55:16,2010-07-03 09:14:18,6889
125,525,895,1545,"74 days, 13:31:18",2013-02-06 06:23:42,2010-02-01 10:32:08,2010-04-17 00:03:26,6879
170,2064,2675,4909,"74 days, 13:37:30",2013-02-06 06:23:35,2010-02-01 10:32:08,2010-04-17 00:09:38,3572
1259,0,0,1259,"74 days, 13:41:20",2013-01-31 06:25:40,2010-02-01 10:32:08,2010-04-17 00:13:28,8919
664,0,0,664,"74 days, 14:22:21",2013-01-22 10:05:27,2012-08-07 10:59:20,2012-10-21 01:21:41,1292
152,803,1588,2543,"74 days, 15:16:22",2013-02-06 09:39:09,2010-02-01 10:32:08,2010-04-17 01:48:30,8025
569,251,768,1588,"74 days, 15:39:17",2013-02-07 09:09:12,2010-02-01 10:32:08,2010-04-17 02:11:25,7348
505,950,1384,2839,"74 days, 16:08:33",2013-02-06 10:05:31,2010-02-01 10:32:08,2010-04-17 02:40:41,2697
49,417,509,975,"74 days, 16:27:38",2013-02-02 01:34:56,2010-02-01 10:32:08,2010-04-17 02:59:46,1861
415,510,864,1789,"74 days, 16:34:47",2013-02-05 03:49:15,2010-02-01 10:32:08,2010-04-17 03:06:55,3315
141,2858,2947,5946,"74 days, 16:51:41",2013-02-05 09:03:35,2010-02-01 10:32:08,2010-04-17 03:23:49,6345
632,34,302,968,"74 days, 17:25:51",2013-01-31 07:50:55,2010-02-01 10:32:08,2010-04-17 03:57:59,2452
294,183,604,1081,"74 days, 17:49:46",2013-02-03 11:55:02,2010-02-01 10:32:08,2010-04-17 04:21:54,4505
55,4907,6300,11262,"74 days, 17:50:33",2013-02-07 02:27:44,2010-02-01 10:32:08,2010-04-17 04:22:41,5574
53,1024,1728,2805,"74 days, 18:32:01",2013-02-06 10:42:47,2010-02-01 10:32:08,2010-04-17 05:04:09,3099
390,0,0,390,"74 days, 18:32:51",2013-01-24 08:12:22,2010-12-11 10:57:27,2011-02-24 05:30:18,4470
45,298,527,870,"74 days, 18:41:32",2013-02-03 11:40:29,2010-02-01 10:32:08,2010-04-17 05:13:40,5473
555,813,1134,2502,"74 days, 19:21:29",2013-02-06 05:32:42,2010-02-01 10:32:08,2010-04-17 05:53:37,5706
213,461,1063,1737,"74 days, 19:24:47",2013-02-06 08:37:04,2010-02-01 10:32:08,2010-04-17 05:56:55,4404
121,964,1355,2440,"74 days, 19:49:52",2013-02-05 09:58:02,2010-02-01 10:32:08,2010-04-17 06:22:00,3774
203,185,346,734,"74 days, 19:50:32",2013-02-05 01:17:26,2010-02-01 10:32:08,2010-04-17 06:22:40,6792
18,139,293,450,"74 days, 19:57:50",2013-02-05 10:14:33,2010-02-01 10:32:08,2010-04-17 06:29:58,5759
897,20,186,1103,"74 days, 20:01:17",2013-01-30 08:13:49,2010-02-01 10:32:08,2010-04-17 06:33:25,7662
607,1993,4107,6707,"74 days, 20:41:48",2013-02-06 10:07:54,2010-02-01 10:32:08,2010-04-17 07:13:56,9070
102,398,753,1253,"74 days, 21:08:43",2013-02-06 10:14:12,2010-02-01 10:32:08,2010-04-17 07:40:51,3152
141,624,1151,1916,"74 days, 21:23:05",2013-02-05 08:28:56,2010-02-01 10:32:08,2010-04-17 07:55:13,4019
114,539,1023,1676,"74 days, 21:31:59",2013-02-05 06:37:53,2010-02-01 10:32:08,2010-04-17 08:04:07,5726
980,1077,2044,4101,"74 days, 21:55:49",2013-02-06 09:26:06,2010-02-01 10:32:08,2010-04-17 08:27:57,2754
207,612,733,1552,"74 days, 22:11:29",2013-02-07 07:51:22,2010-02-01 10:32:08,2010-04-17 08:43:37,4527
555,642,1053,2250,"74 days, 22:17:42",2013-02-07 05:45:04,2010-02-01 10:32:08,2010-04-17 08:49:50,78
42,1951,2146,4139,"74 days, 22:25:27",2013-02-07 10:19:02,2010-02-01 10:32:08,2010-04-17 08:57:35,1116
261,1036,2043,3340,"74 days, 22:29:51",2013-02-06 07:05:21,2010-02-01 10:32:08,2010-04-17 09:01:59,8101
1138,406,1021,2565,"74 days, 23:03:22",2013-02-04 07:18:30,2010-02-01 10:32:08,2010-04-17 09:35:30,4960
709,319,397,1425,"74 days, 23:14:10",2013-02-03 02:38:41,2010-02-01 10:32:08,2010-04-17 09:46:18,1305
518,1157,1796,3471,"74 days, 23:17:40",2013-02-05 01:07:09,2010-02-01 10:32:08,2010-04-17 09:49:48,4111
2588,5381,5171,13140,"74 days, 23:47:08",2013-02-06 11:25:38,2010-02-01 10:32:08,2010-04-17 10:19:16,9177
141,681,440,1262,"75 days, 1:26:37",2013-02-05 07:36:30,2010-02-01 10:32:08,2010-04-17 11:58:45,1905
308,231,581,1120,"75 days, 2:00:13",2013-02-03 02:18:02,2010-04-10 08:30:23,2010-06-24 10:30:36,2940
342,9,105,456,"75 days, 2:22:56",2013-02-01 01:31:18,2010-09-13 02:42:42,2010-11-27 05:05:38,2532
702,0,3,705,"75 days, 14:18:37",2013-01-16 07:24:19,2010-02-01 10:32:08,2010-04-18 00:50:45,2576
244,205,414,863,"75 days, 15:09:29",2013-02-05 10:42:30,2010-02-01 10:32:08,2010-04-18 01:41:37,9735
1052,3044,2782,6878,"75 days, 16:11:53",2013-02-07 00:55:21,2010-02-01 10:32:08,2010-04-18 02:44:01,698
612,883,1022,2517,"75 days, 16:13:04",2013-02-06 11:32:48,2010-02-01 10:32:08,2010-04-18 02:45:12,2058
437,173,372,982,"75 days, 16:44:57",2013-02-04 10:19:43,2010-02-01 10:32:08,2010-04-18 03:17:05,9077
1028,0,28,1056,"75 days, 18:32:14",2013-01-24 06:13:56,2010-02-01 10:32:08,2010-04-18 05:04:22,7829
1279,3,75,1357,"75 days, 18:40:40",2013-02-04 01:04:59,2010-02-01 10:32:08,2010-04-18 05:12:48,3862
120,412,726,1258,"75 days, 19:25:11",2013-02-03 07:47:12,2010-02-01 10:32:08,2010-04-18 05:57:19,8026
1276,431,930,2637,"75 days, 19:33:28",2013-02-07 00:53:54,2010-02-01 10:32:08,2010-04-18 06:05:36,564
1284,575,388,2247,"75 days, 19:55:35",2013-01-31 08:43:42,2010-02-01 10:32:08,2010-04-18 06:27:43,8159
307,1807,2064,4178,"75 days, 20:04:57",2013-02-04 04:49:15,2010-02-01 10:32:08,2010-04-18 06:37:05,3312
3,15,53,71,"75 days, 20:47:45",2012-12-27 01:19:15,2010-05-19 07:36:51,2010-08-03 04:24:36,2621
577,491,762,1830,"75 days, 21:13:20",2013-02-07 04:51:36,2010-02-01 10:32:08,2010-04-18 07:45:28,2324
41,38,229,308,"75 days, 21:13:37",2013-02-05 01:36:19,2010-02-01 10:32:08,2010-04-18 07:45:45,2064
324,184,485,993,"75 days, 21:46:30",2013-02-05 03:44:04,2010-06-06 07:24:41,2010-08-21 05:11:11,1108
652,484,714,1850,"75 days, 23:13:47",2013-02-04 09:49:47,2010-02-01 10:32:08,2010-04-18 09:45:55,1294
1,3,47,51,"75 days, 23:28:10",2013-01-11 02:35:33,2010-11-22 01:23:43,2011-02-06 00:51:53,5760
40,1559,1353,2952,"75 days, 23:31:04",2013-02-07 06:40:28,2010-02-01 10:32:08,2010-04-18 10:03:12,3894
725,2327,3439,6491,"75 days, 23:45:17",2013-02-15 06:21:17,2010-02-01 10:32:08,2010-04-18 10:17:25,9878
1270,1132,1766,4168,"75 days, 23:56:57",2013-02-07 06:21:55,2010-02-01 10:32:08,2010-04-18 10:29:05,9130
139,1674,1891,3704,"76 days, 0:31:13",2013-02-06 00:55:52,2010-02-01 10:32:08,2010-04-18 11:03:21,7900
76,3,117,196,"76 days, 0:37:18",2013-02-01 03:40:58,2010-10-02 00:41:42,2010-12-17 01:19:00,4361
181,190,321,692,"76 days, 1:21:39",2013-02-01 03:24:51,2010-02-01 10:32:08,2010-04-18 11:53:47,3423
332,774,1327,2433,"76 days, 13:55:34",2013-02-04 05:37:07,2010-02-01 10:32:08,2010-04-19 00:27:42,9214
238,292,799,1329,"76 days, 14:11:02",2013-02-06 09:22:26,2010-02-01 10:32:08,2010-04-19 00:43:10,82
274,1007,1371,2652,"76 days, 14:16:45",2013-02-05 05:57:00,2010-02-01 10:32:08,2010-04-19 00:48:53,6469
925,155,430,1510,"76 days, 14:38:04",2013-02-06 08:34:39,2010-02-01 10:32:08,2010-04-19 01:10:12,5748
221,1123,1206,2550,"76 days, 14:54:49",2013-02-05 07:17:20,2010-02-01 10:32:08,2010-04-19 01:26:57,1263
991,1034,1629,3654,"76 days, 15:19:59",2013-02-06 05:47:58,2010-02-01 10:32:08,2010-04-19 01:52:07,7879
650,457,1008,2115,"76 days, 15:31:53",2013-02-05 07:41:59,2010-02-01 10:32:08,2010-04-19 02:04:01,4599
19,310,1092,1421,"76 days, 15:45:45",2013-02-05 06:27:07,2010-02-01 10:32:08,2010-04-19 02:17:53,3252
215,954,1661,2830,"76 days, 15:55:29",2013-02-06 11:35:47,2010-02-01 10:32:08,2010-04-19 02:27:37,6410
34,359,796,1189,"76 days, 16:15:47",2013-02-06 04:09:40,2010-02-01 10:32:08,2010-04-19 02:47:55,8045
286,1813,3256,5355,"76 days, 16:17:48",2013-02-07 02:15:15,2010-02-01 10:32:08,2010-04-19 02:49:56,3393
954,146,419,1519,"76 days, 16:20:32",2013-02-06 00:15:35,2010-02-01 10:32:08,2010-04-19 02:52:40,4269
973,2763,3936,7672,"76 days, 16:36:07",2013-02-04 10:05:17,2010-02-01 10:32:08,2010-04-19 03:08:15,1446
331,95,917,1343,"76 days, 17:00:52",2013-02-05 05:17:09,2010-02-01 10:32:08,2010-04-19 03:33:00,376
14,697,1642,2353,"76 days, 17:00:57",2013-02-06 10:10:17,2010-02-01 10:32:08,2010-04-19 03:33:05,8738
397,671,747,1815,"76 days, 18:11:53",2013-02-07 02:42:22,2010-02-01 10:32:08,2010-04-19 04:44:01,4916
404,974,989,2367,"76 days, 19:03:36",2013-02-07 07:52:10,2010-02-01 10:32:08,2010-04-19 05:35:44,8218
835,1552,3106,5493,"76 days, 19:55:30",2013-02-06 03:24:09,2010-02-01 10:32:08,2010-04-19 06:27:38,8262
1071,468,962,2501,"76 days, 21:03:36",2013-02-04 09:51:17,2010-02-01 10:32:08,2010-04-19 07:35:44,3412
672,0,45,717,"76 days, 21:23:38",2013-02-07 00:44:37,2011-03-13 04:11:04,2011-05-29 01:34:42,1012
168,945,1171,2284,"76 days, 22:13:56",2013-02-07 10:02:05,2010-02-01 10:32:08,2010-04-19 08:46:04,7902
563,0,64,627,"76 days, 23:01:40",2013-01-23 11:53:05,2010-02-01 10:32:08,2010-04-19 09:33:48,5219
1484,293,590,2367,"76 days, 23:29:13",2013-02-06 09:45:04,2010-02-01 10:32:08,2010-04-19 10:01:21,9912
314,1,0,315,"76 days, 23:42:22",2013-01-29 01:39:17,2010-02-01 10:32:08,2010-04-19 10:14:30,9929
18,259,644,921,"77 days, 1:13:58",2013-02-07 07:54:40,2010-02-01 10:32:08,2010-04-19 11:46:06,2585
768,455,465,1688,"77 days, 14:03:34",2013-02-04 11:00:04,2010-02-01 10:32:08,2010-04-20 00:35:42,8344
914,0,44,958,"77 days, 14:14:27",2013-02-09 09:53:31,2010-02-01 10:32:08,2010-04-20 00:46:35,6248
52,480,1095,1627,"77 days, 14:22:20",2013-02-07 07:14:22,2010-02-01 10:32:08,2010-04-20 00:54:28,1014
19,1,36,56,"77 days, 14:48:36",2013-01-28 09:32:26,2011-04-08 09:59:45,2011-06-25 00:48:21,8815
329,395,772,1496,"77 days, 14:58:45",2013-02-04 07:10:41,2010-02-01 10:32:08,2010-04-20 01:30:53,2078
76,161,226,463,"77 days, 14:59:19",2013-02-06 03:56:05,2010-02-01 10:32:08,2010-04-20 01:31:27,684
99,315,221,635,"77 days, 15:01:21",2013-02-02 02:34:50,2010-02-01 10:32:08,2010-04-20 01:33:29,8152
149,777,1037,1963,"77 days, 15:39:55",2013-02-03 09:20:13,2010-02-01 10:32:08,2010-04-20 02:12:03,5208
45,727,1471,2243,"77 days, 15:47:51",2013-02-04 11:17:45,2010-02-01 10:32:08,2010-04-20 02:19:59,2756
330,285,611,1226,"77 days, 16:45:17",2013-02-03 00:10:20,2010-02-01 10:32:08,2010-04-20 03:17:25,1709
498,577,1007,2082,"77 days, 17:34:18",2013-02-05 01:18:28,2010-02-01 10:32:08,2010-04-20 04:06:26,9727
55,682,1131,1868,"77 days, 18:14:31",2013-02-06 00:53:12,2010-02-01 10:32:08,2010-04-20 04:46:39,1207
254,1154,1495,2903,"77 days, 18:16:25",2013-02-04 08:21:13,2010-02-01 10:32:08,2010-04-20 04:48:33,7670
443,970,1040,2453,"77 days, 18:41:33",2013-02-05 11:57:16,2010-02-01 10:32:08,2010-04-20 05:13:41,7501
325,185,359,869,"77 days, 18:47:12",2013-01-31 08:06:15,2010-02-01 10:32:08,2010-04-20 05:19:20,2309
331,104,493,928,"77 days, 19:12:25",2013-02-02 08:47:25,2010-02-01 10:32:08,2010-04-20 05:44:33,7547
1300,337,778,2415,"77 days, 20:01:11",2013-02-02 05:08:42,2010-02-01 10:32:08,2010-04-20 06:33:19,3446
843,649,1222,2714,"77 days, 20:06:13",2013-02-07 06:44:52,2010-02-01 10:32:08,2010-04-20 06:38:21,7153
404,33,213,650,"77 days, 20:59:19",2013-01-31 01:58:53,2010-02-01 10:32:08,2010-04-20 07:31:27,3382
4,318,708,1030,"77 days, 21:20:07",2013-02-02 07:45:21,2010-02-01 10:32:08,2010-04-20 07:52:15,8742
1120,151,497,1768,"77 days, 21:49:31",2013-02-03 03:26:20,2010-02-01 10:32:08,2010-04-20 08:21:39,8901
700,18,109,827,"77 days, 22:18:48",2013-02-06 00:09:32,2010-06-23 07:05:04,2010-09-09 05:23:52,4724
232,42,90,364,"77 days, 22:32:52",2013-02-07 00:42:05,2010-02-01 10:32:08,2010-04-20 09:05:00,2613
295,654,1079,2028,"77 days, 23:06:43",2013-02-04 06:44:53,2010-02-01 10:32:08,2010-04-20 09:38:51,4915
830,357,490,1677,"77 days, 23:20:50",2013-02-02 00:49:34,2010-02-01 10:32:08,2010-04-20 09:52:58,2728
531,173,329,1033,"77 days, 23:25:21",2013-01-29 05:01:15,2010-02-01 10:32:08,2010-04-20 09:57:29,8421
8,21,124,153,"77 days, 23:29:23",2013-01-22 02:07:20,2010-02-01 10:32:08,2010-04-20 10:01:31,3332
763,245,518,1526,"77 days, 23:35:22",2013-02-04 01:48:55,2010-02-01 10:32:08,2010-04-20 10:07:30,5737
1198,88,709,1995,"78 days, 0:10:16",2013-02-06 00:15:46,2010-02-01 10:32:08,2010-04-20 10:42:24,9239
132,1028,1293,2453,"78 days, 0:55:10",2013-02-05 06:08:19,2010-02-01 10:32:08,2010-04-20 11:27:18,1194
811,4,61,876,"78 days, 1:23:14",2013-01-19 10:20:30,2010-02-01 10:32:08,2010-04-20 11:55:22,2267
536,1648,3253,5437,"78 days, 1:23:38",2013-02-07 02:30:43,2010-02-01 10:32:08,2010-04-20 11:55:46,825
329,81,597,1007,"78 days, 1:56:46",2013-02-05 01:59:15,2010-05-27 03:41:46,2010-08-13 05:38:32,3632
107,866,1433,2406,"78 days, 14:24:29",2013-02-05 11:38:59,2010-02-01 10:32:08,2010-04-21 00:56:37,9139
40,2526,2453,5019,"78 days, 14:45:57",2013-02-07 06:19:16,2010-02-01 10:32:08,2010-04-21 01:18:05,1276
1030,509,1186,2725,"78 days, 15:02:01",2013-02-06 06:47:08,2010-02-01 10:32:08,2010-04-21 01:34:09,5797
361,213,152,726,"78 days, 15:40:52",2013-01-24 05:29:17,2010-02-01 10:32:08,2010-04-21 02:13:00,3550
1237,1361,2065,4663,"78 days, 15:59:01",2013-02-07 00:53:11,2010-02-01 10:32:08,2010-04-21 02:31:09,3568
114,37,198,349,"78 days, 16:01:04",2013-02-05 06:00:07,2010-02-01 10:32:08,2010-04-21 02:33:12,2988
635,2,28,665,"78 days, 16:06:23",2013-01-23 08:36:01,2010-03-25 11:47:48,2010-06-12 03:54:11,3280
1244,523,725,2492,"78 days, 17:12:41",2013-02-02 04:45:17,2010-02-01 10:32:08,2010-04-21 03:44:49,4618
1313,1355,1489,4157,"78 days, 17:48:11",2013-02-07 03:10:49,2010-02-01 10:32:08,2010-04-21 04:20:19,4697
318,4,62,384,"78 days, 17:50:13",2013-01-25 02:53:43,2010-02-01 10:32:08,2010-04-21 04:22:21,7949
671,6,63,740,"78 days, 17:53:46",2013-02-07 05:00:17,2010-02-01 10:32:08,2010-04-21 04:25:54,2647
1394,98,275,1767,"78 days, 18:07:17",2013-01-30 09:57:37,2010-02-01 10:32:08,2010-04-21 04:39:25,2503
331,0,17,348,"78 days, 18:07:27",2013-02-04 01:48:10,2010-02-01 10:32:08,2010-04-21 04:39:35,4774
885,465,1104,2454,"78 days, 18:07:59",2013-02-05 05:02:52,2010-02-01 10:32:08,2010-04-21 04:40:07,8244
9,1260,2654,3923,"78 days, 18:32:11",2013-02-04 07:35:23,2010-02-01 10:32:08,2010-04-21 05:04:19,2099
34,42,271,347,"78 days, 18:40:34",2013-02-02 07:06:37,2010-02-01 10:32:08,2010-04-21 05:12:42,2274
1872,4262,4738,10872,"78 days, 19:30:59",2013-02-06 01:46:49,2010-02-01 10:32:08,2010-04-21 06:03:07,2207
721,286,679,1686,"78 days, 19:58:58",2013-02-05 11:21:07,2010-02-01 10:32:08,2010-04-21 06:31:06,9703
959,10,102,1071,"78 days, 20:28:05",2013-02-01 10:04:22,2010-02-01 10:32:08,2010-04-21 07:00:13,1034
657,2041,2154,4852,"78 days, 20:28:13",2013-02-05 07:05:10,2010-02-01 10:32:08,2010-04-21 07:00:21,8021
329,872,737,1938,"78 days, 20:35:59",2013-02-03 10:40:16,2010-02-01 10:32:08,2010-04-21 07:08:07,4906
612,722,722,2056,"78 days, 20:55:22",2013-02-04 10:27:55,2010-02-01 10:32:08,2010-04-21 07:27:30,5153
1216,426,667,2309,"78 days, 21:55:10",2013-02-06 08:13:49,2010-02-01 10:32:08,2010-04-21 08:27:18,2029
625,2007,2323,4955,"78 days, 22:03:19",2013-02-07 11:04:16,2010-02-01 10:32:08,2010-04-21 08:35:27,1319
3,143,133,279,"78 days, 22:22:05",2013-02-03 05:51:26,2010-02-01 10:32:08,2010-04-21 08:54:13,2081
976,764,1178,2918,"78 days, 22:41:47",2013-02-06 00:09:03,2010-02-01 10:32:08,2010-04-21 09:13:55,2765
806,2331,3654,6791,"78 days, 22:54:26",2013-02-06 11:24:34,2010-02-01 10:32:08,2010-04-21 09:26:34,1746
577,1285,2841,4703,"78 days, 23:13:54",2013-02-05 07:11:24,2010-02-01 10:32:08,2010-04-21 09:46:02,5675
929,81,520,1530,"79 days, 0:17:01",2013-02-07 03:42:58,2010-02-01 10:32:08,2010-04-21 10:49:09,5175
631,324,769,1724,"79 days, 0:26:07",2013-02-05 07:27:32,2010-02-01 10:32:08,2010-04-21 10:58:15,7029
1333,1017,1463,3813,"79 days, 0:45:10",2013-02-07 07:01:06,2010-02-01 10:32:08,2010-04-21 11:17:18,4371
1564,2219,2976,6759,"79 days, 1:03:26",2013-02-07 00:54:54,2010-02-01 10:32:08,2010-04-21 11:35:34,8929
343,5340,4836,10519,"79 days, 1:15:54",2013-02-07 03:51:13,2010-02-01 10:32:08,2010-04-21 11:48:02,716
1048,438,734,2220,"79 days, 14:34:01",2013-02-04 11:26:58,2010-02-01 10:32:08,2010-04-22 01:06:09,3270
140,446,784,1370,"79 days, 15:33:03",2013-02-04 10:37:01,2010-02-01 10:32:08,2010-04-22 02:05:11,715
1172,1233,2455,4860,"79 days, 15:57:08",2013-02-07 11:31:23,2010-02-01 10:32:08,2010-04-22 02:29:16,7572
664,220,490,1374,"79 days, 17:25:53",2013-02-02 10:22:50,2010-02-01 10:32:08,2010-04-22 03:58:01,4699
69,10,130,209,"79 days, 18:08:32",2013-01-29 00:55:08,2010-02-01 10:32:08,2010-04-22 04:40:40,4390
92,403,745,1240,"79 days, 18:15:51",2013-02-02 03:46:26,2010-02-01 10:32:08,2010-04-22 04:47:59,8653
707,1372,2182,4261,"79 days, 18:17:03",2013-02-06 07:47:32,2010-02-01 10:32:08,2010-04-22 04:49:11,6450
135,935,1457,2527,"79 days, 19:04:53",2013-02-07 08:41:05,2010-02-01 10:32:08,2010-04-22 05:37:01,6828
724,4,106,834,"79 days, 19:49:56",2013-01-29 10:22:31,2010-03-15 10:36:08,2010-06-03 06:26:04,8949
202,496,851,1549,"79 days, 19:50:43",2013-02-06 07:08:48,2010-02-01 10:32:08,2010-04-22 06:22:51,6169
746,1082,1616,3444,"79 days, 20:49:50",2013-02-07 07:57:22,2010-02-01 10:32:08,2010-04-22 07:21:58,2131
359,368,786,1513,"79 days, 20:52:54",2013-02-05 01:32:41,2010-02-01 10:32:08,2010-04-22 07:25:02,1030
51,1817,2907,4775,"79 days, 21:01:38",2013-02-06 00:41:42,2010-02-01 10:32:08,2010-04-22 07:33:46,4175
310,5,151,466,"79 days, 21:35:14",2013-01-31 07:44:49,2010-02-01 10:32:08,2010-04-22 08:07:22,1989
129,2929,2976,6034,"79 days, 22:14:42",2013-02-06 10:55:25,2010-02-01 10:32:08,2010-04-22 08:46:50,3464
131,492,449,1072,"79 days, 22:24:09",2013-02-06 06:15:08,2010-02-01 10:32:08,2010-04-22 08:56:17,103
298,4117,4945,9360,"79 days, 22:46:45",2013-02-05 09:35:03,2010-02-01 10:32:08,2010-04-22 09:18:53,6165
1000,326,318,1644,"79 days, 23:46:17",2013-02-04 05:23:39,2010-02-01 10:32:08,2010-04-22 10:18:25,7990
807,1790,2573,5170,"80 days, 0:33:46",2013-02-09 08:39:19,2010-02-01 10:32:08,2010-04-22 11:05:54,4721
332,22,132,486,"80 days, 0:34:30",2013-02-05 10:00:07,2010-09-21 03:34:44,2010-12-10 04:09:14,6441
1084,964,1322,3370,"80 days, 0:36:17",2013-02-06 03:34:13,2010-02-01 10:32:08,2010-04-22 11:08:25,2518
520,515,786,1821,"80 days, 0:43:54",2013-02-04 09:15:23,2010-02-01 10:32:08,2010-04-22 11:16:02,9739
421,37,121,579,"80 days, 1:07:44",2013-01-28 09:18:45,2010-02-01 10:32:08,2010-04-22 11:39:52,1222
132,1623,2508,4263,"80 days, 1:22:07",2013-02-07 09:13:33,2010-02-01 10:32:08,2010-04-22 11:54:15,4202
627,183,493,1303,"80 days, 13:38:19",2013-02-04 07:47:26,2010-02-01 10:32:08,2010-04-23 00:10:27,3557
909,75,399,1383,"80 days, 13:53:29",2013-02-01 04:56:12,2010-02-01 10:32:08,2010-04-23 00:25:37,1842
452,2054,1916,4422,"80 days, 13:53:29",2013-02-07 01:05:49,2010-02-01 10:32:08,2010-04-23 00:25:37,3830
577,1324,1895,3796,"80 days, 13:58:46",2013-02-06 10:44:51,2010-02-01 10:32:08,2010-04-23 00:30:54,7911
652,221,179,1052,"80 days, 14:30:38",2013-01-30 09:40:33,2010-02-01 10:32:08,2010-04-23 01:02:46,3091
138,864,1224,2226,"80 days, 15:11:20",2013-02-05 08:53:28,2010-02-01 10:32:08,2010-04-23 01:43:28,3906
759,352,414,1525,"80 days, 15:53:09",2013-02-07 06:26:21,2010-02-01 10:32:08,2010-04-23 02:25:17,5431
246,903,1235,2384,"80 days, 16:06:22",2013-02-04 10:41:31,2010-02-01 10:32:08,2010-04-23 02:38:30,1571
568,297,618,1483,"80 days, 16:56:09",2013-02-03 03:54:50,2010-02-01 10:32:08,2010-04-23 03:28:17,6118
605,3880,3227,7712,"80 days, 17:10:03",2013-02-06 11:35:40,2010-02-01 10:32:08,2010-04-23 03:42:11,237
703,12,186,901,"80 days, 17:14:56",2013-01-21 08:58:19,2010-02-01 10:32:08,2010-04-23 03:47:04,6124
415,945,947,2307,"80 days, 18:01:33",2013-02-05 04:07:10,2010-02-01 10:32:08,2010-04-23 04:33:41,2864
122,618,1209,1949,"80 days, 19:18:18",2013-02-06 02:43:46,2010-02-01 10:32:08,2010-04-23 05:50:26,2484
377,64,284,725,"80 days, 19:34:44",2013-02-03 09:36:42,2010-02-01 10:32:08,2010-04-23 06:06:52,7803
511,94,332,937,"80 days, 19:38:52",2013-02-04 09:13:26,2010-02-01 10:32:08,2010-04-23 06:11:00,6990
878,1,1,880,"80 days, 20:43:18",2013-01-28 09:38:08,2010-02-01 10:32:08,2010-04-23 07:15:26,2815
157,974,1300,2431,"80 days, 20:49:17",2013-02-06 03:24:10,2010-02-01 10:32:08,2010-04-23 07:21:25,9126
506,320,642,1468,"80 days, 21:05:51",2013-02-06 10:35:19,2010-02-01 10:32:08,2010-04-23 07:37:59,7586
186,1782,3032,5000,"80 days, 21:10:25",2013-02-07 00:05:56,2010-02-01 10:32:08,2010-04-23 07:42:33,9061
242,350,522,1114,"80 days, 21:36:48",2013-02-05 01:56:12,2010-02-01 10:32:08,2010-04-23 08:08:56,8222
509,2513,2688,5710,"80 days, 21:44:36",2013-02-06 04:14:00,2010-02-01 10:32:08,2010-04-23 08:16:44,136
307,145,170,622,"80 days, 21:50:43",2013-02-03 05:18:07,2010-06-12 09:53:36,2010-09-01 07:44:19,2821
822,654,1210,2686,"80 days, 22:26:10",2013-02-05 11:37:48,2010-02-01 10:32:08,2010-04-23 08:58:18,1873
206,1052,1648,2906,"80 days, 22:32:21",2013-02-07 02:28:17,2010-02-01 10:32:08,2010-04-23 09:04:29,6486
176,415,762,1353,"80 days, 23:45:33",2013-02-06 02:20:23,2010-02-01 10:32:08,2010-04-23 10:17:41,9655
388,596,763,1747,"81 days, 0:20:11",2013-02-06 00:45:22,2010-02-01 10:32:08,2010-04-23 10:52:19,3692
696,951,1694,3341,"81 days, 0:37:01",2013-02-06 00:45:46,2010-02-01 10:32:08,2010-04-23 11:09:09,7682
80,808,1040,1928,"81 days, 1:07:50",2013-02-06 02:15:48,2010-02-01 10:32:08,2010-04-23 11:39:58,290
30,13,87,130,"81 days, 1:56:35",2013-02-06 01:22:39,2010-04-06 03:57:36,2010-06-26 05:54:11,4882
55,6,78,139,"81 days, 13:43:13",2013-01-28 05:17:20,2010-02-01 10:32:08,2010-04-24 00:15:21,5320
235,321,540,1096,"81 days, 13:51:56",2013-02-06 10:38:16,2010-02-01 10:32:08,2010-04-24 00:24:04,7571
1064,730,1214,3008,"81 days, 13:58:21",2013-02-17 03:06:24,2010-02-01 10:32:08,2010-04-24 00:30:29,4744
42,168,182,392,"81 days, 14:06:47",2013-02-05 09:56:57,2010-02-01 10:32:08,2010-04-24 00:38:55,8046
475,533,845,1853,"81 days, 14:18:47",2013-02-07 04:53:07,2010-02-01 10:32:08,2010-04-24 00:50:55,640
601,54,534,1189,"81 days, 14:58:24",2013-02-02 06:43:22,2010-02-01 10:32:08,2010-04-24 01:30:32,3772
4,53,438,495,"81 days, 15:17:08",2013-02-02 06:56:13,2010-02-01 10:32:08,2010-04-24 01:49:16,925
766,278,1216,2260,"81 days, 15:29:35",2013-02-06 09:45:10,2010-02-01 10:32:08,2010-04-24 02:01:43,6824
963,433,1094,2490,"81 days, 16:16:27",2013-02-06 07:41:12,2010-02-01 10:32:08,2010-04-24 02:48:35,1112
892,1343,2068,4303,"81 days, 16:31:29",2013-02-07 07:40:36,2010-02-01 10:32:08,2010-04-24 03:03:37,4772
485,872,256,1613,"81 days, 16:54:51",2013-02-06 11:40:08,2010-02-01 10:32:08,2010-04-24 03:26:59,845
891,96,385,1372,"81 days, 17:07:41",2013-01-31 05:43:00,2010-02-01 10:32:08,2010-04-24 03:39:49,8280
210,126,246,582,"81 days, 17:41:36",2013-02-02 11:24:51,2010-02-01 10:32:08,2010-04-24 04:13:44,5941
27,306,429,762,"81 days, 17:56:38",2013-02-05 05:30:55,2010-04-28 10:06:57,2010-07-19 04:03:35,641
10,812,1258,2080,"81 days, 18:19:27",2013-02-02 07:24:44,2010-02-01 10:32:08,2010-04-24 04:51:35,1172
957,14,55,1026,"81 days, 18:43:13",2013-02-08 03:03:02,2010-02-01 10:32:08,2010-04-24 05:15:21,7054
147,3,66,216,"81 days, 19:02:58",2013-01-20 03:02:29,2012-05-16 11:23:21,2012-08-06 06:26:19,1526
231,56,265,552,"81 days, 19:19:05",2013-02-03 03:19:45,2010-02-01 10:32:08,2010-04-24 05:51:13,9565
807,354,731,1892,"81 days, 19:22:36",2013-02-03 07:54:39,2010-02-01 10:32:08,2010-04-24 05:54:44,8392
731,502,1035,2268,"81 days, 19:47:46",2013-02-06 07:14:30,2010-02-01 10:32:08,2010-04-24 06:19:54,4517
72,71,311,454,"81 days, 19:51:17",2013-01-30 11:35:10,2010-07-03 06:24:08,2010-09-23 02:15:25,3713
169,323,789,1281,"81 days, 20:02:03",2013-02-04 11:58:25,2010-02-01 10:32:08,2010-04-24 06:34:11,8659
45,82,119,246,"81 days, 20:21:44",2013-01-31 11:58:30,2010-04-24 11:43:21,2010-07-15 08:05:05,3264
795,1734,2130,4659,"81 days, 21:00:16",2013-02-07 07:31:17,2010-02-01 10:32:08,2010-04-24 07:32:24,696
74,269,536,879,"81 days, 21:04:48",2013-02-06 06:28:51,2010-02-01 10:32:08,2010-04-24 07:36:56,7814
23,264,592,879,"81 days, 21:07:03",2013-02-06 00:15:17,2010-02-01 10:32:08,2010-04-24 07:39:11,2377
1325,5716,5170,12211,"81 days, 21:23:23",2013-02-16 10:06:27,2010-02-01 10:32:08,2010-04-24 07:55:31,8
1013,1,9,1023,"81 days, 21:26:16",2013-01-25 05:51:16,2010-02-01 10:32:08,2010-04-24 07:58:24,3607
95,319,251,665,"81 days, 23:02:24",2013-02-05 10:45:57,2010-02-01 10:32:08,2010-04-24 09:34:32,9152
596,1698,2704,4998,"81 days, 23:40:16",2013-02-06 07:24:43,2010-02-01 10:32:08,2010-04-24 10:12:24,7413
595,112,348,1055,"82 days, 0:33:44",2013-02-03 11:49:12,2010-02-01 10:32:08,2010-04-24 11:05:52,9259
680,769,1470,2919,"82 days, 0:59:32",2013-02-06 06:02:20,2010-02-01 10:32:08,2010-04-24 11:31:40,7183
130,6,73,209,"82 days, 2:51:15",2013-01-24 08:09:11,2010-10-29 02:28:28,2011-01-19 05:19:43,1552
76,524,1286,1886,"82 days, 13:39:52",2013-02-08 00:38:58,2010-02-01 10:32:08,2010-04-25 00:12:00,1267
611,94,306,1011,"82 days, 13:47:51",2013-02-03 11:49:39,2010-03-03 11:41:50,2010-05-25 01:29:41,7321
379,920,1945,3244,"82 days, 14:50:03",2013-02-04 08:59:31,2010-02-01 10:32:08,2010-04-25 01:22:11,1751
102,1908,1979,3989,"82 days, 15:32:55",2013-02-06 03:56:56,2010-02-01 10:32:08,2010-04-25 02:05:03,501
1642,2728,3061,7431,"82 days, 16:26:18",2013-02-07 07:54:57,2010-02-01 10:32:08,2010-04-25 02:58:26,7176
47,1217,1690,2954,"82 days, 17:25:19",2013-02-05 08:33:53,2010-02-01 10:32:08,2010-04-25 03:57:27,8711
370,4,60,434,"82 days, 17:50:43",2013-01-31 09:01:11,2010-02-01 10:32:08,2010-04-25 04:22:51,6673
151,5,70,226,"82 days, 17:54:47",2013-01-31 01:20:46,2010-02-01 10:32:08,2010-04-25 04:26:55,1356
322,168,111,601,"82 days, 18:30:42",2013-02-04 06:58:33,2010-02-01 10:32:08,2010-04-25 05:02:50,8175
768,10,180,958,"82 days, 18:56:25",2013-02-04 03:08:52,2010-05-26 06:14:46,2010-08-17 01:11:11,9080
67,5,98,170,"82 days, 19:10:07",2013-02-02 02:41:01,2010-02-01 10:32:08,2010-04-25 05:42:15,9275
121,414,1127,1662,"82 days, 19:26:09",2013-02-06 11:58:18,2010-02-01 10:32:08,2010-04-25 05:58:17,8186
869,340,562,1771,"82 days, 19:32:31",2013-02-06 04:25:52,2010-02-01 10:32:08,2010-04-25 06:04:39,8408
297,24,260,581,"82 days, 19:45:23",2013-02-06 02:02:01,2010-02-01 10:32:08,2010-04-25 06:17:31,1732
162,4698,3848,8708,"82 days, 19:48:27",2013-02-06 11:38:15,2010-02-01 10:32:08,2010-04-25 06:20:35,9129
690,4505,4561,9756,"82 days, 19:56:31",2013-02-18 04:06:59,2010-02-01 10:32:08,2010-04-25 06:28:39,724
462,2672,4307,7441,"82 days, 20:30:45",2013-02-07 02:37:43,2010-02-01 10:32:08,2010-04-25 07:02:53,7388
236,202,173,611,"82 days, 20:49:37",2013-02-02 04:10:35,2010-02-01 10:32:08,2010-04-25 07:21:45,5446
963,6,57,1026,"82 days, 21:17:18",2013-02-04 04:42:27,2010-02-01 10:32:08,2010-04-25 07:49:26,5658
811,301,359,1471,"82 days, 21:19:39",2013-02-04 07:36:44,2010-02-01 10:32:08,2010-04-25 07:51:47,2203
372,60,97,529,"82 days, 21:57:26",2013-02-01 06:16:19,2010-02-01 10:32:08,2010-04-25 08:29:34,3634
625,3,22,650,"82 days, 22:03:13",2013-01-23 08:57:17,2010-02-01 10:32:08,2010-04-25 08:35:21,1201
679,570,460,1709,"82 days, 22:53:01",2013-02-05 04:41:51,2010-02-01 10:32:08,2010-04-25 09:25:09,145
619,9,133,761,"82 days, 23:21:00",2013-01-31 08:25:20,2010-02-01 10:32:08,2010-04-25 09:53:08,9993
1268,905,2207,4380,"82 days, 23:32:03",2013-02-05 03:26:49,2010-02-01 10:32:08,2010-04-25 10:04:11,2342
116,427,815,1358,"82 days, 23:42:21",2013-02-06 00:42:27,2010-02-01 10:32:08,2010-04-25 10:14:29,7070
637,225,379,1241,"83 days, 1:03:48",2013-02-14 09:57:06,2010-02-01 10:32:08,2010-04-25 11:35:56,205
33,162,217,412,"83 days, 13:50:13",2013-02-07 06:00:37,2010-02-01 10:32:08,2010-04-26 00:22:21,8468
89,1576,2035,3700,"83 days, 13:52:09",2013-02-07 11:30:32,2010-02-01 10:32:08,2010-04-26 00:24:17,4083
625,520,1183,2328,"83 days, 15:28:25",2013-02-05 07:09:04,2010-02-01 10:32:08,2010-04-26 02:00:33,7655
566,958,1451,2975,"83 days, 16:00:18",2013-02-07 03:21:17,2010-02-01 10:32:08,2010-04-26 02:32:26,7197
540,933,1073,2546,"83 days, 16:34:17",2013-02-04 02:36:44,2010-02-01 10:32:08,2010-04-26 03:06:25,2665
439,92,384,915,"83 days, 16:38:48",2013-02-01 07:50:54,2010-02-01 10:32:08,2010-04-26 03:10:56,9331
185,636,1231,2052,"83 days, 18:46:10",2013-02-06 06:09:15,2010-02-01 10:32:08,2010-04-26 05:18:18,993
1471,119,316,1906,"83 days, 19:42:24",2013-02-05 02:32:58,2010-02-01 10:32:08,2010-04-26 06:14:32,6151
885,1,0,886,"83 days, 19:54:04",2013-01-29 08:45:20,2010-02-01 10:32:08,2010-04-26 06:26:12,6438
30,85,210,325,"83 days, 20:55:29",2013-02-02 11:22:52,2010-02-01 10:32:08,2010-04-26 07:27:37,8318
978,349,597,1924,"83 days, 21:26:04",2013-02-03 02:39:33,2010-02-01 10:32:08,2010-04-26 07:58:12,6695
913,2597,3303,6813,"83 days, 21:29:59",2013-02-06 07:11:13,2010-02-01 10:32:08,2010-04-26 08:02:07,1038
117,160,213,490,"83 days, 22:00:26",2013-02-05 07:21:11,2010-02-01 10:32:08,2010-04-26 08:32:34,9630
245,318,580,1143,"83 days, 22:12:24",2013-02-04 09:04:16,2010-02-01 10:32:08,2010-04-26 08:44:32,1587
198,8,81,287,"83 days, 22:18:37",2013-02-04 01:43:31,2010-02-01 10:32:08,2010-04-26 08:50:45,2339
285,145,340,770,"83 days, 22:46:12",2013-02-04 06:51:39,2010-02-01 10:32:08,2010-04-26 09:18:20,8401
629,1779,3475,5883,"83 days, 22:47:28",2013-02-06 10:59:48,2010-02-01 10:32:08,2010-04-26 09:19:36,4127
88,451,1322,1861,"83 days, 23:59:30",2013-02-05 09:15:23,2010-02-01 10:32:08,2010-04-26 10:31:38,3951
899,5,64,968,"83 days, 23:59:33",2013-01-30 01:22:14,2010-02-01 10:32:08,2010-04-26 10:31:41,927
742,345,378,1465,"84 days, 0:55:15",2013-02-04 11:55:14,2010-02-01 10:32:08,2010-04-26 11:27:23,1715
394,1717,2559,4670,"84 days, 1:08:15",2013-02-06 07:54:50,2010-02-01 10:32:08,2010-04-26 11:40:23,2932
89,10,56,155,"84 days, 1:46:38",2013-01-24 06:12:48,2011-12-17 06:45:07,2012-03-10 08:31:45,1054
471,236,392,1099,"84 days, 3:59:01",2013-02-05 02:43:43,2010-03-26 04:30:54,2010-06-18 08:29:55,1720
9,16,102,127,"84 days, 13:47:48",2013-01-29 04:25:49,2010-02-01 10:32:08,2010-04-27 00:19:56,3248
5,407,538,950,"84 days, 14:09:35",2013-02-06 07:18:45,2010-02-01 10:32:08,2010-04-27 00:41:43,5077
48,345,631,1024,"84 days, 14:23:34",2013-02-03 00:24:01,2010-02-01 10:32:08,2010-04-27 00:55:42,8377
830,366,544,1740,"84 days, 14:58:23",2013-02-06 08:23:29,2010-02-01 10:32:08,2010-04-27 01:30:31,7913
436,2,46,484,"84 days, 15:20:51",2013-01-31 01:03:07,2010-02-01 10:32:08,2010-04-27 01:52:59,7075
339,287,405,1031,"84 days, 17:10:59",2013-02-04 10:10:05,2010-02-01 10:32:08,2010-04-27 03:43:07,8358
66,81,260,407,"84 days, 17:12:42",2013-02-07 00:51:50,2010-02-01 10:32:08,2010-04-27 03:44:50,9879
1016,538,756,2310,"84 days, 17:40:24",2013-02-03 08:43:33,2010-02-01 10:32:08,2010-04-27 04:12:32,5301
25,703,1400,2128,"84 days, 18:09:11",2013-02-07 03:45:43,2010-02-01 10:32:08,2010-04-27 04:41:19,8011
610,426,1143,2179,"84 days, 18:24:50",2013-02-06 09:56:28,2010-02-01 10:32:08,2010-04-27 04:56:58,573
413,154,443,1010,"84 days, 18:27:06",2013-02-03 06:16:29,2010-02-01 10:32:08,2010-04-27 04:59:14,5620
52,425,911,1388,"84 days, 18:36:35",2013-02-06 11:24:48,2010-02-01 10:32:08,2010-04-27 05:08:43,6102
255,467,943,1665,"84 days, 20:32:12",2013-02-05 06:25:07,2010-02-01 10:32:08,2010-04-27 07:04:20,6607
56,333,515,904,"84 days, 21:05:49",2013-02-05 00:37:08,2010-02-01 10:32:08,2010-04-27 07:37:57,7503
1971,3385,3855,9211,"84 days, 21:36:46",2013-02-06 07:39:08,2010-02-01 10:32:08,2010-04-27 08:08:54,7715
420,574,1269,2263,"84 days, 21:40:55",2013-02-06 09:47:08,2010-02-01 10:32:08,2010-04-27 08:13:03,4711
1093,19,166,1278,"84 days, 22:04:21",2013-02-03 04:11:19,2010-02-01 10:32:08,2010-04-27 08:36:29,8339
83,80,176,339,"84 days, 22:11:25",2013-02-05 10:48:07,2011-01-07 07:29:57,2011-04-02 05:41:22,2744
439,1675,1806,3920,"84 days, 22:14:49",2013-02-06 06:43:39,2010-02-01 10:32:08,2010-04-27 08:46:57,5436
748,1738,3230,5716,"84 days, 22:19:00",2013-02-13 11:55:13,2010-02-01 10:32:08,2010-04-27 08:51:08,1654
44,273,456,773,"84 days, 22:19:18",2013-02-01 05:48:15,2010-02-01 10:32:08,2010-04-27 08:51:26,5527
937,0,20,957,"84 days, 23:04:31",2013-01-18 01:30:58,2010-02-01 10:32:08,2010-04-27 09:36:39,6356
198,129,205,532,"84 days, 23:12:55",2013-02-02 09:42:15,2010-02-01 10:32:08,2010-04-27 09:45:03,8378
175,550,835,1560,"84 days, 23:19:26",2013-02-05 01:32:23,2010-02-01 10:32:08,2010-04-27 09:51:34,320
30,161,365,556,"84 days, 23:36:24",2013-02-02 05:50:15,2010-02-01 10:32:08,2010-04-27 10:08:32,9413
275,197,251,723,"84 days, 23:40:52",2013-02-03 10:26:24,2010-02-01 10:32:08,2010-04-27 10:13:00,6624
465,95,105,665,"84 days, 23:51:16",2013-01-31 06:52:18,2010-02-01 10:32:08,2010-04-27 10:23:24,6979
989,0,29,1018,"85 days, 0:21:13",2013-01-23 05:43:26,2010-12-27 09:16:57,2011-03-22 09:38:10,1554
696,32,191,919,"85 days, 0:41:41",2013-02-02 11:47:36,2010-02-01 10:32:08,2010-04-27 11:13:49,7827
17,192,308,517,"85 days, 1:17:56",2013-02-03 04:01:08,2010-02-01 10:32:08,2010-04-27 11:50:04,2021
304,0,0,304,"85 days, 2:01:35",2012-12-25 11:52:37,2010-03-04 03:19:06,2010-05-28 05:20:41,5819
1060,1547,2657,5264,"85 days, 13:51:30",2013-02-07 08:15:26,2010-02-01 10:32:08,2010-04-28 00:23:38,4556
92,305,518,915,"85 days, 14:09:04",2013-02-04 02:14:47,2010-02-01 10:32:08,2010-04-28 00:41:12,8428
1043,287,338,1668,"85 days, 14:31:19",2013-02-06 01:59:14,2010-02-01 10:32:08,2010-04-28 01:03:27,6677
1071,161,385,1617,"85 days, 14:52:03",2013-01-29 00:35:15,2010-02-01 10:32:08,2010-04-28 01:24:11,9714
1159,81,431,1671,"85 days, 15:52:43",2013-02-02 05:28:10,2010-02-01 10:32:08,2010-04-28 02:24:51,7525
8,512,1240,1760,"85 days, 16:10:34",2013-02-04 03:59:16,2010-02-01 10:32:08,2010-04-28 02:42:42,8373
1535,878,1062,3475,"85 days, 16:49:22",2013-02-04 08:00:59,2010-02-01 10:32:08,2010-04-28 03:21:30,5136
641,304,665,1610,"85 days, 16:50:03",2013-02-06 08:36:27,2010-02-01 10:32:08,2010-04-28 03:22:11,7080
563,2184,2687,5434,"85 days, 16:50:42",2013-02-05 06:58:51,2010-02-01 10:32:08,2010-04-28 03:22:50,3482
17,28,193,238,"85 days, 16:54:12",2013-02-01 09:34:03,2010-02-01 10:32:08,2010-04-28 03:26:20,2313
134,72,301,507,"85 days, 16:58:55",2013-02-04 02:40:11,2010-02-01 10:32:08,2010-04-28 03:31:03,482
67,42,190,299,"85 days, 18:09:58",2013-01-31 09:52:27,2010-02-01 10:32:08,2010-04-28 04:42:06,1009
22,11,31,64,"85 days, 18:44:38",2013-01-16 00:04:05,2011-04-19 07:39:12,2011-07-14 02:23:50,3959
302,608,1288,2198,"85 days, 18:57:31",2013-02-04 07:29:42,2010-02-01 10:32:08,2010-04-28 05:29:39,6882
1246,3,0,1249,"85 days, 19:11:16",2012-12-25 05:54:50,2010-02-01 10:32:08,2010-04-28 05:43:24,4210
100,60,137,297,"85 days, 19:36:18",2013-02-03 03:33:02,2010-02-01 10:32:08,2010-04-28 06:08:26,7787
738,445,706,1889,"85 days, 19:39:33",2013-02-01 01:50:18,2010-02-01 10:32:08,2010-04-28 06:11:41,8601
1285,3083,4222,8590,"85 days, 19:47:42",2013-02-07 00:22:13,2010-02-01 10:32:08,2010-04-28 06:19:50,668
658,0,18,676,"85 days, 20:01:00",2013-01-21 00:23:03,2010-02-01 10:32:08,2010-04-28 06:33:08,7296
1090,448,769,2307,"85 days, 20:02:26",2013-02-06 06:19:55,2010-02-01 10:32:08,2010-04-28 06:34:34,4154
804,352,462,1618,"85 days, 20:58:18",2013-02-10 07:03:31,2010-02-01 10:32:08,2010-04-28 07:30:26,574
770,284,423,1477,"85 days, 21:08:27",2013-02-06 05:49:38,2010-02-01 10:32:08,2010-04-28 07:40:35,4049
148,738,1097,1983,"85 days, 21:29:57",2013-02-07 08:39:49,2010-02-01 10:32:08,2010-04-28 08:02:05,4044
866,1272,1552,3690,"85 days, 21:30:07",2013-02-06 01:04:39,2010-02-01 10:32:08,2010-04-28 08:02:15,7763
192,207,513,912,"85 days, 21:46:48",2013-02-06 05:28:44,2010-02-01 10:32:08,2010-04-28 08:18:56,9004
598,254,607,1459,"85 days, 21:57:53",2013-02-03 11:01:38,2010-02-01 10:32:08,2010-04-28 08:30:01,1613
345,823,1483,2651,"85 days, 22:01:03",2013-02-05 04:23:58,2010-02-01 10:32:08,2010-04-28 08:33:11,1217
1108,1678,2804,5590,"85 days, 22:28:36",2013-02-06 09:28:08,2010-02-01 10:32:08,2010-04-28 09:00:44,5319
559,1026,1163,2748,"85 days, 22:29:08",2013-02-05 04:11:18,2010-02-01 10:32:08,2010-04-28 09:01:16,9154
235,325,583,1143,"85 days, 22:57:33",2013-02-03 00:43:57,2010-02-01 10:32:08,2010-04-28 09:29:41,9438
523,701,1057,2281,"85 days, 23:37:54",2013-02-08 06:24:05,2010-02-01 10:32:08,2010-04-28 10:10:02,7639
35,138,321,494,"86 days, 0:27:23",2013-02-06 07:38:22,2010-02-01 10:32:08,2010-04-28 10:59:31,7104
345,21,27,393,"86 days, 0:33:14",2013-02-02 05:50:34,2010-07-01 10:37:00,2010-09-25 11:10:14,7616
672,503,1003,2178,"86 days, 0:40:08",2013-02-06 06:27:25,2010-05-04 11:12:02,2010-07-29 11:52:10,8486
1408,620,847,2875,"86 days, 1:23:30",2013-02-04 09:15:41,2010-02-01 10:32:08,2010-04-28 11:55:38,6216
172,7,112,291,"86 days, 9:41:43",2013-02-07 08:10:45,2010-05-10 00:56:10,2010-08-04 10:37:53,2177
200,6,60,266,"86 days, 12:29:48",2013-01-31 03:07:26,2010-05-15 11:32:24,2010-08-10 00:02:12,2849
459,325,789,1573,"86 days, 13:46:23",2013-02-07 02:16:03,2010-02-01 10:32:08,2010-04-29 00:18:31,8357
367,7,295,669,"86 days, 14:15:17",2013-01-28 02:05:59,2010-02-01 10:32:08,2010-04-29 00:47:25,619
26,3184,3785,6995,"86 days, 14:44:19",2013-02-06 09:58:53,2010-02-01 10:32:08,2010-04-29 01:16:27,3738
1214,258,538,2010,"86 days, 16:10:50",2013-02-05 05:16:58,2010-02-01 10:32:08,2010-04-29 02:42:58,3545
452,893,1645,2990,"86 days, 16:44:33",2013-02-06 01:45:01,2010-02-01 10:32:08,2010-04-29 03:16:41,4
96,327,461,884,"86 days, 17:07:14",2013-02-11 09:57:30,2010-02-01 10:32:08,2010-04-29 03:39:22,9104
24,37,147,208,"86 days, 17:42:03",2013-02-01 10:25:51,2010-02-01 10:32:08,2010-04-29 04:14:11,5584
965,208,596,1769,"86 days, 18:20:17",2013-02-05 11:22:43,2010-02-01 10:32:08,2010-04-29 04:52:25,1359
49,503,517,1069,"86 days, 18:22:20",2013-02-04 00:44:47,2010-02-01 10:32:08,2010-04-29 04:54:28,4785
806,50,234,1090,"86 days, 18:26:01",2013-01-23 01:34:47,2010-02-01 10:32:08,2010-04-29 04:58:09,9392
1392,163,329,1884,"86 days, 18:28:09",2013-02-04 02:42:12,2010-02-01 10:32:08,2010-04-29 05:00:17,5728
673,2279,3359,6311,"86 days, 18:28:31",2013-02-07 06:43:29,2010-02-01 10:32:08,2010-04-29 05:00:39,827
404,668,1370,2442,"86 days, 18:35:10",2013-02-06 09:34:17,2010-02-01 10:32:08,2010-04-29 05:07:18,9206
455,658,1506,2619,"86 days, 18:48:43",2013-02-06 06:39:15,2010-02-01 10:32:08,2010-04-29 05:20:51,6167
193,61,338,592,"86 days, 18:53:08",2013-01-30 00:04:22,2010-02-01 10:32:08,2010-04-29 05:25:16,9521
527,1263,2552,4342,"86 days, 18:56:50",2013-02-06 01:36:32,2010-02-01 10:32:08,2010-04-29 05:28:58,8925
7,496,926,1429,"86 days, 19:18:37",2013-02-06 04:26:36,2010-02-01 10:32:08,2010-04-29 05:50:45,1983
360,53,252,665,"86 days, 19:20:34",2013-01-30 09:54:27,2010-02-01 10:32:08,2010-04-29 05:52:42,1852
24,432,910,1366,"86 days, 19:44:25",2013-02-03 04:28:25,2010-02-01 10:32:08,2010-04-29 06:16:33,8689
242,117,573,932,"86 days, 20:06:50",2013-02-03 07:26:19,2010-02-01 10:32:08,2010-04-29 06:38:58,9127
202,1294,1699,3195,"86 days, 20:12:53",2013-02-05 10:55:06,2010-02-01 10:32:08,2010-04-29 06:45:01,9786
7,178,410,595,"86 days, 20:14:54",2013-02-01 07:16:06,2010-02-01 10:32:08,2010-04-29 06:47:02,207
998,752,1515,3265,"86 days, 20:50:48",2013-02-03 07:37:02,2010-02-01 10:32:08,2010-04-29 07:22:56,8912
164,988,2354,3506,"86 days, 21:10:34",2013-02-07 04:29:47,2010-02-01 10:32:08,2010-04-29 07:42:42,5710
26,2,90,118,"86 days, 22:43:59",2013-02-02 11:09:00,2010-11-29 07:41:15,2011-02-24 06:25:14,1848
1335,723,843,2901,"86 days, 23:48:04",2013-02-06 08:32:05,2010-02-01 10:32:08,2010-04-29 10:20:12,255
398,7,151,556,"87 days, 0:11:58",2013-01-31 00:15:44,2010-06-08 09:27:41,2010-09-03 09:39:39,5770
584,129,159,872,"87 days, 0:24:27",2013-02-05 04:29:15,2010-02-01 10:32:08,2010-04-29 10:56:35,7606
1054,4,10,1068,"87 days, 0:30:17",2013-02-05 04:28:56,2010-02-01 10:32:08,2010-04-29 11:02:25,1792
233,152,230,615,"87 days, 0:53:44",2013-02-05 06:23:43,2010-03-25 04:21:27,2010-06-20 05:15:11,3728
37,11,62,110,"87 days, 1:52:56",2013-01-28 07:30:59,2010-08-30 02:26:53,2010-11-25 04:19:49,8681
5,3,36,44,"87 days, 8:09:22",2013-02-02 04:29:37,2010-09-16 01:47:15,2010-12-12 09:56:37,689
102,614,1119,1835,"87 days, 13:32:52",2013-02-08 03:29:45,2010-02-01 10:32:08,2010-04-30 00:05:00,7924
213,46,157,416,"87 days, 14:41:02",2013-02-03 07:21:21,2010-02-01 10:32:08,2010-04-30 01:13:10,9156
270,517,921,1708,"87 days, 14:55:08",2013-02-07 08:51:37,2010-02-01 10:32:08,2010-04-30 01:27:16,457
31,163,228,422,"87 days, 15:19:35",2013-02-06 08:57:01,2010-02-01 10:32:08,2010-04-30 01:51:43,8395
215,191,827,1233,"87 days, 16:17:57",2013-02-04 05:31:14,2010-02-01 10:32:08,2010-04-30 02:50:05,5464
510,225,662,1397,"87 days, 16:23:24",2013-02-01 03:50:32,2010-02-01 10:32:08,2010-04-30 02:55:32,2878
246,253,810,1309,"87 days, 16:57:46",2013-02-04 04:37:26,2010-02-01 10:32:08,2010-04-30 03:29:54,6375
65,131,411,607,"87 days, 17:32:20",2013-02-03 06:35:03,2010-02-01 10:32:08,2010-04-30 04:04:28,303
1032,1825,2684,5541,"87 days, 17:35:10",2013-02-06 04:21:59,2010-02-01 10:32:08,2010-04-30 04:07:18,790
81,92,420,593,"87 days, 18:35:40",2013-02-05 00:26:37,2010-02-01 10:32:08,2010-04-30 05:07:48,8359
18,82,336,436,"87 days, 18:42:15",2013-02-01 04:53:08,2010-02-01 10:32:08,2010-04-30 05:14:23,1211
237,457,1117,1811,"87 days, 18:54:51",2013-02-06 05:58:54,2010-02-01 10:32:08,2010-04-30 05:26:59,484
1351,4,11,1366,"87 days, 19:11:49",2013-02-04 10:54:10,2010-02-01 10:32:08,2010-04-30 05:43:57,6567
1015,186,790,1991,"87 days, 21:17:35",2013-02-04 00:27:59,2010-02-01 10:32:08,2010-04-30 07:49:43,9261
841,325,551,1717,"87 days, 21:28:14",2013-02-05 08:41:21,2010-02-01 10:32:08,2010-04-30 08:00:22,2913
369,803,1548,2720,"87 days, 23:00:24",2013-02-05 01:54:22,2010-02-01 10:32:08,2010-04-30 09:32:32,9279
1320,850,815,2985,"87 days, 23:17:34",2013-02-03 09:58:56,2010-02-01 10:32:08,2010-04-30 09:49:42,9108
372,243,845,1460,"87 days, 23:21:05",2013-02-06 10:41:18,2010-02-01 10:32:08,2010-04-30 09:53:13,3453
676,7,35,718,"87 days, 23:35:04",2013-02-11 00:52:55,2010-02-01 10:32:08,2010-04-30 10:07:12,8016
382,974,1459,2815,"87 days, 23:37:54",2013-02-04 06:18:10,2010-02-01 10:32:08,2010-04-30 10:10:02,9826
319,67,278,664,"88 days, 0:13:04",2013-01-29 05:55:50,2010-02-01 10:32:08,2010-04-30 10:45:12,8630
718,650,1065,2433,"88 days, 0:24:28",2013-02-04 06:10:19,2010-02-01 10:32:08,2010-04-30 10:56:36,8087
749,46,193,988,"88 days, 1:06:28",2013-02-03 04:15:05,2010-02-01 10:32:08,2010-04-30 11:38:36,301
92,196,243,531,"88 days, 1:25:17",2013-02-04 03:33:19,2010-02-01 10:32:08,2010-04-30 11:57:25,9561
317,0,9,326,"88 days, 2:39:53",2013-01-14 04:19:19,2012-01-24 08:20:37,2012-04-21 11:00:30,7863
372,0,34,406,"88 days, 3:53:21",2013-01-27 09:48:42,2011-02-21 07:16:09,2011-05-20 11:09:30,4771
23,426,429,878,"88 days, 4:17:04",2013-02-13 00:00:42,2010-02-24 03:13:06,2010-05-23 07:30:10,1826
129,5,36,170,"88 days, 10:54:29",2013-02-07 08:11:32,2011-05-20 00:47:28,2011-08-16 11:41:57,2111
33,174,702,909,"88 days, 14:12:02",2013-02-06 05:13:51,2010-02-01 10:32:08,2010-05-01 00:44:10,2092
1371,773,910,3054,"88 days, 14:32:06",2013-02-06 05:53:07,2010-02-01 10:32:08,2010-05-01 01:04:14,7284
144,123,212,479,"88 days, 14:50:58",2013-02-06 11:15:15,2010-02-01 10:32:08,2010-05-01 01:23:06,2886
350,47,258,655,"88 days, 15:20:26",2013-02-03 04:48:49,2010-02-01 10:32:08,2010-05-01 01:52:34,5952
157,310,728,1195,"88 days, 16:00:36",2013-02-04 04:43:56,2010-02-01 10:32:08,2010-05-01 02:32:44,7
1321,0,10,1331,"88 days, 16:01:49",2013-02-05 04:03:10,2010-02-01 10:32:08,2010-05-01 02:33:57,7717
288,554,590,1432,"88 days, 16:02:50",2013-02-05 04:47:31,2010-02-01 10:32:08,2010-05-01 02:34:58,8524
1348,364,527,2239,"88 days, 16:29:19",2013-02-06 02:43:24,2010-02-01 10:32:08,2010-05-01 03:01:27,4775
256,811,1247,2314,"88 days, 16:37:03",2013-02-05 03:11:08,2010-02-01 10:32:08,2010-05-01 03:09:11,4398
677,782,1468,2927,"88 days, 17:31:49",2013-02-06 06:14:56,2010-02-01 10:32:08,2010-05-01 04:03:57,2104
131,427,781,1339,"88 days, 17:55:03",2013-02-03 00:18:53,2010-02-01 10:32:08,2010-05-01 04:27:11,52
1046,205,299,1550,"88 days, 18:15:47",2013-02-03 09:49:06,2010-02-01 10:32:08,2010-05-01 04:47:55,254
63,161,362,586,"88 days, 18:42:48",2013-02-06 07:10:14,2010-02-01 10:32:08,2010-05-01 05:14:56,9650
1140,0,12,1152,"88 days, 18:57:50",2013-01-25 06:50:25,2010-02-01 10:32:08,2010-05-01 05:29:58,1471
9,43,539,591,"88 days, 20:49:24",2013-02-06 11:52:15,2010-02-01 10:32:08,2010-05-01 07:21:32,493
410,39,258,707,"88 days, 20:54:10",2013-02-05 01:27:53,2010-02-01 10:32:08,2010-05-01 07:26:18,5010
1283,331,884,2498,"88 days, 22:54:52",2013-02-07 09:52:59,2010-02-01 10:32:08,2010-05-01 09:27:00,6531
104,12,110,226,"88 days, 23:54:31",2013-01-17 09:19:38,2010-02-01 10:32:08,2010-05-01 10:26:39,9448
301,925,1408,2634,"89 days, 0:39:26",2013-02-05 07:37:14,2010-02-01 10:32:08,2010-05-01 11:11:34,9082
790,763,1855,3408,"89 days, 0:50:10",2013-02-02 10:16:35,2010-02-01 10:32:08,2010-05-01 11:22:18,6689
1879,1415,2348,5642,"89 days, 0:50:59",2013-02-03 11:44:52,2010-02-01 10:32:08,2010-05-01 11:23:07,266
1,283,739,1023,"89 days, 1:06:32",2013-02-07 07:06:59,2010-02-01 10:32:08,2010-05-01 11:38:40,5465
877,237,843,1957,"89 days, 1:12:00",2013-02-03 04:49:09,2010-02-01 10:32:08,2010-05-01 11:44:08,7282
367,0,0,367,"89 days, 13:47:17",2012-12-26 01:39:17,2010-08-12 10:41:09,2010-11-10 00:28:26,3365
47,4208,3756,8011,"89 days, 14:05:48",2013-02-06 01:59:08,2010-02-01 10:32:08,2010-05-02 00:37:56,8170
1125,2693,3699,7517,"89 days, 15:43:36",2013-02-07 10:12:43,2010-02-01 10:32:08,2010-05-02 02:15:44,2909
40,72,235,347,"89 days, 15:55:35",2013-01-31 00:45:07,2010-02-01 10:32:08,2010-05-02 02:27:43,2494
233,65,162,460,"89 days, 16:15:47",2013-02-05 00:03:29,2010-02-01 10:32:08,2010-05-02 02:47:55,5206
583,658,1484,2725,"89 days, 16:29:39",2013-02-06 02:17:37,2010-02-01 10:32:08,2010-05-02 03:01:47,8243
1424,198,287,1909,"89 days, 16:42:44",2013-02-04 00:47:47,2010-02-01 10:32:08,2010-05-02 03:14:52,554
34,234,855,1123,"89 days, 16:44:40",2013-02-06 08:06:21,2010-02-01 10:32:08,2010-05-02 03:16:48,8450
575,520,536,1631,"89 days, 16:56:40",2013-02-02 08:52:57,2010-02-01 10:32:08,2010-05-02 03:28:48,5314
182,10,52,244,"89 days, 16:57:34",2013-02-07 01:46:40,2010-10-24 11:37:55,2011-01-22 04:35:29,2609
15,8,58,81,"89 days, 17:31:51",2013-02-03 01:44:06,2011-11-18 08:30:37,2012-02-16 02:02:28,9961
18,4,76,98,"89 days, 17:41:57",2013-01-21 09:54:48,2010-11-10 09:31:28,2011-02-08 03:13:25,6133
249,111,236,596,"89 days, 18:37:13",2013-02-04 10:23:51,2010-02-01 10:32:08,2010-05-02 05:09:21,5630
241,231,710,1182,"89 days, 19:50:40",2013-02-05 10:15:41,2010-02-01 10:32:08,2010-05-02 06:22:48,8124
55,143,548,746,"89 days, 19:57:52",2013-02-06 06:24:05,2010-02-01 10:32:08,2010-05-02 06:30:00,8723
360,1,45,406,"89 days, 20:16:24",2013-01-17 00:27:22,2010-02-01 10:32:08,2010-05-02 06:48:32,946
1568,259,487,2314,"89 days, 20:46:08",2013-02-03 06:02:20,2010-02-01 10:32:08,2010-05-02 07:18:16,2854
922,134,355,1411,"89 days, 21:12:46",2013-02-05 05:24:32,2010-02-01 10:32:08,2010-05-02 07:44:54,2721
1204,2,37,1243,"89 days, 21:18:04",2013-01-30 01:31:09,2010-02-01 10:32:08,2010-05-02 07:50:12,7057
18,4661,4909,9588,"89 days, 21:27:27",2013-02-07 00:06:57,2010-02-01 10:32:08,2010-05-02 07:59:35,7985
290,66,436,792,"89 days, 21:27:43",2013-02-01 09:12:25,2010-02-01 10:32:08,2010-05-02 07:59:51,4565
402,352,739,1493,"89 days, 21:56:07",2013-02-04 06:32:23,2010-02-01 10:32:08,2010-05-02 08:28:15,7965
121,567,907,1595,"89 days, 22:10:14",2013-02-06 04:13:38,2010-02-01 10:32:08,2010-05-02 08:42:22,1942
973,2,31,1006,"89 days, 22:35:40",2013-02-02 05:48:21,2010-02-01 10:32:08,2010-05-02 09:07:48,6608
476,325,1093,1894,"89 days, 22:44:51",2013-02-05 10:32:19,2010-02-01 10:32:08,2010-05-02 09:16:59,7477
319,160,886,1365,"89 days, 22:53:26",2013-02-04 05:06:32,2010-02-01 10:32:08,2010-05-02 09:25:34,1031
80,1580,1702,3362,"89 days, 23:31:07",2013-02-05 04:46:56,2010-02-01 10:32:08,2010-05-02 10:03:15,4755
5,207,433,645,"89 days, 23:33:49",2013-01-29 09:17:37,2010-02-01 10:32:08,2010-05-02 10:05:57,8521
850,43,194,1087,"90 days, 0:36:05",2013-02-01 04:32:03,2010-02-01 10:32:08,2010-05-02 11:08:13,8690
347,445,607,1399,"90 days, 0:45:54",2013-02-05 00:23:02,2010-02-01 10:32:08,2010-05-02 11:18:02,420
28,65,300,393,"90 days, 0:46:22",2013-02-05 08:18:15,2010-02-01 10:32:08,2010-05-02 11:18:30,7143
27,347,667,1041,"90 days, 1:02:38",2013-02-06 02:21:52,2010-03-22 01:23:59,2010-06-20 02:26:37,1767
352,164,452,968,"90 days, 4:03:41",2013-02-04 09:40:39,2010-04-13 05:40:25,2010-07-12 09:44:06,1059
418,28,139,585,"90 days, 5:12:32",2013-02-04 03:30:00,2010-06-12 01:41:09,2010-09-10 06:53:41,582
176,283,936,1395,"90 days, 13:31:43",2013-02-06 05:11:45,2010-02-01 10:32:08,2010-05-03 00:03:51,5713
1977,716,1475,4168,"90 days, 13:50:06",2013-02-06 04:03:52,2010-02-01 10:32:08,2010-05-03 00:22:14,1883
182,423,491,1096,"90 days, 13:51:27",2013-02-02 01:22:08,2010-02-01 10:32:08,2010-05-03 00:23:35,3742
563,264,363,1190,"90 days, 15:21:13",2013-01-31 08:14:48,2010-02-01 10:32:08,2010-05-03 01:53:21,1253
52,1348,1863,3263,"90 days, 15:24:17",2013-02-06 10:00:17,2010-02-01 10:32:08,2010-05-03 01:56:25,2385
129,357,618,1104,"90 days, 17:42:23",2013-02-01 07:18:57,2010-02-01 10:32:08,2010-05-03 04:14:31,8083
675,615,1252,2542,"90 days, 18:18:23",2013-02-05 02:26:36,2010-02-01 10:32:08,2010-05-03 04:50:31,4661
125,464,900,1489,"90 days, 18:35:11",2013-02-07 03:00:55,2010-02-01 10:32:08,2010-05-03 05:07:19,7517
301,687,1156,2144,"90 days, 20:59:31",2013-02-06 08:49:17,2010-02-01 10:32:08,2010-05-03 07:31:39,1188
271,121,345,737,"90 days, 21:18:08",2013-01-31 05:19:30,2010-02-01 10:32:08,2010-05-03 07:50:16,472
1122,3967,3370,8459,"90 days, 21:32:37",2013-02-07 04:08:46,2010-02-01 10:32:08,2010-05-03 08:04:45,8926
20,0,44,64,"90 days, 22:06:10",2013-01-26 07:21:28,2010-02-01 10:32:08,2010-05-03 08:38:18,8370
886,2,116,1004,"90 days, 22:18:17",2013-02-04 10:25:15,2010-02-01 10:32:08,2010-05-03 08:50:25,6930
64,329,505,898,"90 days, 23:20:59",2013-01-31 05:41:00,2010-02-01 10:32:08,2010-05-03 09:53:07,3740
372,438,1089,1899,"91 days, 0:00:34",2013-02-04 04:40:51,2010-02-01 10:32:08,2010-05-03 10:32:42,5970
818,60,393,1271,"91 days, 1:07:43",2013-01-30 11:15:45,2010-02-01 10:32:08,2010-05-03 11:39:51,1630
8,3,94,105,"91 days, 1:10:26",2013-02-04 07:18:11,2010-02-01 10:32:08,2010-05-03 11:42:34,5609
112,1163,1586,2861,"91 days, 1:50:07",2013-02-21 04:25:36,2010-02-18 04:40:35,2010-05-20 06:30:42,1578
243,1,55,299,"91 days, 3:54:08",2013-01-25 02:44:57,2010-12-08 00:53:54,2011-03-09 04:48:02,4069
484,546,1124,2154,"91 days, 4:12:22",2013-02-05 03:30:05,2010-04-17 00:19:20,2010-07-17 04:31:42,5974
144,140,177,461,"91 days, 7:44:41",2013-02-02 00:22:49,2010-08-28 02:09:07,2010-11-27 09:53:48,3418
1209,230,508,1947,"91 days, 13:29:38",2013-02-05 08:16:30,2010-02-01 10:32:08,2010-05-04 00:01:46,4968
0,173,445,618,"91 days, 13:52:55",2013-01-29 11:10:49,2010-02-01 10:32:08,2010-05-04 00:25:03,7765
862,3166,5645,9673,"91 days, 14:00:43",2013-02-07 10:36:27,2010-02-01 10:32:08,2010-05-04 00:32:51,2749
131,213,1100,1444,"91 days, 14:30:20",2013-02-05 07:17:35,2010-02-01 10:32:08,2010-05-04 01:02:28,9633
747,36,165,948,"91 days, 15:17:34",2013-01-31 06:44:29,2010-02-01 10:32:08,2010-05-04 01:49:42,2062
106,641,1021,1768,"91 days, 15:34:13",2013-02-06 05:57:45,2010-02-01 10:32:08,2010-05-04 02:06:21,1440
44,334,400,778,"91 days, 16:31:29",2013-02-04 08:16:54,2010-02-01 10:32:08,2010-05-04 03:03:37,9708
74,493,1053,1620,"91 days, 17:54:26",2013-02-04 10:49:07,2010-02-01 10:32:08,2010-05-04 04:26:34,1195
140,1437,1995,3572,"91 days, 18:11:22",2013-02-06 05:01:14,2010-02-01 10:32:08,2010-05-04 04:43:30,9978
1369,1075,2099,4543,"91 days, 18:46:50",2013-02-05 10:44:04,2010-02-01 10:32:08,2010-05-04 05:18:58,2941
784,788,1356,2928,"91 days, 19:28:37",2013-02-06 08:10:06,2010-02-01 10:32:08,2010-05-04 06:00:45,83
78,966,1451,2495,"91 days, 19:48:40",2013-02-07 11:45:50,2010-02-01 10:32:08,2010-05-04 06:20:48,578
1133,990,1310,3433,"91 days, 20:45:53",2013-02-03 04:34:38,2010-02-01 10:32:08,2010-05-04 07:18:01,6781
165,86,236,487,"91 days, 21:07:14",2013-02-02 05:49:06,2010-02-01 10:32:08,2010-05-04 07:39:22,637
1298,0,14,1312,"91 days, 21:11:21",2013-01-25 01:17:51,2010-02-01 10:32:08,2010-05-04 07:43:29,6478
765,523,770,2058,"91 days, 21:56:25",2013-02-07 06:23:50,2010-02-01 10:32:08,2010-05-04 08:28:33,7696
530,477,999,2006,"91 days, 22:20:59",2013-02-06 04:32:10,2010-02-01 10:32:08,2010-05-04 08:53:07,2244
343,194,291,828,"91 days, 23:09:18",2013-02-02 06:09:28,2010-02-01 10:32:08,2010-05-04 09:41:26,4079
1203,608,1187,2998,"91 days, 23:21:02",2013-02-06 09:43:25,2010-02-01 10:32:08,2010-05-04 09:53:10,502
772,226,260,1258,"92 days, 0:08:53",2013-02-06 00:49:37,2010-02-01 10:32:08,2010-05-04 10:41:01,8388
1142,1087,1166,3395,"92 days, 0:09:13",2013-02-04 11:54:38,2010-02-01 10:32:08,2010-05-04 10:41:21,5814
33,1,51,85,"92 days, 1:13:43",2013-02-02 08:02:17,2010-06-15 09:26:51,2010-09-15 10:40:34,4302
36,98,66,200,"92 days, 9:19:44",2013-02-06 02:18:49,2010-06-15 02:29:25,2010-09-15 11:49:09,259
965,146,351,1462,"92 days, 13:28:23",2013-01-30 06:37:53,2010-02-01 10:32:08,2010-05-05 00:00:31,1162
1721,1306,1884,4911,"92 days, 14:22:22",2013-02-05 07:19:22,2010-02-01 10:32:08,2010-05-05 00:54:30,4299
88,92,204,384,"92 days, 14:43:31",2013-02-03 07:10:55,2010-02-01 10:32:08,2010-05-05 01:15:39,209
418,215,314,947,"92 days, 15:54:21",2013-02-02 10:44:06,2010-02-01 10:32:08,2010-05-05 02:26:29,672
301,20,107,428,"92 days, 15:55:16",2013-01-21 10:50:28,2010-04-02 08:29:50,2010-07-04 00:25:06,4430
279,1737,2632,4648,"92 days, 16:02:59",2013-02-06 08:35:42,2010-02-01 10:32:08,2010-05-05 02:35:07,6364
175,554,1553,2282,"92 days, 16:05:50",2013-02-05 03:15:37,2010-02-01 10:32:08,2010-05-05 02:37:58,8641
76,2010,2402,4488,"92 days, 16:07:58",2013-02-06 10:54:07,2010-02-01 10:32:08,2010-05-05 02:40:06,5680
317,214,435,966,"92 days, 16:45:19",2013-02-04 02:00:35,2010-02-01 10:32:08,2010-05-05 03:17:27,971
340,192,362,894,"92 days, 17:25:09",2013-02-04 06:51:29,2010-02-01 10:32:08,2010-05-05 03:57:17,8498
12,957,1173,2142,"92 days, 17:45:17",2013-02-02 08:34:56,2010-02-01 10:32:08,2010-05-05 04:17:25,7725
134,448,800,1382,"92 days, 17:51:17",2013-02-02 11:16:05,2010-02-01 10:32:08,2010-05-05 04:23:25,9813
380,24,173,577,"92 days, 18:30:28",2013-02-03 08:25:20,2010-02-01 10:32:08,2010-05-05 05:02:36,758
274,213,329,816,"92 days, 18:43:53",2013-02-07 09:58:16,2010-02-01 10:32:08,2010-05-05 05:16:01,3624
354,399,1036,1789,"92 days, 19:13:23",2013-02-05 10:10:25,2010-02-01 10:32:08,2010-05-05 05:45:31,5050
34,49,138,221,"92 days, 19:29:49",2013-01-24 05:57:24,2010-02-01 10:32:08,2010-05-05 06:01:57,6536
54,496,805,1355,"92 days, 20:24:47",2013-02-05 10:07:39,2010-02-01 10:32:08,2010-05-05 06:56:55,6604
652,274,1003,1929,"92 days, 20:30:44",2013-02-02 07:54:47,2010-02-01 10:32:08,2010-05-05 07:02:52,2684
41,2247,3553,5841,"92 days, 22:45:37",2013-02-11 01:46:48,2010-02-01 10:32:08,2010-05-05 09:17:45,669
100,39,1221,1360,"92 days, 23:59:12",2013-01-29 11:51:51,2010-02-01 10:32:08,2010-05-05 10:31:20,8082
689,964,1540,3193,"93 days, 0:04:03",2013-02-09 01:59:09,2010-02-01 10:32:08,2010-05-05 10:36:11,5087
679,339,582,1600,"93 days, 0:26:33",2013-02-05 06:23:47,2010-02-01 10:32:08,2010-05-05 10:58:41,8566
0,8,69,77,"93 days, 1:15:47",2013-01-30 03:12:47,2012-02-24 07:56:23,2012-05-27 09:12:10,5321
248,12,173,433,"93 days, 13:33:25",2013-01-27 11:34:07,2010-02-01 10:32:08,2010-05-06 00:05:33,5530
902,134,339,1375,"93 days, 14:05:38",2013-02-05 01:24:34,2010-02-01 10:32:08,2010-05-06 00:37:46,2822
899,293,645,1837,"93 days, 14:22:05",2013-02-06 06:03:35,2010-02-01 10:32:08,2010-05-06 00:54:13,6403
527,1313,2145,3985,"93 days, 15:11:02",2013-02-06 11:46:57,2010-02-01 10:32:08,2010-05-06 01:43:10,2899
116,9,41,166,"93 days, 15:26:04",2013-01-29 07:36:50,2011-02-25 09:46:10,2011-05-30 01:12:14,7346
747,4061,5691,10499,"93 days, 15:34:55",2013-02-06 10:29:11,2010-02-01 10:32:08,2010-05-06 02:07:03,2351
284,149,363,796,"93 days, 16:12:39",2013-02-03 11:18:55,2010-02-01 10:32:08,2010-05-06 02:44:47,6444
333,2,39,374,"93 days, 16:52:06",2013-01-07 10:30:33,2010-05-27 08:46:41,2010-08-29 01:38:47,4632
6,294,448,748,"93 days, 17:36:51",2013-02-05 06:24:24,2010-02-01 10:32:08,2010-05-06 04:08:59,9570
977,283,359,1619,"93 days, 17:56:00",2013-02-05 04:01:18,2010-02-01 10:32:08,2010-05-06 04:28:08,7419
394,3633,4596,8623,"93 days, 19:24:41",2013-02-07 04:40:06,2010-02-01 10:32:08,2010-05-06 05:56:49,610
241,379,1068,1688,"93 days, 20:32:38",2013-02-05 10:46:20,2010-02-01 10:32:08,2010-05-06 07:04:46,9020
346,12,134,492,"93 days, 21:03:04",2013-01-31 08:22:23,2010-05-03 05:51:07,2010-08-05 02:54:11,97
775,7,195,977,"93 days, 22:21:54",2013-01-25 02:16:45,2010-02-01 10:32:08,2010-05-06 08:54:02,1920
56,211,291,558,"93 days, 22:43:48",2013-02-01 02:25:12,2010-02-01 10:32:08,2010-05-06 09:15:56,4881
9,228,767,1004,"93 days, 23:20:59",2013-02-07 01:40:06,2010-02-01 10:32:08,2010-05-06 09:53:07,517
3,47,162,212,"94 days, 0:06:46",2013-01-30 09:15:38,2010-02-01 10:32:08,2010-05-06 10:38:54,9865
996,9,55,1060,"94 days, 0:29:15",2013-02-01 10:57:05,2010-08-20 01:15:23,2010-11-22 01:44:38,8385
629,97,451,1177,"94 days, 0:50:56",2013-01-30 03:54:40,2010-02-01 10:32:08,2010-05-06 11:23:04,1508
332,443,946,1721,"94 days, 0:53:07",2013-02-05 10:45:38,2010-02-01 10:32:08,2010-05-06 11:25:15,84
338,2,5,345,"94 days, 5:07:39",2013-01-19 08:02:21,2011-02-12 02:54:24,2011-05-17 08:02:03,2904
889,726,1651,3266,"94 days, 15:15:00",2013-02-07 09:36:59,2010-02-01 10:32:08,2010-05-07 01:47:08,4880
216,44,237,497,"94 days, 15:21:33",2013-01-28 04:31:10,2010-02-01 10:32:08,2010-05-07 01:53:41,7540
208,269,848,1325,"94 days, 16:07:19",2013-02-03 11:08:43,2010-02-01 10:32:08,2010-05-07 02:39:27,4765
109,845,996,1950,"94 days, 16:26:10",2013-02-04 03:31:57,2010-02-01 10:32:08,2010-05-07 02:58:18,8263
608,652,1947,3207,"94 days, 16:46:54",2013-02-07 10:42:05,2010-02-01 10:32:08,2010-05-07 03:19:02,1036
595,128,176,899,"94 days, 17:48:56",2013-02-01 11:23:02,2010-02-01 10:32:08,2010-05-07 04:21:04,3678
73,68,441,582,"94 days, 17:57:40",2013-01-28 07:12:13,2010-02-01 10:32:08,2010-05-07 04:29:48,9292
338,213,336,887,"94 days, 18:36:37",2013-02-03 04:50:10,2010-02-01 10:32:08,2010-05-07 05:08:45,575
25,57,138,220,"94 days, 18:36:53",2013-02-01 01:58:04,2010-02-01 10:32:08,2010-05-07 05:09:01,8650
629,311,522,1462,"94 days, 21:05:59",2013-02-06 04:02:06,2010-02-01 10:32:08,2010-05-07 07:38:07,3995
510,288,630,1428,"94 days, 21:22:27",2013-02-03 09:39:29,2010-02-01 10:32:08,2010-05-07 07:54:35,4673
330,209,168,707,"94 days, 21:46:21",2013-02-06 11:31:31,2010-02-01 10:32:08,2010-05-07 08:18:29,3051
22,392,1197,1611,"94 days, 23:05:46",2013-02-05 11:40:59,2010-02-01 10:32:08,2010-05-07 09:37:54,824
682,45,196,923,"94 days, 23:08:59",2013-02-06 06:02:58,2010-02-01 10:32:08,2010-05-07 09:41:07,6493
1007,207,241,1455,"95 days, 0:23:12",2013-02-01 11:02:54,2010-02-01 10:32:08,2010-05-07 10:55:20,8048
34,35,242,311,"95 days, 0:46:39",2013-02-06 09:53:56,2010-02-01 10:32:08,2010-05-07 11:18:47,8666
900,48,149,1097,"95 days, 0:55:23",2013-01-31 06:16:32,2010-02-01 10:32:08,2010-05-07 11:27:31,3197
1365,33,127,1525,"95 days, 9:59:39",2013-02-03 06:54:36,2010-03-10 01:44:51,2010-06-13 11:44:30,9194
94,1291,1828,3213,"95 days, 14:39:48",2013-02-07 05:13:47,2010-02-01 10:32:08,2010-05-08 01:11:56,9845
789,62,147,998,"95 days, 14:43:37",2013-02-01 00:57:08,2010-02-01 10:32:08,2010-05-08 01:15:45,6681
332,79,347,758,"95 days, 15:09:06",2013-02-02 06:39:29,2010-02-01 10:32:08,2010-05-08 01:41:14,1718
247,449,615,1311,"95 days, 15:46:35",2013-02-06 05:04:50,2010-02-01 10:32:08,2010-05-08 02:18:43,703
944,1,5,950,"95 days, 15:56:34",2013-01-28 07:19:31,2010-02-01 10:32:08,2010-05-08 02:28:42,4287
209,89,276,574,"95 days, 16:48:18",2013-02-03 11:28:42,2010-02-01 10:32:08,2010-05-08 03:20:26,6851
81,425,634,1140,"95 days, 16:56:35",2013-02-02 11:00:11,2010-02-01 10:32:08,2010-05-08 03:28:43,3795
664,280,587,1531,"95 days, 18:05:25",2013-02-06 01:31:33,2010-02-01 10:32:08,2010-05-08 04:37:33,620
143,6234,6820,13197,"95 days, 18:25:20",2013-02-07 04:13:14,2010-02-01 10:32:08,2010-05-08 04:57:28,2614
10,280,295,585,"95 days, 18:38:13",2013-02-03 08:00:22,2010-02-01 10:32:08,2010-05-08 05:10:21,462
188,803,1383,2374,"95 days, 18:57:44",2013-02-05 04:43:37,2010-02-01 10:32:08,2010-05-08 05:29:52,5918
357,555,1271,2183,"95 days, 19:05:02",2013-02-07 09:01:05,2010-02-01 10:32:08,2010-05-08 05:37:10,3964
461,708,1031,2200,"95 days, 19:29:35",2013-02-04 06:33:17,2010-02-01 10:32:08,2010-05-08 06:01:43,7716
519,864,1230,2613,"95 days, 19:35:15",2013-02-06 01:33:21,2010-02-01 10:32:08,2010-05-08 06:07:23,1931
343,737,1301,2381,"95 days, 21:14:49",2013-02-07 00:44:40,2010-02-01 10:32:08,2010-05-08 07:46:57,515
588,720,1474,2782,"95 days, 21:20:34",2013-02-07 10:00:59,2010-02-01 10:32:08,2010-05-08 07:52:42,2673
561,22,173,756,"95 days, 23:17:09",2013-01-30 06:14:28,2010-05-29 01:11:52,2010-09-02 00:29:01,2708
209,185,718,1112,"95 days, 23:25:05",2013-02-04 04:25:38,2010-02-01 10:32:08,2010-05-08 09:57:13,863
1264,85,232,1581,"95 days, 23:53:04",2013-02-03 03:01:51,2010-02-01 10:32:08,2010-05-08 10:25:12,8836
2,74,185,261,"96 days, 0:21:57",2013-01-31 07:57:34,2010-02-01 10:32:08,2010-05-08 10:54:05,9713
291,458,853,1602,"96 days, 0:34:13",2013-02-03 05:22:31,2010-02-01 10:32:08,2010-05-08 11:06:21,4638
7,870,1240,2117,"96 days, 1:21:28",2013-02-07 03:51:13,2010-02-01 10:32:08,2010-05-08 11:53:36,7747
298,8,163,469,"96 days, 4:15:05",2013-02-01 08:13:39,2010-04-17 04:53:11,2010-07-22 09:08:16,2380
85,68,433,586,"96 days, 13:53:35",2013-02-06 01:15:54,2010-02-01 10:32:08,2010-05-09 00:25:43,770
1097,210,454,1761,"96 days, 14:06:27",2013-02-06 05:51:46,2010-02-01 10:32:08,2010-05-09 00:38:35,5091
356,1324,1380,3060,"96 days, 14:50:27",2013-02-06 07:05:45,2010-02-01 10:32:08,2010-05-09 01:22:35,1752
85,11,72,168,"96 days, 15:57:06",2013-02-02 00:06:50,2010-02-01 10:32:08,2010-05-09 02:29:14,1922
1148,132,477,1757,"96 days, 17:04:59",2013-02-04 03:10:39,2010-02-01 10:32:08,2010-05-09 03:37:07,7537
13,171,251,435,"96 days, 19:50:12",2013-01-31 01:50:24,2010-02-01 10:32:08,2010-05-09 06:22:20,7920
438,1421,1733,3592,"96 days, 19:53:41",2013-02-07 07:24:47,2010-02-01 10:32:08,2010-05-09 06:25:49,6156
43,490,933,1466,"96 days, 20:15:57",2013-02-03 02:42:06,2010-02-01 10:32:08,2010-05-09 06:48:05,6629
3,911,1125,2039,"96 days, 20:40:16",2013-02-05 07:35:59,2010-02-01 10:32:08,2010-05-09 07:12:24,2667
117,855,911,1883,"96 days, 21:39:03",2013-02-04 11:40:41,2010-02-01 10:32:08,2010-05-09 08:11:11,6046
1331,365,764,2460,"96 days, 22:16:51",2013-02-04 07:27:09,2010-02-01 10:32:08,2010-05-09 08:48:59,8034
1325,137,607,2069,"96 days, 22:37:06",2013-02-06 00:33:39,2010-02-01 10:32:08,2010-05-09 09:09:14,7249
349,66,512,927,"96 days, 23:48:43",2013-02-03 04:57:55,2010-02-01 10:32:08,2010-05-09 10:20:51,5516
455,382,618,1455,"97 days, 0:47:05",2013-02-05 11:25:19,2010-03-12 11:09:20,2010-06-17 11:56:25,704
252,2,21,275,"97 days, 4:01:00",2013-01-30 04:43:42,2010-09-10 05:26:08,2010-12-16 09:27:08,4499
1086,1,88,1175,"97 days, 14:41:46",2013-01-24 00:52:30,2010-02-01 10:32:08,2010-05-10 01:13:54,7980
1287,598,744,2629,"97 days, 15:13:37",2013-02-05 05:38:53,2010-02-01 10:32:08,2010-05-10 01:45:45,7036
714,204,508,1426,"97 days, 15:36:18",2013-02-04 09:49:30,2010-02-01 10:32:08,2010-05-10 02:08:26,8623
251,2,43,296,"97 days, 15:49:08",2013-01-24 10:37:10,2011-04-08 09:19:55,2011-07-15 01:09:03,2228
374,15,173,562,"97 days, 15:50:44",2013-02-03 07:30:51,2010-02-01 10:32:08,2010-05-10 02:22:52,6988
619,570,709,1898,"97 days, 16:23:16",2013-02-04 10:15:25,2010-02-01 10:32:08,2010-05-10 02:55:24,7723
165,437,822,1424,"97 days, 16:42:20",2013-02-06 08:27:08,2010-02-01 10:32:08,2010-05-10 03:14:28,5921
510,3880,4056,8446,"97 days, 16:49:52",2013-02-07 06:44:32,2010-02-01 10:32:08,2010-05-10 03:22:00,5564
737,506,924,2167,"97 days, 17:32:43",2013-02-07 02:26:58,2010-02-01 10:32:08,2010-05-10 04:04:51,2676
14,3,45,62,"97 days, 17:47:43",2013-01-18 01:48:43,2010-02-01 10:32:08,2010-05-10 04:19:51,3363
42,492,918,1452,"97 days, 18:52:06",2013-02-07 06:49:17,2010-02-01 10:32:08,2010-05-10 05:24:14,4479
279,1,6,286,"97 days, 18:59:46",2013-01-19 06:33:35,2010-04-29 11:57:29,2010-08-05 06:57:15,9726
1597,269,613,2479,"97 days, 19:27:14",2013-02-03 03:56:18,2010-02-01 10:32:08,2010-05-10 05:59:22,7278
526,40,97,663,"97 days, 21:44:23",2013-02-01 02:53:03,2010-06-09 02:31:03,2010-09-15 00:15:26,1778
243,234,836,1313,"97 days, 22:55:21",2013-02-06 10:00:28,2010-02-01 10:32:08,2010-05-10 09:27:29,6107
178,25,95,298,"97 days, 23:04:17",2013-01-30 00:26:23,2010-02-01 10:32:08,2010-05-10 09:36:25,2950
439,698,1008,2145,"97 days, 23:10:08",2013-02-05 06:52:23,2010-02-01 10:32:08,2010-05-10 09:42:16,7836
910,1599,1921,4430,"98 days, 0:09:17",2013-02-07 01:11:54,2010-02-01 10:32:08,2010-05-10 10:41:25,1529
618,217,700,1535,"98 days, 0:13:41",2013-02-03 05:27:58,2010-02-01 10:32:08,2010-05-10 10:45:49,5962
21,37,270,328,"98 days, 0:55:35",2013-02-03 11:35:43,2010-08-25 10:57:33,2010-12-01 11:53:08,4948
156,113,431,700,"98 days, 13:42:39",2013-02-04 01:24:43,2010-02-01 10:32:08,2010-05-11 00:14:47,3936
305,377,506,1188,"98 days, 13:43:07",2013-02-05 11:40:11,2010-02-01 10:32:08,2010-05-11 00:15:15,4308
594,1084,1299,2977,"98 days, 14:44:46",2013-02-07 02:11:32,2010-02-01 10:32:08,2010-05-11 01:16:54,7947
349,261,473,1083,"98 days, 15:10:07",2013-02-02 10:17:47,2010-02-01 10:32:08,2010-05-11 01:42:15,6647
644,719,874,2237,"98 days, 15:40:09",2013-02-07 11:44:35,2010-02-01 10:32:08,2010-05-11 02:12:17,9369
435,368,560,1363,"98 days, 16:32:54",2013-02-06 10:17:12,2010-02-01 10:32:08,2010-05-11 03:05:02,2961
7,76,474,557,"98 days, 16:44:36",2013-02-03 08:51:32,2010-02-01 10:32:08,2010-05-11 03:16:44,2998
2,209,512,723,"98 days, 18:40:16",2013-02-03 08:35:09,2010-02-01 10:32:08,2010-05-11 05:12:24,3351
1091,775,1099,2965,"98 days, 19:06:53",2013-02-03 00:07:33,2010-02-01 10:32:08,2010-05-11 05:39:01,2495
5,133,267,405,"98 days, 19:23:59",2013-02-06 10:40:33,2010-02-01 10:32:08,2010-05-11 05:56:07,679
199,182,498,879,"98 days, 19:28:16",2013-02-06 01:10:40,2010-02-01 10:32:08,2010-05-11 06:00:24,8393
630,267,644,1541,"98 days, 19:40:49",2013-02-04 11:53:39,2010-02-01 10:32:08,2010-05-11 06:12:57,4610
5,1131,1212,2348,"98 days, 19:40:51",2013-02-06 09:46:34,2010-02-01 10:32:08,2010-05-11 06:12:59,1633
186,281,543,1010,"98 days, 19:51:55",2013-02-06 10:43:30,2010-02-01 10:32:08,2010-05-11 06:24:03,4577
689,244,605,1538,"98 days, 20:29:03",2013-02-04 04:47:45,2010-02-01 10:32:08,2010-05-11 07:01:11,8824
177,115,448,740,"98 days, 21:32:45",2013-02-04 01:25:03,2010-02-01 10:32:08,2010-05-11 08:04:53,4142
23,815,1174,2012,"98 days, 22:43:24",2013-02-05 07:19:41,2010-02-01 10:32:08,2010-05-11 09:15:32,2406
350,3,21,374,"98 days, 22:52:36",2013-02-03 02:31:03,2010-02-01 10:32:08,2010-05-11 09:24:44,8618
677,359,920,1956,"98 days, 23:31:44",2013-02-07 04:34:23,2010-02-01 10:32:08,2010-05-11 10:03:52,2010
241,4,116,361,"98 days, 23:43:06",2013-01-23 00:51:30,2010-02-01 10:32:08,2010-05-11 10:15:14,2097
173,292,829,1294,"98 days, 23:51:42",2013-02-05 10:39:44,2010-02-01 10:32:08,2010-05-11 10:23:50,4743
484,287,1191,1962,"99 days, 0:30:22",2013-02-03 06:42:14,2010-02-01 10:32:08,2010-05-11 11:02:30,275
1331,5027,8163,14521,"99 days, 1:09:20",2013-02-07 10:07:14,2010-02-01 10:32:08,2010-05-11 11:41:28,811
708,94,150,952,"99 days, 1:19:55",2013-02-06 07:36:19,2010-02-01 10:32:08,2010-05-11 11:52:03,850
499,428,595,1522,"99 days, 1:26:44",2013-02-05 05:39:49,2010-02-01 10:32:08,2010-05-11 11:58:52,6234
360,1159,1462,2981,"99 days, 14:15:08",2013-02-07 06:56:02,2010-02-01 10:32:08,2010-05-12 00:47:16,3737
822,883,786,2491,"99 days, 15:35:05",2013-02-05 05:17:16,2010-02-01 10:32:08,2010-05-12 02:07:13,6848
12,11,86,109,"99 days, 15:38:30",2013-02-07 11:37:27,2010-02-01 10:32:08,2010-05-12 02:10:38,5118
157,7,30,194,"99 days, 15:38:36",2013-01-27 10:45:41,2010-02-01 10:32:08,2010-05-12 02:10:44,3228
723,306,424,1453,"99 days, 15:39:32",2013-02-01 05:20:37,2010-02-01 10:32:08,2010-05-12 02:11:40,3430
423,1206,1221,2850,"99 days, 16:18:53",2013-02-06 04:28:29,2010-02-01 10:32:08,2010-05-12 02:51:01,3604
163,3,86,252,"99 days, 16:37:03",2013-01-04 02:25:10,2010-02-01 10:32:08,2010-05-12 03:09:11,7387
1185,221,952,2358,"99 days, 16:50:15",2013-02-06 09:47:28,2010-02-01 10:32:08,2010-05-12 03:22:23,3978
53,521,914,1488,"99 days, 17:04:38",2013-02-02 09:24:38,2010-02-01 10:32:08,2010-05-12 03:36:46,6466
304,0,24,328,"99 days, 17:30:37",2013-02-04 05:30:44,2010-02-01 10:32:08,2010-05-12 04:02:45,7697
140,2,78,220,"99 days, 17:46:57",2013-01-28 04:26:42,2010-02-01 10:32:08,2010-05-12 04:19:05,4896
194,761,999,1954,"99 days, 17:52:26",2013-02-02 11:17:10,2010-02-01 10:32:08,2010-05-12 04:24:34,7975
460,750,1145,2355,"99 days, 18:21:06",2013-02-06 03:21:15,2010-02-01 10:32:08,2010-05-12 04:53:14,7219
174,600,819,1593,"99 days, 19:37:01",2013-02-05 05:54:09,2010-02-01 10:32:08,2010-05-12 06:09:09,9098
112,579,1441,2132,"99 days, 19:54:59",2013-02-04 10:19:58,2010-02-01 10:32:08,2010-05-12 06:27:07,3054
513,66,162,741,"99 days, 20:24:48",2013-01-29 08:51:57,2010-02-01 10:32:08,2010-05-12 06:56:56,7969
126,369,729,1224,"99 days, 20:34:49",2013-02-03 10:42:12,2010-02-01 10:32:08,2010-05-12 07:06:57,4733
213,107,435,755,"99 days, 20:58:49",2013-02-05 09:14:38,2010-02-01 10:32:08,2010-05-12 07:30:57,4433
599,9,179,787,"99 days, 23:39:33",2013-02-03 10:43:56,2010-02-01 10:32:08,2010-05-12 10:11:41,2787
657,0,4,661,"99 days, 23:44:38",2013-02-04 07:15:12,2010-02-01 10:32:08,2010-05-12 10:16:46,3211
1164,683,1019,2866,"100 days, 0:36:01",2013-02-06 06:46:00,2010-02-01 10:32:08,2010-05-12 11:08:09,1646
13,0,54,67,"100 days, 3:19:58",2013-02-03 06:06:48,2010-03-27 03:39:22,2010-07-05 06:59:20,9577
221,2,81,304,"100 days, 3:53:33",2013-02-01 10:27:27,2010-10-20 06:02:29,2011-01-28 09:56:02,1988
197,18,274,489,"100 days, 8:15:11",2013-02-05 02:31:11,2010-09-28 02:58:44,2011-01-06 11:13:55,6090
1128,38,79,1245,"100 days, 14:02:23",2013-02-04 08:19:08,2010-02-01 10:32:08,2010-05-13 00:34:31,1324
296,4,42,342,"100 days, 14:22:40",2013-01-26 07:40:57,2010-06-08 10:36:59,2010-09-17 00:59:39,4987
1385,875,1140,3400,"100 days, 15:06:52",2013-02-06 11:46:02,2010-02-01 10:32:08,2010-05-13 01:39:00,3945
129,407,624,1160,"100 days, 15:14:31",2013-02-04 03:24:28,2010-02-01 10:32:08,2010-05-13 01:46:39,7984
234,373,657,1264,"100 days, 15:42:43",2013-02-05 10:24:29,2010-02-01 10:32:08,2010-05-13 02:14:51,1032
326,27,122,475,"100 days, 16:24:59",2013-01-31 01:26:44,2010-02-01 10:32:08,2010-05-13 02:57:07,7196
197,1,44,242,"100 days, 16:42:14",2013-01-29 08:13:38,2010-02-01 10:32:08,2010-05-13 03:14:22,7000
47,320,821,1188,"100 days, 17:05:06",2013-02-05 00:13:08,2010-02-01 10:32:08,2010-05-13 03:37:14,8399
403,1375,1621,3399,"100 days, 18:08:44",2013-02-06 04:45:03,2010-02-01 10:32:08,2010-05-13 04:40:52,3876
822,700,775,2297,"100 days, 19:12:21",2013-02-06 02:36:48,2010-02-01 10:32:08,2010-05-13 05:44:29,3578
1209,0,20,1229,"100 days, 19:21:03",2013-01-30 06:27:27,2010-02-01 10:32:08,2010-05-13 05:53:11,1582
740,3,28,771,"100 days, 20:18:42",2013-01-17 08:45:17,2010-02-01 10:32:08,2010-05-13 06:50:50,49
780,712,1369,2861,"100 days, 20:27:00",2013-02-07 04:50:26,2010-02-01 10:32:08,2010-05-13 06:59:08,6096
12,6,137,155,"100 days, 20:48:47",2013-01-19 11:33:21,2010-02-01 10:32:08,2010-05-13 07:20:55,3076
216,325,762,1303,"100 days, 23:03:54",2013-02-06 07:45:36,2010-02-01 10:32:08,2010-05-13 09:36:02,2520
628,593,788,2009,"100 days, 23:35:11",2013-02-04 03:20:18,2010-02-01 10:32:08,2010-05-13 10:07:19,7946
6,15,162,183,"101 days, 0:50:14",2013-01-24 03:31:25,2010-02-01 10:32:08,2010-05-13 11:22:22,7174
425,7,55,487,"101 days, 2:59:34",2013-01-31 11:54:29,2010-05-11 08:52:27,2010-08-20 11:52:01,5489
386,3,17,406,"101 days, 3:03:07",2013-02-03 10:21:46,2011-12-12 01:29:48,2012-03-22 04:32:55,6394
906,0,29,935,"101 days, 14:31:09",2013-01-29 04:54:24,2010-02-01 10:32:08,2010-05-14 01:03:17,4319
471,652,1209,2332,"101 days, 14:33:42",2013-02-06 10:40:36,2010-02-01 10:32:08,2010-05-14 01:05:50,3787
791,2616,3529,6936,"101 days, 15:02:46",2013-02-06 03:11:44,2010-02-01 10:32:08,2010-05-14 01:34:54,7809
908,1,66,975,"101 days, 16:31:57",2013-02-04 01:40:03,2010-02-01 10:32:08,2010-05-14 03:04:05,7922
291,2,13,306,"101 days, 17:02:43",2013-01-24 00:57:46,2010-02-01 10:32:08,2010-05-14 03:34:51,1326
859,267,1062,2188,"101 days, 17:23:51",2013-02-06 06:40:33,2010-02-01 10:32:08,2010-05-14 03:55:59,3081
704,156,375,1235,"101 days, 17:31:18",2013-02-02 06:51:46,2010-02-01 10:32:08,2010-05-14 04:03:26,9395
1131,587,899,2617,"101 days, 18:03:39",2013-02-06 01:54:27,2010-02-01 10:32:08,2010-05-14 04:35:47,2804
457,770,1329,2556,"101 days, 18:13:36",2013-02-07 03:34:52,2010-02-01 10:32:08,2010-05-14 04:45:44,2101
142,269,475,886,"101 days, 19:47:20",2013-02-03 00:40:13,2010-02-01 10:32:08,2010-05-14 06:19:28,3679
40,445,606,1091,"101 days, 19:48:38",2013-02-03 11:00:10,2010-02-01 10:32:08,2010-05-14 06:20:46,2143
503,350,653,1506,"101 days, 21:27:25",2013-02-04 07:30:49,2010-02-01 10:32:08,2010-05-14 07:59:33,3806
1051,141,602,1794,"101 days, 22:08:17",2013-02-07 09:45:49,2010-02-01 10:32:08,2010-05-14 08:40:25,509
430,259,688,1377,"101 days, 23:12:12",2013-02-06 10:39:22,2010-02-01 10:32:08,2010-05-14 09:44:20,6252
1349,462,1308,3119,"101 days, 23:26:04",2013-02-05 08:43:42,2010-02-01 10:32:08,2010-05-14 09:58:12,5888
273,8,37,318,"101 days, 23:32:16",2013-02-03 05:58:45,2011-04-20 10:15:19,2011-07-31 09:47:35,3077
311,859,864,2034,"101 days, 23:39:58",2013-02-06 01:53:11,2010-02-01 10:32:08,2010-05-14 10:12:06,5434
460,1134,1603,3197,"102 days, 0:22:33",2013-02-04 02:47:58,2010-02-01 10:32:08,2010-05-14 10:54:41,4239
1432,477,1326,3235,"102 days, 0:36:36",2013-02-07 02:11:07,2010-02-01 10:32:08,2010-05-14 11:08:44,7779
879,83,366,1328,"102 days, 1:08:08",2013-02-05 01:49:46,2010-02-01 10:32:08,2010-05-14 11:40:16,7326
73,117,328,518,"102 days, 1:18:05",2013-02-04 07:47:03,2010-02-01 10:32:08,2010-05-14 11:50:13,4745
166,402,1037,1605,"102 days, 14:03:26",2013-02-05 08:33:11,2010-02-01 10:32:08,2010-05-15 00:35:34,3494
3,23,169,195,"102 days, 14:27:11",2013-02-03 04:10:26,2010-02-01 10:32:08,2010-05-15 00:59:19,5582
711,833,820,2364,"102 days, 14:28:59",2013-02-05 07:52:25,2010-02-01 10:32:08,2010-05-15 01:01:07,7783
254,3,108,365,"102 days, 14:43:07",2013-02-03 10:15:15,2010-02-01 10:32:08,2010-05-15 01:15:15,7843
14,218,100,332,"102 days, 14:55:17",2013-02-02 04:50:01,2010-02-01 10:32:08,2010-05-15 01:27:25,5854
133,542,1000,1675,"102 days, 15:00:07",2013-02-06 01:58:22,2010-02-01 10:32:08,2010-05-15 01:32:15,8448
1301,0,0,1301,"102 days, 15:07:46",2013-01-26 10:37:27,2010-02-01 10:32:08,2010-05-15 01:39:54,8712
380,644,1479,2503,"102 days, 15:26:38",2013-02-05 06:07:30,2010-02-01 10:32:08,2010-05-15 01:58:46,2905
317,1713,2635,4665,"102 days, 15:38:33",2013-02-04 10:19:58,2010-02-01 10:32:08,2010-05-15 02:10:41,3582
860,118,398,1376,"102 days, 16:32:29",2013-02-06 01:15:48,2010-02-01 10:32:08,2010-05-15 03:04:37,3636
437,272,364,1073,"102 days, 17:21:52",2013-02-03 08:27:08,2010-02-01 10:32:08,2010-05-15 03:54:00,4530
275,149,391,815,"102 days, 17:38:46",2013-02-06 04:44:49,2010-02-01 10:32:08,2010-05-15 04:10:54,5540
294,240,893,1427,"102 days, 17:40:59",2013-02-06 01:07:34,2010-02-01 10:32:08,2010-05-15 04:13:07,4664
259,4,89,352,"102 days, 17:44:27",2013-01-25 11:17:39,2010-02-01 10:32:08,2010-05-15 04:16:35,7905
324,1,4,329,"102 days, 18:07:12",2013-01-25 03:18:02,2010-02-01 10:32:08,2010-05-15 04:39:20,8567
23,1,15,39,"102 days, 19:10:03",2013-01-28 11:47:09,2010-11-20 05:15:51,2011-03-03 00:25:54,9721
608,0,26,634,"102 days, 19:52:38",2013-01-15 03:43:50,2010-02-01 10:32:08,2010-05-15 06:24:46,6905
5,0,35,40,"102 days, 22:14:55",2013-01-29 03:33:57,2010-02-01 10:32:08,2010-05-15 08:47:03,7442
730,1180,2453,4363,"102 days, 22:55:00",2013-02-06 04:12:24,2010-02-01 10:32:08,2010-05-15 09:27:08,8451
10,668,800,1478,"102 days, 23:27:48",2013-02-06 05:31:10,2010-02-01 10:32:08,2010-05-15 09:59:56,3931
362,0,1,363,"102 days, 23:39:17",2013-01-29 09:54:29,2012-06-06 04:44:34,2012-09-17 04:23:51,187
200,607,785,1592,"103 days, 0:06:05",2013-02-03 07:01:35,2010-02-01 10:32:08,2010-05-15 10:38:13,7428
113,297,913,1323,"103 days, 0:21:27",2013-02-04 09:45:05,2010-02-01 10:32:08,2010-05-15 10:53:35,9744
4,9,44,57,"103 days, 0:43:38",2013-02-05 09:15:32,2011-01-18 03:36:27,2011-05-01 04:20:05,9
15,3,37,55,"103 days, 9:35:45",2013-01-21 04:16:10,2012-02-12 00:37:33,2012-05-25 10:13:18,5196
93,6,52,151,"103 days, 13:13:43",2013-02-01 02:28:07,2011-05-18 11:06:06,2011-08-30 00:19:49,7883
972,0,3,975,"103 days, 13:53:47",2013-01-31 10:08:47,2010-02-01 10:32:08,2010-05-16 00:25:55,7211
1052,78,181,1311,"103 days, 17:25:45",2013-01-28 02:45:22,2010-02-01 10:32:08,2010-05-16 03:57:53,5279
223,1729,2027,3979,"103 days, 17:57:53",2013-02-06 09:28:44,2010-02-01 10:32:08,2010-05-16 04:30:01,9063
231,337,357,925,"103 days, 18:59:19",2013-02-03 09:28:42,2010-02-01 10:32:08,2010-05-16 05:31:27,3991
277,41,259,577,"103 days, 19:42:38",2013-02-04 11:33:47,2010-02-01 10:32:08,2010-05-16 06:14:46,1913
290,58,126,474,"103 days, 20:40:39",2013-01-30 03:37:05,2010-02-01 10:32:08,2010-05-16 07:12:47,3858
1141,146,437,1724,"103 days, 20:42:46",2013-02-03 09:32:45,2010-02-01 10:32:08,2010-05-16 07:14:54,6667
655,0,4,659,"103 days, 20:47:18",2013-02-01 02:13:31,2010-02-01 10:32:08,2010-05-16 07:19:26,1925
342,205,451,998,"103 days, 21:04:04",2013-02-05 01:44:36,2010-02-01 10:32:08,2010-05-16 07:36:12,8403
5,68,335,408,"103 days, 22:35:25",2013-02-01 10:53:49,2010-02-01 10:32:08,2010-05-16 09:07:33,4249
323,2,0,325,"104 days, 6:36:02",2013-01-24 08:48:21,2011-09-06 01:07:00,2011-12-19 07:43:02,9150
42,141,631,814,"104 days, 14:18:40",2013-02-04 05:59:36,2010-02-01 10:32:08,2010-05-17 00:50:48,985
1386,213,398,1997,"104 days, 14:56:44",2013-02-05 07:16:47,2010-02-01 10:32:08,2010-05-17 01:28:52,8936
910,84,275,1269,"104 days, 16:26:50",2013-01-30 01:15:11,2010-02-01 10:32:08,2010-05-17 02:58:58,1303
76,1902,3145,5123,"104 days, 16:54:23",2013-02-05 07:28:50,2010-02-01 10:32:08,2010-05-17 03:26:31,661
1027,618,951,2596,"104 days, 17:28:06",2013-02-07 01:26:36,2010-02-01 10:32:08,2010-05-17 04:00:14,6238
176,38,158,372,"104 days, 18:06:24",2013-02-02 10:54:42,2010-02-01 10:32:08,2010-05-17 04:38:32,4326
12,361,584,957,"104 days, 19:13:57",2013-02-06 03:12:30,2010-02-01 10:32:08,2010-05-17 05:46:05,6742
271,139,362,772,"104 days, 19:45:56",2013-02-07 01:01:07,2010-02-01 10:32:08,2010-05-17 06:18:04,3443
384,81,345,810,"104 days, 20:37:40",2013-02-02 03:06:33,2010-02-01 10:32:08,2010-05-17 07:09:48,1282
390,163,579,1132,"104 days, 22:17:52",2013-02-02 06:46:03,2010-02-01 10:32:08,2010-05-17 08:50:00,8802
920,116,842,1878,"104 days, 22:56:37",2013-02-04 11:26:35,2010-02-01 10:32:08,2010-05-17 09:28:45,6319
895,1742,3112,5749,"104 days, 23:18:16",2013-02-06 08:36:53,2010-02-01 10:32:08,2010-05-17 09:50:24,8671
1067,8,31,1106,"105 days, 3:57:24",2013-01-31 09:17:06,2010-03-28 00:55:01,2010-07-11 04:52:25,6015
672,7,238,917,"105 days, 14:22:20",2013-02-05 11:07:15,2010-02-01 10:32:08,2010-05-18 00:54:28,7805
333,373,584,1290,"105 days, 14:28:26",2013-02-04 06:47:28,2010-02-01 10:32:08,2010-05-18 01:00:34,4251
253,488,1215,1956,"105 days, 16:47:04",2013-02-06 11:43:28,2010-02-01 10:32:08,2010-05-18 03:19:12,4829
339,165,404,908,"105 days, 21:15:52",2013-02-06 07:49:57,2010-02-01 10:32:08,2010-05-18 07:48:00,5490
2,95,301,398,"106 days, 0:49:41",2013-02-05 03:16:04,2010-02-01 10:32:08,2010-05-18 11:21:49,2716
59,168,522,749,"106 days, 15:43:11",2013-02-04 11:42:09,2010-02-01 10:32:08,2010-05-19 02:15:19,9164
6,43,254,303,"106 days, 16:25:08",2013-02-03 08:37:15,2010-02-01 10:32:08,2010-05-19 02:57:16,496
494,356,475,1325,"106 days, 17:15:51",2013-02-06 03:44:24,2010-02-01 10:32:08,2010-05-19 03:47:59,6895
94,36,267,397,"106 days, 17:51:52",2013-02-01 08:44:50,2010-02-01 10:32:08,2010-05-19 04:24:00,1090
1163,176,482,1821,"106 days, 18:12:10",2013-02-05 05:01:56,2010-02-01 10:32:08,2010-05-19 04:44:18,3029
1032,2,1,1035,"106 days, 18:35:15",2013-02-03 10:02:59,2010-02-01 10:32:08,2010-05-19 05:07:23,4097
699,76,150,925,"106 days, 18:44:29",2013-02-10 05:41:24,2010-02-01 10:32:08,2010-05-19 05:16:37,1874
980,53,95,1128,"106 days, 19:25:38",2013-02-03 11:51:11,2010-02-01 10:32:08,2010-05-19 05:57:46,9887
20,415,1577,2012,"106 days, 19:44:48",2013-02-06 01:02:58,2010-02-01 10:32:08,2010-05-19 06:16:56,7190
238,204,570,1012,"106 days, 19:57:20",2013-02-06 01:17:19,2010-02-01 10:32:08,2010-05-19 06:29:28,8294
720,1104,1469,3293,"106 days, 20:18:11",2013-02-07 03:33:32,2010-02-01 10:32:08,2010-05-19 06:50:19,5639
665,43,143,851,"106 days, 20:24:31",2013-02-05 06:49:13,2010-02-01 10:32:08,2010-05-19 06:56:39,1056
1405,46,231,1682,"106 days, 21:33:48",2013-02-03 03:34:30,2010-02-01 10:32:08,2010-05-19 08:05:56,2767
703,166,292,1161,"106 days, 21:46:01",2013-02-07 06:00:32,2010-02-01 10:32:08,2010-05-19 08:18:09,9435
1205,3,5,1213,"106 days, 22:15:40",2013-01-25 10:45:16,2010-02-01 10:32:08,2010-05-19 08:47:48,9540
493,2152,4456,7101,"106 days, 22:50:42",2013-02-07 04:45:44,2010-02-01 10:32:08,2010-05-19 09:22:50,5497
413,0,22,435,"107 days, 1:07:17",2013-01-28 11:53:01,2010-02-01 10:32:08,2010-05-19 11:39:25,3377
344,315,582,1241,"107 days, 14:56:42",2013-02-05 04:11:58,2010-02-01 10:32:08,2010-05-20 01:28:50,1180
867,109,518,1494,"107 days, 15:18:31",2013-02-07 00:44:30,2010-02-01 10:32:08,2010-05-20 01:50:39,4502
627,71,184,882,"107 days, 15:37:58",2013-01-30 05:51:48,2010-02-01 10:32:08,2010-05-20 02:10:06,2383
544,574,1212,2330,"107 days, 15:45:59",2013-02-05 11:41:43,2010-02-01 10:32:08,2010-05-20 02:18:07,4124
74,6,75,155,"107 days, 15:46:59",2013-01-31 01:57:37,2010-02-01 10:32:08,2010-05-20 02:19:07,1332
29,109,134,272,"107 days, 15:55:32",2013-01-30 02:03:37,2010-02-01 10:32:08,2010-05-20 02:27:40,1598
179,338,1586,2103,"107 days, 17:28:23",2013-02-07 00:57:00,2010-02-01 10:32:08,2010-05-20 04:00:31,6530
134,620,838,1592,"107 days, 19:54:27",2013-02-06 03:18:39,2010-02-01 10:32:08,2010-05-20 06:26:35,6244
29,121,183,333,"107 days, 20:16:11",2013-02-04 01:02:25,2010-02-01 10:32:08,2010-05-20 06:48:19,6218
484,103,131,718,"107 days, 20:19:31",2013-02-02 03:15:34,2010-02-01 10:32:08,2010-05-20 06:51:39,5897
35,204,526,765,"107 days, 20:29:44",2013-02-05 06:07:33,2010-02-01 10:32:08,2010-05-20 07:01:52,4759
2,486,939,1427,"107 days, 20:38:11",2013-02-04 10:13:07,2010-02-01 10:32:08,2010-05-20 07:10:19,5886
1311,0,10,1321,"107 days, 21:30:08",2013-01-29 06:04:53,2010-02-01 10:32:08,2010-05-20 08:02:16,5679
361,1,35,397,"108 days, 0:06:04",2013-01-31 02:41:17,2012-01-24 09:52:21,2012-05-11 09:58:25,1190
214,7,196,417,"108 days, 1:24:23",2013-01-30 05:29:44,2010-02-01 10:32:08,2010-05-20 11:56:31,9894
847,1600,2186,4633,"108 days, 13:48:26",2013-02-06 10:28:05,2010-02-01 10:32:08,2010-05-21 00:20:34,4234
69,0,100,169,"108 days, 14:26:26",2013-02-01 00:56:47,2010-02-01 10:32:08,2010-05-21 00:58:34,128
381,0,33,414,"108 days, 16:37:06",2013-01-27 07:12:30,2010-02-01 10:32:08,2010-05-21 03:09:14,8863
3,3,33,39,"108 days, 17:13:25",2012-12-20 01:50:17,2011-01-12 07:52:35,2011-05-01 01:06:00,4007
728,146,300,1174,"108 days, 18:48:36",2013-02-02 03:19:59,2010-02-01 10:32:08,2010-05-21 05:20:44,7526
1318,1186,1530,4034,"108 days, 19:05:54",2013-02-06 02:46:39,2010-02-01 10:32:08,2010-05-21 05:38:02,5859
0,394,475,869,"108 days, 20:23:11",2013-02-03 06:12:56,2010-02-01 10:32:08,2010-05-21 06:55:19,7778
99,353,860,1312,"108 days, 21:23:32",2013-02-05 08:08:58,2010-02-01 10:32:08,2010-05-21 07:55:40,5499
650,314,282,1246,"108 days, 21:40:50",2013-02-02 00:11:43,2010-02-01 10:32:08,2010-05-21 08:12:58,1610
741,77,272,1090,"108 days, 21:54:19",2013-02-06 11:19:55,2010-02-01 10:32:08,2010-05-21 08:26:27,6357
965,80,442,1487,"108 days, 22:29:57",2013-02-06 03:33:43,2010-02-01 10:32:08,2010-05-21 09:02:05,9014
867,3,118,988,"108 days, 22:34:35",2013-02-04 04:13:06,2010-02-01 10:32:08,2010-05-21 09:06:43,1851
440,114,400,954,"108 days, 22:44:26",2013-01-31 08:00:32,2010-04-09 04:00:22,2010-07-27 02:44:48,337
271,644,1331,2246,"108 days, 23:16:32",2013-02-04 06:56:59,2010-02-01 10:32:08,2010-05-21 09:48:40,4148
281,759,998,2038,"109 days, 1:12:51",2013-02-04 00:45:38,2010-02-01 10:32:08,2010-05-21 11:44:59,7881
5,413,466,884,"109 days, 15:03:56",2013-02-05 11:20:17,2010-02-01 10:32:08,2010-05-22 01:36:04,8823
333,138,184,655,"109 days, 15:45:08",2013-01-26 09:07:42,2010-02-01 10:32:08,2010-05-22 02:17:16,8829
136,15,179,330,"109 days, 17:58:22",2013-02-04 01:30:52,2010-02-01 10:32:08,2010-05-22 04:30:30,8226
381,249,363,993,"109 days, 17:59:09",2013-02-04 00:54:55,2010-02-01 10:32:08,2010-05-22 04:31:17,4484
55,2,106,163,"109 days, 19:05:13",2013-01-29 09:24:00,2010-02-01 10:32:08,2010-05-22 05:37:21,3696
538,272,639,1449,"109 days, 20:33:13",2013-02-07 02:44:56,2010-02-01 10:32:08,2010-05-22 07:05:21,1128
236,682,2042,2960,"109 days, 21:19:50",2013-02-06 07:14:28,2010-02-01 10:32:08,2010-05-22 07:51:58,991
102,377,613,1092,"109 days, 22:14:58",2013-02-04 11:00:20,2010-02-01 10:32:08,2010-05-22 08:47:06,360
439,302,567,1308,"109 days, 22:31:32",2013-02-01 09:21:22,2010-02-01 10:32:08,2010-05-22 09:03:40,4480
46,137,350,533,"109 days, 22:47:23",2013-02-04 05:20:10,2010-02-01 10:32:08,2010-05-22 09:19:31,7709
521,690,1919,3130,"109 days, 23:01:23",2013-02-06 07:54:32,2010-02-01 10:32:08,2010-05-22 09:33:31,3916
48,285,382,715,"109 days, 23:11:37",2013-02-03 01:23:30,2010-02-01 10:32:08,2010-05-22 09:43:45,8867
77,41,203,321,"110 days, 0:22:08",2013-02-03 07:24:06,2010-04-26 04:41:22,2010-08-14 05:03:30,5181
109,25,303,437,"110 days, 0:33:46",2013-02-02 01:20:04,2010-02-01 10:32:08,2010-05-22 11:05:54,8545
885,4,29,918,"110 days, 1:22:05",2013-01-27 08:24:40,2010-02-01 10:32:08,2010-05-22 11:54:13,3811
314,0,28,342,"110 days, 5:18:03",2012-12-16 00:06:46,2010-07-05 05:15:30,2010-10-23 10:33:33,1416
437,3,12,452,"110 days, 9:19:32",2013-01-30 00:43:24,2010-03-26 00:13:00,2010-07-14 09:32:32,256
244,35,134,413,"110 days, 13:53:24",2013-01-30 04:43:25,2010-02-01 10:32:08,2010-05-23 00:25:32,4313
385,12,61,458,"110 days, 15:03:23",2013-01-29 07:21:51,2010-11-06 10:58:46,2011-02-25 02:02:09,3369
1431,736,1489,3656,"110 days, 16:09:42",2013-02-06 03:44:22,2010-02-01 10:32:08,2010-05-23 02:41:50,5812
246,85,326,657,"110 days, 16:30:39",2013-02-06 09:02:06,2010-02-01 10:32:08,2010-05-23 03:02:47,5167
1697,3733,4496,9926,"110 days, 18:21:33",2013-02-07 03:26:35,2010-02-01 10:32:08,2010-05-23 04:53:41,1412
831,324,383,1538,"110 days, 18:23:39",2013-01-30 04:36:01,2010-02-01 10:32:08,2010-05-23 04:55:47,6625
520,917,925,2362,"110 days, 19:18:04",2013-02-04 01:30:58,2010-02-01 10:32:08,2010-05-23 05:50:12,1264
736,4,36,776,"110 days, 20:14:16",2013-02-02 04:42:01,2010-02-01 10:32:08,2010-05-23 06:46:24,3316
448,523,959,1930,"110 days, 21:24:34",2013-02-18 02:11:06,2010-02-01 10:32:08,2010-05-23 07:56:42,6117
76,121,202,399,"110 days, 22:32:33",2013-02-03 08:35:30,2010-02-01 10:32:08,2010-05-23 09:04:41,2670
373,1,109,483,"110 days, 22:34:41",2013-02-03 02:44:18,2010-02-01 10:32:08,2010-05-23 09:06:49,7508
581,1058,1877,3516,"110 days, 22:47:05",2013-02-04 08:12:45,2010-02-01 10:32:08,2010-05-23 09:19:13,5632
663,1236,2030,3929,"110 days, 23:03:41",2013-02-05 05:12:22,2010-02-01 10:32:08,2010-05-23 09:35:49,943
17,161,306,484,"110 days, 23:15:43",2013-02-05 01:23:37,2010-02-01 10:32:08,2010-05-23 09:47:51,4188
423,4,45,472,"110 days, 23:32:14",2013-01-30 09:27:16,2010-03-28 03:53:14,2010-07-17 03:25:28,9452
721,289,552,1562,"110 days, 23:32:33",2013-02-04 02:55:08,2010-02-01 10:32:08,2010-05-23 10:04:41,4307
361,66,123,550,"111 days, 1:08:49",2013-01-27 00:25:59,2010-12-06 05:03:55,2011-03-27 06:12:44,3320
74,332,1010,1416,"111 days, 14:01:27",2013-02-07 07:21:41,2010-02-01 10:32:08,2010-05-24 00:33:35,6443
428,218,295,941,"111 days, 14:56:37",2013-02-01 09:33:21,2010-02-01 10:32:08,2010-05-24 01:28:45,8780
6,1004,1779,2789,"111 days, 17:29:23",2013-02-05 10:13:43,2010-02-01 10:32:08,2010-05-24 04:01:31,4797
7,336,592,935,"111 days, 18:26:41",2013-02-04 11:31:53,2010-02-01 10:32:08,2010-05-24 04:58:49,4913
206,619,1069,1894,"111 days, 18:45:18",2013-02-06 05:34:00,2010-02-01 10:32:08,2010-05-24 05:17:26,2582
503,5,28,536,"111 days, 19:05:15",2013-01-19 10:25:41,2010-02-01 10:32:08,2010-05-24 05:37:23,5425
965,105,228,1298,"111 days, 19:35:16",2013-01-31 08:38:19,2010-02-01 10:32:08,2010-05-24 06:07:24,7994
294,1978,2358,4630,"111 days, 21:40:12",2013-02-05 08:10:00,2010-02-01 10:32:08,2010-05-24 08:12:20,4048
427,965,2223,3615,"111 days, 21:54:41",2013-02-06 11:58:55,2010-02-01 10:32:08,2010-05-24 08:26:49,2134
1031,74,348,1453,"111 days, 22:47:26",2013-02-04 02:37:11,2010-02-01 10:32:08,2010-05-24 09:19:34,3726
33,265,287,585,"111 days, 23:49:11",2013-02-04 10:53:45,2010-02-01 10:32:08,2010-05-24 10:21:19,555
156,120,360,636,"112 days, 0:13:48",2013-02-02 08:05:38,2010-02-01 10:32:08,2010-05-24 10:45:56,6126
341,687,1102,2130,"112 days, 0:49:33",2013-02-03 11:08:01,2010-02-01 10:32:08,2010-05-24 11:21:41,8939
362,1,26,389,"112 days, 6:26:28",2013-01-29 04:07:59,2011-02-10 01:24:36,2011-06-02 07:51:04,5411
446,2,62,510,"112 days, 7:05:59",2013-01-26 02:00:13,2011-11-19 02:51:40,2012-03-10 09:57:39,6980
39,933,2693,3665,"112 days, 15:00:26",2013-02-05 10:10:00,2010-02-01 10:32:08,2010-05-25 01:32:34,1532
1326,1,8,1335,"112 days, 15:00:55",2013-01-31 04:39:24,2010-02-01 10:32:08,2010-05-25 01:33:03,5494
41,1000,1508,2549,"112 days, 15:46:48",2013-02-05 06:58:44,2010-02-01 10:32:08,2010-05-25 02:18:56,8014
699,2,202,903,"112 days, 17:03:39",2013-01-28 07:15:48,2010-02-01 10:32:08,2010-05-25 03:35:47,4149
337,0,0,337,"112 days, 17:26:24",2012-11-09 11:59:16,2012-11-09 11:59:16,2013-03-02 05:25:40,8821
19,235,693,947,"112 days, 19:19:23",2013-02-03 11:59:17,2010-02-01 10:32:08,2010-05-25 05:51:31,6675
2,634,663,1299,"112 days, 19:29:14",2013-02-02 09:18:38,2010-02-01 10:32:08,2010-05-25 06:01:22,8817
427,364,850,1641,"112 days, 19:55:09",2013-02-07 04:33:14,2010-02-01 10:32:08,2010-05-25 06:27:17,1233
856,230,409,1495,"112 days, 20:00:01",2013-02-04 03:07:06,2010-02-01 10:32:08,2010-05-25 06:32:09,3907
272,165,208,645,"112 days, 21:13:30",2013-01-30 05:11:26,2010-02-01 10:32:08,2010-05-25 07:45:38,4911
1057,190,471,1718,"112 days, 23:09:27",2013-02-04 06:42:19,2010-02-01 10:32:08,2010-05-25 09:41:35,6931
119,2103,1990,4212,"112 days, 23:33:26",2013-02-04 02:28:10,2010-02-01 10:32:08,2010-05-25 10:05:34,6369
643,1759,2482,4884,"112 days, 23:42:46",2013-02-05 05:15:53,2010-02-01 10:32:08,2010-05-25 10:14:54,438
18,493,1075,1586,"112 days, 23:46:15",2013-02-06 01:04:28,2010-02-01 10:32:08,2010-05-25 10:18:23,8828
311,1,0,312,"113 days, 0:06:08",2013-01-25 03:02:34,2012-08-28 06:40:02,2012-12-19 06:46:10,5533
1171,259,1037,2467,"113 days, 0:19:29",2013-02-06 02:05:18,2010-02-01 10:32:08,2010-05-25 10:51:37,9049
441,2,86,529,"113 days, 0:28:38",2013-02-04 10:40:33,2010-02-01 10:32:08,2010-05-25 11:00:46,2220
317,140,534,991,"113 days, 13:41:01",2013-02-05 07:42:37,2010-02-01 10:32:08,2010-05-26 00:13:09,6189
95,213,522,830,"113 days, 15:59:01",2013-02-05 00:19:22,2010-02-01 10:32:08,2010-05-26 02:31:09,4908
4,16,52,72,"113 days, 17:22:31",2013-02-04 09:54:35,2012-02-25 09:24:58,2012-06-18 02:47:29,2330
718,465,700,1883,"113 days, 17:54:22",2013-02-04 11:08:08,2010-02-01 10:32:08,2010-05-26 04:26:30,3912
546,242,715,1503,"113 days, 20:40:56",2013-02-04 00:15:49,2010-02-01 10:32:08,2010-05-26 07:13:04,8017
315,9,28,352,"113 days, 20:46:11",2013-01-31 10:07:26,2012-02-12 04:29:33,2012-06-05 01:15:44,3333
46,445,911,1402,"113 days, 22:44:44",2013-02-05 04:53:11,2010-02-01 10:32:08,2010-05-26 09:16:52,1117
859,26,100,985,"114 days, 0:18:20",2013-02-07 01:10:59,2010-02-01 10:32:08,2010-05-26 10:50:28,4985
112,9,92,213,"114 days, 0:19:34",2013-01-01 02:16:58,2010-02-01 10:32:08,2010-05-26 10:51:42,9303
88,223,540,851,"114 days, 0:19:43",2013-02-07 00:56:33,2010-02-01 10:32:08,2010-05-26 10:51:51,7128
11,44,170,225,"114 days, 3:50:19",2013-02-01 03:32:26,2010-03-27 00:24:48,2010-07-19 04:15:07,7266
1344,1246,2707,5297,"114 days, 13:57:01",2013-02-07 07:27:08,2010-02-01 10:32:08,2010-05-27 00:29:09,4291
811,326,710,1847,"114 days, 13:57:30",2013-02-06 02:16:47,2010-02-01 10:32:08,2010-05-27 00:29:38,1769
8,1,55,64,"114 days, 14:00:20",2013-01-30 08:17:57,2010-02-01 10:32:08,2010-05-27 00:32:28,7162
165,329,557,1051,"114 days, 15:15:35",2013-02-06 07:22:40,2010-02-01 10:32:08,2010-05-27 01:47:43,6557
298,4,51,353,"114 days, 15:58:46",2013-01-27 00:19:56,2010-02-01 10:32:08,2010-05-27 02:30:54,6176
1022,86,271,1379,"114 days, 15:58:58",2013-02-04 10:23:05,2010-02-01 10:32:08,2010-05-27 02:31:06,8616
632,2,70,704,"114 days, 16:11:54",2013-01-31 00:25:39,2010-02-01 10:32:08,2010-05-27 02:44:02,937
1419,5887,6089,13395,"114 days, 16:12:39",2013-02-07 07:13:40,2010-02-01 10:32:08,2010-05-27 02:44:47,4602
327,99,274,700,"114 days, 16:54:06",2013-02-02 00:36:33,2010-02-01 10:32:08,2010-05-27 03:26:14,1140
453,1191,1888,3532,"114 days, 17:10:40",2013-02-06 10:20:15,2010-02-01 10:32:08,2010-05-27 03:42:48,9957
8,387,583,978,"114 days, 17:46:22",2013-02-03 04:44:24,2010-02-01 10:32:08,2010-05-27 04:18:30,3701
140,149,117,406,"114 days, 18:22:51",2013-01-30 10:01:10,2010-02-01 10:32:08,2010-05-27 04:54:59,9836
28,15,31,74,"114 days, 18:47:45",2013-02-05 01:12:59,2011-05-12 08:59:57,2011-09-04 03:47:42,9238
571,224,366,1161,"114 days, 19:01:57",2013-02-01 09:08:58,2010-02-01 10:32:08,2010-05-27 05:34:05,743
225,1237,1609,3071,"114 days, 20:38:12",2013-02-06 04:52:48,2010-02-01 10:32:08,2010-05-27 07:10:20,2508
217,444,935,1596,"114 days, 21:43:49",2013-02-17 11:31:02,2010-02-01 10:32:08,2010-05-27 08:15:57,6910
210,250,496,956,"114 days, 22:03:12",2013-01-31 08:56:21,2010-04-23 05:59:31,2010-08-16 04:02:43,9538
1345,428,1440,3213,"114 days, 22:52:48",2013-02-04 11:03:01,2010-02-01 10:32:08,2010-05-27 09:24:56,4037
54,165,287,506,"114 days, 23:07:55",2013-02-03 05:34:37,2010-02-01 10:32:08,2010-05-27 09:40:03,4694
705,142,531,1378,"114 days, 23:56:31",2013-02-04 04:41:03,2010-02-01 10:32:08,2010-05-27 10:28:39,2212
18,1178,1432,2628,"115 days, 14:45:40",2013-02-05 05:43:22,2010-02-01 10:32:08,2010-05-28 01:17:48,727
712,167,292,1171,"115 days, 15:48:53",2013-02-03 08:58:06,2010-02-01 10:32:08,2010-05-28 02:21:01,8141
553,2368,2467,5388,"115 days, 16:05:19",2013-02-05 08:47:51,2010-02-01 10:32:08,2010-05-28 02:37:27,7061
107,456,1441,2004,"115 days, 16:38:15",2013-02-04 10:29:04,2010-02-01 10:32:08,2010-05-28 03:10:23,6703
916,3,105,1024,"115 days, 17:57:28",2013-01-29 07:16:34,2010-02-01 10:32:08,2010-05-28 04:29:36,9573
144,1048,1337,2529,"115 days, 18:34:16",2013-02-06 00:06:42,2010-02-01 10:32:08,2010-05-28 05:06:24,7115
624,537,1164,2325,"115 days, 19:06:05",2013-02-05 00:56:36,2010-02-01 10:32:08,2010-05-28 05:38:13,6298
1003,1,21,1025,"115 days, 21:49:21",2013-01-31 05:48:57,2010-02-01 10:32:08,2010-05-28 08:21:29,1836
60,269,624,953,"116 days, 18:18:57",2013-02-05 08:03:12,2010-02-01 10:32:08,2010-05-29 04:51:05,9526
161,314,496,971,"116 days, 18:55:17",2013-02-03 10:11:02,2010-02-01 10:32:08,2010-05-29 05:27:25,6753
476,1162,1458,3096,"116 days, 19:06:34",2013-02-06 11:34:06,2010-02-01 10:32:08,2010-05-29 05:38:42,8875
221,115,243,579,"116 days, 20:14:08",2013-02-04 01:27:27,2010-02-01 10:32:08,2010-05-29 06:46:16,4047
320,19,143,482,"116 days, 21:47:47",2013-02-05 06:41:44,2010-09-10 11:20:51,2011-01-05 09:08:38,1153
307,1105,2286,3698,"116 days, 22:01:09",2013-02-05 02:58:58,2010-02-01 10:32:08,2010-05-29 08:33:17,3356
1323,497,1219,3039,"116 days, 23:19:05",2013-02-05 10:31:51,2010-02-01 10:32:08,2010-05-29 09:51:13,2277
411,247,308,966,"116 days, 23:20:59",2013-02-01 02:38:09,2010-02-01 10:32:08,2010-05-29 09:53:07,5203
426,472,756,1654,"116 days, 23:56:10",2013-02-06 07:10:30,2010-02-01 10:32:08,2010-05-29 10:28:18,1405
266,653,1006,1925,"117 days, 0:13:10",2013-02-07 08:15:38,2010-03-21 09:41:25,2010-07-16 09:54:35,506
304,272,371,947,"117 days, 0:48:28",2013-02-05 09:35:52,2010-02-01 10:32:08,2010-05-29 11:20:36,4060
371,2,19,392,"117 days, 14:55:40",2013-01-27 10:00:16,2010-02-01 10:32:08,2010-05-30 01:27:48,8362
1326,288,711,2325,"117 days, 15:08:53",2013-02-03 05:57:40,2010-02-01 10:32:08,2010-05-30 01:41:01,2040
1156,393,440,1989,"117 days, 15:46:20",2013-02-03 11:47:46,2010-02-01 10:32:08,2010-05-30 02:18:28,8188
91,284,1072,1447,"117 days, 17:22:53",2013-02-04 02:21:07,2010-02-01 10:32:08,2010-05-30 03:55:01,771
347,172,256,775,"117 days, 17:50:51",2013-01-29 08:32:21,2010-02-01 10:32:08,2010-05-30 04:22:59,6188
451,5,75,531,"117 days, 18:13:32",2013-02-03 06:03:38,2010-02-01 10:32:08,2010-05-30 04:45:40,445
494,1102,1537,3133,"117 days, 19:07:47",2013-02-06 06:32:05,2010-02-01 10:32:08,2010-05-30 05:39:55,3715
536,33,371,940,"117 days, 19:17:04",2013-02-06 07:58:07,2010-02-01 10:32:08,2010-05-30 05:49:12,1766
997,316,478,1791,"117 days, 23:03:32",2013-02-07 08:13:46,2010-02-01 10:32:08,2010-05-30 09:35:40,6802
665,50,181,896,"117 days, 23:05:54",2013-01-30 07:15:46,2010-04-09 04:25:19,2010-08-05 03:31:13,2897
18,0,60,78,"118 days, 0:14:42",2013-01-11 08:30:05,2010-02-01 10:32:08,2010-05-30 10:46:50,8777
760,63,511,1334,"118 days, 0:20:00",2013-02-04 01:39:42,2010-02-01 10:32:08,2010-05-30 10:52:08,2114
1167,12,127,1306,"118 days, 0:39:37",2013-02-02 07:55:06,2010-02-01 10:32:08,2010-05-30 11:11:45,7560
133,252,557,942,"118 days, 0:41:04",2013-02-07 01:38:17,2010-02-01 10:32:08,2010-05-30 11:13:12,1542
572,196,729,1497,"118 days, 1:04:38",2013-02-07 05:28:24,2010-02-01 10:32:08,2010-05-30 11:36:46,5468
318,1,2,321,"118 days, 1:09:46",2013-01-28 01:44:26,2010-02-01 10:32:08,2010-05-30 11:41:54,5990
62,609,1004,1675,"118 days, 1:16:48",2013-02-04 00:28:26,2010-02-01 10:32:08,2010-05-30 11:48:56,571
209,690,1187,2086,"118 days, 13:29:14",2013-02-05 11:04:22,2010-02-01 10:32:08,2010-05-31 00:01:22,2549
1,3,64,68,"118 days, 13:29:57",2013-01-26 04:17:01,2010-02-01 10:32:08,2010-05-31 00:02:05,7446
176,119,332,627,"118 days, 13:32:08",2013-02-01 03:21:34,2010-02-01 10:32:08,2010-05-31 00:04:16,2870
58,67,194,319,"118 days, 13:51:24",2013-02-03 02:25:24,2010-02-01 10:32:08,2010-05-31 00:23:32,6371
19,73,263,355,"118 days, 14:02:40",2013-02-05 03:05:05,2010-02-01 10:32:08,2010-05-31 00:34:48,2910
830,1,74,905,"118 days, 14:07:08",2013-02-01 02:09:55,2010-02-01 10:32:08,2010-05-31 00:39:16,6892
630,10,97,737,"118 days, 14:16:26",2013-02-01 09:46:03,2010-02-01 10:32:08,2010-05-31 00:48:34,6989
1147,1666,2326,5139,"118 days, 14:34:26",2013-02-06 00:46:44,2010-02-01 10:32:08,2010-05-31 01:06:34,1985
595,1107,2192,3894,"118 days, 15:51:41",2013-02-09 01:59:15,2010-02-01 10:32:08,2010-05-31 02:23:49,589
77,7,49,133,"118 days, 16:00:01",2013-02-07 00:46:48,2010-11-15 09:46:48,2011-03-14 01:46:49,6538
207,205,427,839,"118 days, 17:56:48",2013-02-01 10:38:56,2010-02-01 10:32:08,2010-05-31 04:28:56,4465
10,359,1024,1393,"118 days, 18:30:22",2013-02-04 03:14:31,2010-02-01 10:32:08,2010-05-31 05:02:30,5981
488,272,678,1438,"118 days, 19:27:05",2013-02-07 00:17:58,2010-02-01 10:32:08,2010-05-31 05:59:13,861
208,28,195,431,"118 days, 21:15:45",2013-02-03 07:51:03,2010-02-01 10:32:08,2010-05-31 07:47:53,1380
995,63,107,1165,"118 days, 21:46:31",2013-02-04 08:37:41,2010-02-01 10:32:08,2010-05-31 08:18:39,2838
51,254,562,867,"118 days, 22:00:02",2013-02-07 06:09:42,2010-02-01 10:32:08,2010-05-31 08:32:10,3325
181,1500,2877,4558,"119 days, 0:30:10",2013-02-05 07:42:46,2010-02-01 10:32:08,2010-05-31 11:02:18,4660
27,223,733,983,"119 days, 0:32:34",2013-02-03 10:35:13,2010-02-01 10:32:08,2010-05-31 11:04:42,172
192,229,423,844,"119 days, 1:10:49",2013-02-03 07:52:29,2010-02-01 10:32:08,2010-05-31 11:42:57,2316
995,227,530,1752,"119 days, 13:58:42",2013-02-04 07:19:01,2010-02-01 10:32:08,2010-06-01 00:30:50,2090
565,0,0,565,"119 days, 14:37:12",2013-01-07 10:29:40,2010-02-01 10:32:08,2010-06-01 01:09:20,9503
650,1,21,672,"119 days, 14:37:29",2013-01-30 06:04:31,2010-08-02 09:40:54,2010-11-30 00:18:23,7341
393,23,152,568,"119 days, 15:00:16",2013-02-01 00:58:59,2010-02-01 10:32:08,2010-06-01 01:32:24,7451
509,2,45,556,"119 days, 15:25:03",2013-01-31 07:04:14,2010-02-01 10:32:08,2010-06-01 01:57:11,4387
201,1,35,237,"119 days, 15:43:39",2013-01-17 04:26:55,2010-02-01 10:32:08,2010-06-01 02:15:47,1322
270,8,161,439,"119 days, 17:06:17",2013-01-26 00:46:25,2010-02-01 10:32:08,2010-06-01 03:38:25,7310
303,657,1531,2491,"119 days, 17:59:28",2013-02-06 10:55:49,2010-02-01 10:32:08,2010-06-01 04:31:36,8759
16,1073,1917,3006,"119 days, 18:07:41",2013-02-07 10:08:13,2010-02-01 10:32:08,2010-06-01 04:39:49,4575
30,53,236,319,"119 days, 19:10:07",2013-02-01 06:08:51,2010-02-01 10:32:08,2010-06-01 05:42:15,1343
898,236,485,1619,"119 days, 19:26:09",2013-02-03 10:27:57,2010-02-01 10:32:08,2010-06-01 05:58:17,5385
247,87,63,397,"119 days, 19:48:36",2013-02-04 07:12:37,2010-02-01 10:32:08,2010-06-01 06:20:44,7222
1205,0,17,1222,"119 days, 21:32:07",2013-01-26 01:22:10,2010-02-01 10:32:08,2010-06-01 08:04:15,2182
1562,262,869,2693,"119 days, 22:08:55",2013-02-04 11:44:25,2010-02-01 10:32:08,2010-06-01 08:41:03,7160
240,859,921,2020,"119 days, 22:10:23",2013-02-05 05:13:10,2010-02-01 10:32:08,2010-06-01 08:42:31,6337
462,15,221,698,"119 days, 22:18:19",2013-02-01 05:50:05,2010-02-01 10:32:08,2010-06-01 08:50:27,4317
28,2,88,118,"120 days, 13:32:40",2013-01-31 01:44:52,2010-02-01 10:32:08,2010-06-02 00:04:48,7397
65,346,657,1068,"120 days, 15:20:31",2013-02-03 02:20:45,2010-02-01 10:32:08,2010-06-02 01:52:39,6467
425,94,401,920,"120 days, 16:01:16",2013-02-02 09:34:03,2010-02-01 10:32:08,2010-06-02 02:33:24,1160
1372,1920,2128,5420,"120 days, 16:28:59",2013-02-06 11:33:44,2010-02-01 10:32:08,2010-06-02 03:01:07,5379
59,115,281,455,"120 days, 17:11:29",2013-02-03 11:48:18,2010-02-01 10:32:08,2010-06-02 03:43:37,9411
376,52,250,678,"120 days, 18:04:50",2013-02-01 11:55:58,2010-02-01 10:32:08,2010-06-02 04:36:58,468
512,1532,1464,3508,"120 days, 19:50:51",2013-02-06 06:51:05,2010-02-01 10:32:08,2010-06-02 06:22:59,8028
884,110,262,1256,"120 days, 20:34:06",2013-01-28 03:02:44,2010-02-01 10:32:08,2010-06-02 07:06:14,3109
226,17,203,446,"120 days, 21:26:29",2013-02-03 03:33:54,2010-02-01 10:32:08,2010-06-02 07:58:37,4135
167,194,788,1149,"120 days, 21:39:44",2013-02-06 07:31:45,2010-02-01 10:32:08,2010-06-02 08:11:52,8918
1118,40,445,1603,"120 days, 22:32:12",2013-02-06 07:08:04,2010-07-06 03:15:12,2010-11-04 01:47:24,1072
519,1,78,598,"120 days, 22:54:47",2013-01-20 00:59:09,2010-02-01 10:32:08,2010-06-02 09:26:55,7376
117,346,524,987,"121 days, 0:00:36",2013-02-06 11:19:35,2010-02-01 10:32:08,2010-06-02 10:32:44,6129
428,237,424,1089,"121 days, 14:20:39",2013-02-07 10:13:14,2010-02-01 10:32:08,2010-06-03 00:52:47,2962
806,59,474,1339,"121 days, 15:33:42",2013-02-03 10:16:23,2010-02-01 10:32:08,2010-06-03 02:05:50,2020
126,16,188,330,"121 days, 17:18:28",2013-02-03 04:05:44,2010-02-01 10:32:08,2010-06-03 03:50:36,2236
1168,80,208,1456,"121 days, 21:04:04",2013-01-30 04:04:11,2010-02-01 10:32:08,2010-06-03 07:36:12,3798
946,0,23,969,"121 days, 21:40:55",2013-01-22 09:47:51,2010-02-01 10:32:08,2010-06-03 08:13:03,206
21,153,429,603,"122 days, 0:07:38",2013-02-05 07:34:01,2010-02-01 10:32:08,2010-06-03 10:39:46,9332
75,72,289,436,"122 days, 0:09:51",2013-01-29 08:04:13,2010-02-01 10:32:08,2010-06-03 10:41:59,4933
17,129,145,291,"122 days, 0:14:42",2013-02-03 04:03:31,2010-02-01 10:32:08,2010-06-03 10:46:50,2703
86,2,81,169,"122 days, 13:37:15",2013-02-01 07:20:11,2010-02-01 10:32:08,2010-06-04 00:09:23,9935
1280,78,295,1653,"122 days, 14:13:03",2013-02-07 00:31:33,2010-02-01 10:32:08,2010-06-04 00:45:11,4669
2,22,176,200,"122 days, 15:27:28",2013-01-29 04:48:05,2010-02-01 10:32:08,2010-06-04 01:59:36,9770
1130,1095,1498,3723,"122 days, 16:51:53",2013-02-07 03:24:38,2010-02-01 10:32:08,2010-06-04 03:24:01,238
16,5,25,46,"122 days, 19:20:23",2013-01-28 06:20:53,2010-02-01 10:32:08,2010-06-04 05:52:31,4370
46,766,747,1559,"122 days, 20:15:21",2013-02-05 03:13:50,2010-02-01 10:32:08,2010-06-04 06:47:29,2418
329,0,3,332,"122 days, 20:55:30",2013-01-01 03:46:11,2010-02-01 10:32:08,2010-06-04 07:27:38,6157
327,0,9,336,"122 days, 21:01:37",2012-12-29 07:49:55,2010-05-24 03:02:07,2010-09-24 00:03:44,8033
1,6,33,40,"122 days, 22:41:24",2012-12-06 03:36:04,2010-11-04 09:23:54,2011-03-07 08:05:18,636
28,423,761,1212,"122 days, 23:28:55",2013-02-06 02:33:32,2010-02-01 10:32:08,2010-06-04 10:01:03,6605
184,1590,1854,3628,"123 days, 0:02:56",2013-02-06 06:27:11,2010-02-01 10:32:08,2010-06-04 10:35:04,4580
1182,286,1054,2522,"123 days, 14:21:53",2013-02-06 07:41:51,2010-02-01 10:32:08,2010-06-05 00:54:01,3120
74,29,402,505,"123 days, 14:24:59",2013-02-05 04:26:09,2010-02-01 10:32:08,2010-06-05 00:57:07,9984
212,923,1903,3038,"123 days, 15:03:00",2013-02-04 07:51:56,2010-02-01 10:32:08,2010-06-05 01:35:08,3
346,388,798,1532,"123 days, 15:08:45",2013-02-06 06:09:36,2010-02-01 10:32:08,2010-06-05 01:40:53,2939
674,0,17,691,"123 days, 15:32:58",2013-01-29 04:44:43,2010-02-01 10:32:08,2010-06-05 02:05:06,9853
204,2213,1769,4186,"123 days, 17:09:37",2013-02-06 08:33:07,2010-02-01 10:32:08,2010-06-05 03:41:45,7575
59,644,1135,1838,"123 days, 17:45:11",2013-02-06 08:22:05,2010-02-01 10:32:08,2010-06-05 04:17:19,8195
1,107,196,304,"123 days, 17:58:45",2013-01-29 06:46:43,2010-02-01 10:32:08,2010-06-05 04:30:53,8903
351,0,11,362,"123 days, 18:14:07",2013-01-30 07:56:54,2010-07-25 06:37:25,2010-11-26 00:51:32,8419
232,3,148,383,"123 days, 18:20:14",2013-01-27 03:48:48,2010-02-01 10:32:08,2010-06-05 04:52:22,3718
751,184,566,1501,"123 days, 19:28:12",2013-02-06 01:39:08,2010-02-01 10:32:08,2010-06-05 06:00:20,5656
1315,119,160,1594,"123 days, 20:03:17",2013-02-04 07:18:32,2010-02-01 10:32:08,2010-06-05 06:35:25,6279
842,1107,1379,3328,"123 days, 20:10:56",2013-02-06 08:18:54,2010-02-01 10:32:08,2010-06-05 06:43:04,697
369,960,1842,3171,"123 days, 20:13:38",2013-02-06 09:02:00,2010-02-01 10:32:08,2010-06-05 06:45:46,9440
532,107,683,1322,"123 days, 21:08:32",2013-02-06 03:18:11,2010-02-01 10:32:08,2010-06-05 07:40:40,1280
312,765,1205,2282,"123 days, 21:28:45",2013-02-07 10:19:34,2010-02-01 10:32:08,2010-06-05 08:00:53,888
609,1,46,656,"123 days, 21:35:18",2013-01-29 08:52:55,2010-02-01 10:32:08,2010-06-05 08:07:26,3956
368,873,1405,2646,"123 days, 23:36:49",2013-02-05 11:30:40,2010-02-01 10:32:08,2010-06-05 10:08:57,1196
1048,214,457,1719,"124 days, 0:37:52",2013-02-04 04:35:41,2010-02-10 09:27:50,2010-06-14 10:05:42,940
683,223,158,1064,"124 days, 1:20:02",2013-02-01 09:02:45,2010-02-01 10:32:08,2010-06-05 11:52:10,9044
1223,291,522,2036,"124 days, 16:03:21",2013-02-03 06:32:44,2010-02-01 10:32:08,2010-06-06 02:35:29,2649
92,1000,1015,2107,"124 days, 17:34:52",2013-02-06 07:20:58,2010-02-01 10:32:08,2010-06-06 04:07:00,7281
416,26,166,608,"124 days, 17:39:05",2013-02-06 03:07:26,2010-02-01 10:32:08,2010-06-06 04:11:13,5575
122,95,404,621,"124 days, 18:29:04",2013-02-04 06:52:01,2010-02-01 10:32:08,2010-06-06 05:01:12,6020
428,86,339,853,"124 days, 19:48:55",2013-02-07 01:37:52,2010-02-01 10:32:08,2010-06-06 06:21:03,7543
225,193,469,887,"124 days, 19:55:36",2013-02-07 02:48:19,2010-02-01 10:32:08,2010-06-06 06:27:44,2554
120,8,216,344,"124 days, 20:48:32",2013-02-01 06:53:32,2010-02-01 10:32:08,2010-06-06 07:20:40,3283
85,128,336,549,"124 days, 20:53:47",2013-02-03 01:31:48,2010-02-01 10:32:08,2010-06-06 07:25:55,3025
183,1328,1663,3174,"124 days, 21:13:34",2013-02-06 03:46:42,2010-02-01 10:32:08,2010-06-06 07:45:42,3112
28,9,27,64,"124 days, 21:20:34",2013-01-28 09:28:37,2012-05-16 10:33:36,2012-09-18 07:54:10,3401
1233,1,0,1234,"124 days, 21:35:37",2013-01-26 09:14:01,2010-02-01 10:32:08,2010-06-06 08:07:45,4684
887,274,632,1793,"124 days, 21:57:14",2013-02-05 11:56:49,2010-02-01 10:32:08,2010-06-06 08:29:22,7257
1177,413,875,2465,"124 days, 22:38:19",2013-02-04 08:31:16,2010-02-01 10:32:08,2010-06-06 09:10:27,2936
138,0,49,187,"124 days, 22:47:55",2013-01-30 02:49:22,2010-02-01 10:32:08,2010-06-06 09:20:03,4493
3,28,129,160,"125 days, 7:21:56",2013-02-05 10:10:57,2011-02-17 01:53:40,2011-06-22 09:15:36,2126
146,354,530,1030,"125 days, 14:10:16",2013-02-05 04:47:22,2010-02-01 10:32:08,2010-06-07 00:42:24,542
1,2,77,80,"125 days, 14:55:02",2013-01-23 10:33:50,2010-02-01 10:32:08,2010-06-07 01:27:10,4907
648,2,56,706,"125 days, 16:25:38",2013-01-31 00:46:08,2010-02-01 10:32:08,2010-06-07 02:57:46,2459
1029,1,32,1062,"125 days, 17:47:03",2013-02-01 02:54:42,2010-02-01 10:32:08,2010-06-07 04:19:11,2194
901,0,4,905,"125 days, 18:35:55",2013-01-25 01:33:52,2010-02-01 10:32:08,2010-06-07 05:08:03,6482
443,64,391,898,"125 days, 18:46:54",2013-02-05 07:28:26,2010-02-01 10:32:08,2010-06-07 05:19:02,7441
413,572,808,1793,"125 days, 18:52:57",2013-02-03 06:00:08,2010-02-01 10:32:08,2010-06-07 05:25:05,701
245,3,84,332,"125 days, 18:55:52",2013-02-01 00:08:09,2010-02-01 10:32:08,2010-06-07 05:28:00,4814
884,422,564,1870,"125 days, 18:59:02",2013-02-06 06:11:48,2010-02-01 10:32:08,2010-06-07 05:31:10,6093
80,30,306,416,"125 days, 19:19:07",2013-02-06 04:20:34,2010-02-01 10:32:08,2010-06-07 05:51:15,9107
119,333,846,1298,"125 days, 20:19:20",2013-02-06 11:37:46,2010-02-01 10:32:08,2010-06-07 06:51:28,4714
1176,1483,1667,4326,"125 days, 21:22:54",2013-02-06 02:53:43,2010-02-01 10:32:08,2010-06-07 07:55:02,1406
256,296,647,1199,"125 days, 22:46:02",2013-02-01 02:20:49,2010-02-01 10:32:08,2010-06-07 09:18:10,2128
887,450,699,2036,"125 days, 23:06:03",2013-02-05 10:13:31,2010-02-01 10:32:08,2010-06-07 09:38:11,649
64,371,621,1056,"125 days, 23:42:03",2013-02-05 05:11:22,2010-02-01 10:32:08,2010-06-07 10:14:11,1234
345,0,21,366,"126 days, 4:34:50",2013-01-14 07:04:30,2010-08-22 07:18:34,2010-12-26 11:53:24,7538
53,176,687,916,"126 days, 14:18:39",2013-02-06 06:02:28,2010-02-01 10:32:08,2010-06-08 00:50:47,1535
348,381,654,1383,"126 days, 14:24:08",2013-02-05 08:25:21,2010-02-01 10:32:08,2010-06-08 00:56:16,5060
1028,170,255,1453,"126 days, 14:53:49",2013-01-30 00:55:50,2010-02-01 10:32:08,2010-06-08 01:25:57,6720
214,518,1021,1753,"126 days, 15:54:58",2013-02-06 09:05:43,2010-02-01 10:32:08,2010-06-08 02:27:06,514
95,450,613,1158,"126 days, 17:52:53",2013-02-05 02:25:47,2010-02-01 10:32:08,2010-06-08 04:25:01,4113
90,2,94,186,"126 days, 19:48:59",2013-02-06 00:20:03,2010-06-02 10:18:24,2010-10-07 06:07:23,4425
40,199,601,840,"126 days, 20:22:37",2013-02-06 10:45:07,2010-02-01 10:32:08,2010-06-08 06:54:45,897
27,23,290,340,"126 days, 20:44:26",2013-02-04 10:24:49,2010-05-22 04:03:11,2010-09-26 00:47:37,6299
6,5,110,121,"126 days, 21:43:09",2013-02-03 00:49:40,2010-02-01 10:32:08,2010-06-08 08:15:17,2583
0,2,151,153,"126 days, 21:56:40",2013-02-01 09:58:58,2010-02-01 10:32:08,2010-06-08 08:28:48,2589
413,128,507,1048,"126 days, 23:10:55",2013-02-05 01:26:51,2010-02-01 10:32:08,2010-06-08 09:43:03,1425
317,242,342,901,"126 days, 23:58:56",2013-01-30 09:56:37,2010-02-01 10:32:08,2010-06-08 10:31:04,212
382,2,88,472,"127 days, 0:41:58",2013-02-05 08:30:08,2010-02-01 10:32:08,2010-06-08 11:14:06,2966
498,4,35,537,"127 days, 3:55:13",2013-01-27 08:07:13,2010-02-26 05:15:26,2010-07-03 09:10:39,9109
47,105,196,348,"127 days, 14:28:55",2013-02-03 07:07:42,2010-02-01 10:32:08,2010-06-09 01:01:03,6446
1094,4,21,1119,"127 days, 15:26:19",2013-01-29 10:17:29,2010-02-01 10:32:08,2010-06-09 01:58:27,2354
749,80,275,1104,"127 days, 16:00:57",2013-02-07 01:56:29,2010-02-01 10:32:08,2010-06-09 02:33:05,1067
658,1113,1948,3719,"127 days, 16:24:39",2013-02-07 06:44:20,2010-02-01 10:32:08,2010-06-09 02:56:47,2026
388,206,382,976,"127 days, 16:59:25",2013-02-03 06:30:55,2010-02-01 10:32:08,2010-06-09 03:31:33,5222
123,24,307,454,"127 days, 17:05:36",2013-02-05 08:01:43,2010-02-01 10:32:08,2010-06-09 03:37:44,8905
502,177,236,915,"127 days, 18:10:02",2013-02-02 02:27:47,2010-02-01 10:32:08,2010-06-09 04:42:10,8862
992,0,4,996,"127 days, 19:03:57",2013-01-27 11:26:57,2010-02-01 10:32:08,2010-06-09 05:36:05,7923
236,11,271,518,"127 days, 19:23:36",2013-02-03 02:34:07,2010-02-01 10:32:08,2010-06-09 05:55:44,4707
375,106,373,854,"127 days, 19:43:50",2013-02-06 07:29:51,2010-02-01 10:32:08,2010-06-09 06:15:58,7096
24,11,79,114,"127 days, 19:56:24",2013-02-01 07:32:16,2010-02-01 10:32:08,2010-06-09 06:28:32,2173
116,139,315,570,"127 days, 20:07:19",2013-01-29 07:02:07,2010-02-01 10:32:08,2010-06-09 06:39:27,150
361,403,691,1455,"127 days, 20:36:58",2013-02-05 10:45:44,2010-02-01 10:32:08,2010-06-09 07:09:06,8227
278,514,773,1565,"127 days, 20:59:46",2013-02-05 00:26:06,2010-02-01 10:32:08,2010-06-09 07:31:54,6752
303,163,533,999,"127 days, 22:01:11",2013-02-02 02:12:06,2010-02-01 10:32:08,2010-06-09 08:33:19,1119
1211,372,1054,2637,"127 days, 22:22:39",2013-02-06 09:15:06,2010-02-01 10:32:08,2010-06-09 08:54:47,4696
231,744,1693,2668,"127 days, 22:42:15",2013-02-07 02:54:47,2010-02-01 10:32:08,2010-06-09 09:14:23,4526
833,2,57,892,"127 days, 23:03:43",2013-01-28 09:56:49,2010-02-01 10:32:08,2010-06-09 09:35:51,6603
423,214,568,1205,"128 days, 0:46:53",2013-02-03 08:24:23,2010-02-01 10:32:08,2010-06-09 11:19:01,4764
70,344,520,934,"128 days, 14:31:01",2013-02-06 09:19:52,2010-02-01 10:32:08,2010-06-10 01:03:09,9955
55,179,287,521,"128 days, 15:02:05",2013-02-02 08:28:38,2010-02-01 10:32:08,2010-06-10 01:34:13,2350
58,985,1626,2669,"128 days, 15:44:18",2013-02-06 06:08:15,2010-02-01 10:32:08,2010-06-10 02:16:26,4201
10,9,146,165,"128 days, 15:57:01",2013-01-30 11:15:56,2010-02-01 10:32:08,2010-06-10 02:29:09,2310
447,145,400,992,"128 days, 16:10:30",2013-02-03 01:10:41,2010-02-01 10:32:08,2010-06-10 02:42:38,4354
94,592,964,1650,"128 days, 17:54:35",2013-02-06 09:26:24,2010-02-01 10:32:08,2010-06-10 04:26:43,6962
161,20,356,537,"128 days, 19:08:33",2013-02-03 09:17:26,2010-02-01 10:32:08,2010-06-10 05:40:41,5745
438,128,215,781,"128 days, 20:17:25",2013-01-29 09:39:55,2010-02-01 10:32:08,2010-06-10 06:49:33,1802
171,295,510,976,"128 days, 21:23:54",2013-02-07 11:22:00,2010-02-01 10:32:08,2010-06-10 07:56:02,651
421,0,44,465,"128 days, 21:28:16",2013-01-02 07:01:09,2010-02-01 10:32:08,2010-06-10 08:00:24,906
423,305,1141,1869,"128 days, 21:43:43",2013-02-04 11:36:23,2010-02-01 10:32:08,2010-06-10 08:15:51,7817
25,158,603,786,"128 days, 22:02:30",2013-02-06 05:14:04,2010-02-01 10:32:08,2010-06-10 08:34:38,9016
440,57,336,833,"128 days, 22:03:29",2013-02-04 06:40:19,2010-02-01 10:32:08,2010-06-10 08:35:37,5634
0,2,82,84,"128 days, 23:53:21",2013-01-18 10:07:05,2010-02-01 10:32:08,2010-06-10 10:25:29,8158
932,0,3,935,"128 days, 23:55:00",2013-01-29 06:25:38,2010-02-01 10:32:08,2010-06-10 10:27:08,223
17,28,110,155,"128 days, 23:59:18",2013-02-07 09:21:21,2010-02-01 10:32:08,2010-06-10 10:31:26,2120
294,0,8,302,"129 days, 8:00:06",2013-01-29 01:56:46,2011-05-21 03:24:55,2011-09-27 11:25:01,4970
287,0,16,303,"129 days, 14:17:14",2013-01-31 00:06:33,2010-02-01 10:32:08,2010-06-11 00:49:22,9475
222,279,356,857,"129 days, 15:08:37",2013-02-05 10:57:57,2010-02-01 10:32:08,2010-06-11 01:40:45,657
240,43,178,461,"129 days, 15:29:15",2013-01-31 09:30:39,2010-02-01 10:32:08,2010-06-11 02:01:23,1248
1250,7,165,1422,"129 days, 18:55:17",2013-01-31 03:29:16,2010-02-01 10:32:08,2010-06-11 05:27:25,5048
72,53,199,324,"129 days, 19:18:07",2013-02-04 09:03:55,2010-02-01 10:32:08,2010-06-11 05:50:15,775
17,70,294,381,"129 days, 21:52:33",2013-02-05 06:14:41,2010-02-01 10:32:08,2010-06-11 08:24:41,8921
64,261,837,1162,"129 days, 22:49:05",2013-02-06 04:43:55,2010-02-01 10:32:08,2010-06-11 09:21:13,6823
177,125,296,598,"130 days, 1:12:53",2013-02-05 07:11:23,2010-02-01 10:32:08,2010-06-11 11:45:01,4366
133,43,93,269,"130 days, 1:14:45",2013-01-29 00:50:11,2011-01-22 00:46:46,2011-06-01 02:01:31,4651
4,353,287,644,"130 days, 1:16:09",2013-02-02 08:50:16,2010-02-01 10:32:08,2010-06-11 11:48:17,243
1000,146,168,1314,"130 days, 14:05:33",2013-01-30 03:25:42,2010-02-01 10:32:08,2010-06-12 00:37:41,3258
42,167,433,642,"130 days, 14:18:21",2013-02-07 08:20:42,2010-02-01 10:32:08,2010-06-12 00:50:29,8642
1462,437,834,2733,"130 days, 15:00:43",2013-02-04 09:41:43,2010-02-01 10:32:08,2010-06-12 01:32:51,3523
52,13,77,142,"130 days, 15:34:49",2013-01-22 01:05:34,2011-01-13 11:41:31,2011-05-24 03:16:20,4066
463,405,782,1650,"130 days, 16:17:01",2013-02-06 09:56:01,2010-02-01 10:32:08,2010-06-12 02:49:09,6516
3,674,1073,1750,"130 days, 16:21:31",2013-02-06 05:22:30,2010-02-20 10:47:22,2010-07-01 03:08:53,1498
587,117,328,1032,"130 days, 16:54:11",2013-02-04 07:30:30,2010-02-01 10:32:08,2010-06-12 03:26:19,8729
38,177,300,515,"130 days, 17:38:58",2013-02-02 11:31:16,2010-02-01 10:32:08,2010-06-12 04:11:06,2978
2,123,198,323,"130 days, 21:24:59",2013-02-01 00:34:48,2010-02-01 10:32:08,2010-06-12 07:57:07,646
558,539,888,1985,"130 days, 21:26:54",2013-02-07 10:35:16,2010-02-01 10:32:08,2010-06-12 07:59:02,8587
121,484,1027,1632,"130 days, 21:53:38",2013-02-03 11:46:49,2010-02-01 10:32:08,2010-06-12 08:25:46,7784
98,366,824,1288,"130 days, 22:20:05",2013-02-04 00:09:38,2010-02-01 10:32:08,2010-06-12 08:52:13,1656
48,220,411,679,"130 days, 23:21:56",2013-02-04 00:00:03,2010-02-01 10:32:08,2010-06-12 09:54:04,665
1192,0,31,1223,"130 days, 23:23:32",2013-01-28 08:49:35,2010-02-01 10:32:08,2010-06-12 09:55:40,2655
1139,191,301,1631,"131 days, 0:32:56",2013-02-05 01:05:23,2010-02-01 10:32:08,2010-06-12 11:05:04,1220
248,272,335,855,"131 days, 1:27:05",2013-02-06 06:29:19,2010-02-01 10:32:08,2010-06-12 11:59:13,1789
60,134,145,339,"131 days, 13:58:30",2013-02-02 02:56:50,2010-02-01 10:32:08,2010-06-13 00:30:38,8439
386,360,499,1245,"131 days, 15:09:00",2013-02-05 07:41:30,2010-02-01 10:32:08,2010-06-13 01:41:08,8273
509,852,1082,2443,"131 days, 15:35:25",2013-02-05 06:01:27,2010-02-01 10:32:08,2010-06-13 02:07:33,4015
200,397,520,1117,"131 days, 15:53:19",2013-02-06 03:11:52,2010-02-01 10:32:08,2010-06-13 02:25:27,8855
177,326,441,944,"131 days, 16:06:12",2013-02-05 10:49:12,2010-02-01 10:32:08,2010-06-13 02:38:20,4072
524,471,937,1932,"131 days, 16:07:07",2013-02-04 07:52:07,2010-02-01 10:32:08,2010-06-13 02:39:15,8121
534,94,183,811,"131 days, 17:47:45",2013-01-29 07:04:24,2010-02-01 10:32:08,2010-06-13 04:19:53,972
377,1175,1431,2983,"131 days, 17:57:24",2013-02-06 03:10:12,2010-02-01 10:32:08,2010-06-13 04:29:32,3473
221,138,164,523,"131 days, 19:55:21",2013-02-03 06:30:29,2010-02-01 10:32:08,2010-06-13 06:27:29,8775
1179,2,23,1204,"131 days, 20:08:06",2013-01-25 00:05:36,2010-02-01 10:32:08,2010-06-13 06:40:14,9672
69,1047,1622,2738,"131 days, 20:29:34",2013-02-06 10:48:39,2010-02-01 10:32:08,2010-06-13 07:01:42,278
57,38,129,224,"131 days, 20:57:06",2013-02-05 10:28:11,2010-11-29 08:45:05,2011-04-10 05:42:11,8031
29,155,183,367,"131 days, 21:11:55",2013-02-02 03:24:33,2010-02-01 10:32:08,2010-06-13 07:44:03,3115
681,57,166,904,"131 days, 21:40:40",2013-01-29 09:50:58,2010-02-01 10:32:08,2010-06-13 08:12:48,6162
115,36,392,543,"131 days, 21:53:48",2013-02-07 04:19:28,2010-02-01 10:32:08,2010-06-13 08:25:56,8167
37,102,561,700,"131 days, 22:09:08",2013-02-01 05:46:33,2010-02-01 10:32:08,2010-06-13 08:41:16,9024
368,1,0,369,"132 days, 0:40:50",2012-11-05 08:13:26,2011-02-26 05:49:32,2011-07-08 06:30:22,9247
497,641,243,1381,"132 days, 13:38:02",2013-02-05 08:07:06,2010-02-01 10:32:08,2010-06-14 00:10:10,841
243,3,106,352,"132 days, 14:00:28",2013-01-18 11:01:59,2010-02-01 10:32:08,2010-06-14 00:32:36,5926
181,127,251,559,"132 days, 16:02:44",2013-02-03 11:29:49,2010-02-01 10:32:08,2010-06-14 02:34:52,939
61,470,810,1341,"132 days, 16:04:36",2013-02-04 07:26:45,2010-02-01 10:32:08,2010-06-14 02:36:44,3390
45,686,1515,2246,"132 days, 16:14:44",2013-02-11 02:20:39,2010-02-01 10:32:08,2010-06-14 02:46:52,2990
718,37,338,1093,"132 days, 18:08:12",2013-02-04 05:29:03,2010-05-21 10:54:48,2010-10-01 05:03:00,8722
114,1016,1798,2928,"132 days, 18:13:56",2013-02-06 03:56:53,2010-02-01 10:32:08,2010-06-14 04:46:04,89
8,0,8,16,"132 days, 18:24:06",2013-01-08 00:03:44,2011-06-10 09:45:56,2011-10-21 04:10:02,594
360,420,747,1527,"132 days, 18:33:44",2013-02-05 05:34:50,2010-02-01 10:32:08,2010-06-14 05:05:52,8302
107,361,674,1142,"132 days, 18:46:23",2013-02-04 04:38:01,2010-02-01 10:32:08,2010-06-14 05:18:31,611
527,5,170,702,"132 days, 19:02:04",2013-01-31 05:53:54,2010-02-01 10:32:08,2010-06-14 05:34:12,1682
1304,138,218,1660,"132 days, 19:18:36",2013-02-07 07:00:36,2010-02-01 10:32:08,2010-06-14 05:50:44,1210
418,1370,1402,3190,"132 days, 19:48:12",2013-02-06 08:42:33,2010-02-01 10:32:08,2010-06-14 06:20:20,6620
158,154,99,411,"132 days, 22:43:39",2013-01-25 09:24:03,2010-02-01 10:32:08,2010-06-14 09:15:47,5288
149,291,590,1030,"132 days, 22:50:44",2013-02-07 10:25:23,2010-02-01 10:32:08,2010-06-14 09:22:52,4648
1633,598,982,3213,"132 days, 23:06:13",2013-02-06 09:56:42,2010-02-01 10:32:08,2010-06-14 09:38:21,6180
178,663,988,1829,"132 days, 23:44:23",2013-02-07 02:01:02,2010-02-01 10:32:08,2010-06-14 10:16:31,8008
1035,3,67,1105,"132 days, 23:52:45",2013-02-05 09:25:08,2010-02-01 10:32:08,2010-06-14 10:24:53,7893
27,96,199,322,"133 days, 1:19:11",2013-02-02 03:59:50,2010-02-01 10:32:08,2010-06-14 11:51:19,2686
405,625,1235,2265,"133 days, 14:54:49",2013-02-06 06:59:58,2010-02-01 10:32:08,2010-06-15 01:26:57,1553
484,722,1248,2454,"133 days, 14:59:05",2013-02-07 07:47:34,2010-02-01 10:32:08,2010-06-15 01:31:13,270
562,153,590,1305,"133 days, 15:16:09",2013-02-02 11:06:56,2010-02-01 10:32:08,2010-06-15 01:48:17,8317
704,1,10,715,"133 days, 16:53:32",2013-01-23 03:10:53,2010-02-01 10:32:08,2010-06-15 03:25:40,234
668,226,1068,1962,"133 days, 16:55:18",2013-02-07 01:38:49,2010-02-01 10:32:08,2010-06-15 03:27:26,7297
939,259,218,1416,"133 days, 18:10:16",2013-02-05 08:43:07,2010-02-01 10:32:08,2010-06-15 04:42:24,8240
1080,27,314,1421,"133 days, 19:08:41",2013-02-03 05:13:54,2010-02-01 10:32:08,2010-06-15 05:40:49,3030
125,936,1322,2383,"133 days, 19:33:23",2013-02-06 03:11:30,2010-02-01 10:32:08,2010-06-15 06:05:31,3935
609,140,559,1308,"133 days, 20:01:12",2013-02-02 01:18:45,2010-02-01 10:32:08,2010-06-15 06:33:20,2666
593,0,5,598,"133 days, 21:37:20",2013-02-01 03:03:10,2010-02-01 10:32:08,2010-06-15 08:09:28,2001
36,36,114,186,"133 days, 22:16:10",2013-02-03 06:45:12,2010-02-01 10:32:08,2010-06-15 08:48:18,988
295,9,65,369,"133 days, 23:31:45",2013-01-30 02:22:16,2010-03-26 06:18:06,2010-08-07 05:49:51,7621
843,331,680,1854,"134 days, 0:18:52",2013-02-06 02:14:46,2010-07-27 01:46:15,2010-12-08 02:05:07,3374
826,0,4,830,"134 days, 1:12:33",2013-02-06 09:25:24,2010-02-01 10:32:08,2010-06-15 11:44:41,6272
447,41,206,694,"134 days, 6:52:49",2013-01-31 02:15:51,2010-06-27 01:39:14,2010-11-08 08:32:03,4128
410,121,734,1265,"134 days, 13:28:55",2013-02-03 11:17:47,2010-02-01 10:32:08,2010-06-16 00:01:03,8518
511,34,259,804,"134 days, 15:14:50",2013-02-04 11:54:27,2010-02-01 10:32:08,2010-06-16 01:46:58,4804
216,113,270,599,"134 days, 15:52:41",2013-02-05 03:11:50,2010-02-01 10:32:08,2010-06-16 02:24:49,5376
620,6,15,641,"134 days, 16:03:41",2013-01-29 03:28:53,2010-02-01 10:32:08,2010-06-16 02:35:49,6514
601,320,278,1199,"134 days, 16:15:37",2013-02-07 00:21:09,2010-02-01 10:32:08,2010-06-16 02:47:45,691
45,1,29,75,"134 days, 16:30:57",2013-01-31 03:21:54,2010-02-01 10:32:08,2010-06-16 03:03:05,5801
256,1039,634,1929,"134 days, 17:07:09",2013-02-03 09:59:37,2010-02-01 10:32:08,2010-06-16 03:39:17,8278
267,257,486,1010,"134 days, 17:58:46",2013-02-05 10:47:32,2010-02-01 10:32:08,2010-06-16 04:30:54,8610
437,6,130,573,"134 days, 18:24:37",2013-02-02 05:08:16,2010-02-01 10:32:08,2010-06-16 04:56:45,7118
91,1014,1441,2546,"134 days, 18:45:54",2013-02-06 04:41:17,2010-02-01 10:32:08,2010-06-16 05:18:02,7247
186,432,598,1216,"134 days, 19:29:06",2013-02-03 04:02:34,2010-02-01 10:32:08,2010-06-16 06:01:14,7781
191,19,108,318,"134 days, 20:19:21",2013-02-01 07:00:49,2010-02-01 10:32:08,2010-06-16 06:51:29,4145
60,9,178,247,"134 days, 21:02:05",2013-01-28 03:02:57,2010-02-01 10:32:08,2010-06-16 07:34:13,188
112,307,417,836,"134 days, 22:30:25",2013-02-04 00:02:25,2010-05-18 10:14:19,2010-09-30 08:44:44,7806
547,268,510,1325,"134 days, 22:33:41",2013-02-02 09:35:49,2010-02-01 10:32:08,2010-06-16 09:05:49,2996
302,1095,1137,2534,"134 days, 22:48:10",2013-02-05 05:39:32,2010-02-01 10:32:08,2010-06-16 09:20:18,4082
9,1,32,42,"135 days, 0:09:23",2013-01-25 02:16:03,2010-02-01 10:32:08,2010-06-16 10:41:31,5062
553,85,159,797,"135 days, 0:16:36",2013-02-05 07:58:32,2010-02-01 10:32:08,2010-06-16 10:48:44,1863
20,202,391,613,"135 days, 0:19:35",2013-02-03 03:38:54,2010-02-01 10:32:08,2010-06-16 10:51:43,3622
263,976,1861,3100,"135 days, 0:22:07",2013-02-07 05:13:05,2010-02-01 10:32:08,2010-06-16 10:54:15,5789
770,0,15,785,"135 days, 0:23:26",2013-01-18 03:19:17,2010-02-01 10:32:08,2010-06-16 10:55:34,916
550,174,548,1272,"135 days, 0:26:55",2013-02-04 00:03:31,2010-02-01 10:32:08,2010-06-16 10:59:03,3023
683,10,36,729,"135 days, 1:41:42",2013-02-03 02:12:57,2010-06-13 05:38:14,2010-10-26 07:19:56,449
33,1,41,75,"135 days, 6:31:31",2013-01-27 08:30:01,2011-02-02 03:06:30,2011-06-17 09:38:01,6288
377,478,644,1499,"135 days, 13:29:09",2013-02-07 02:38:38,2010-02-01 10:32:08,2010-06-17 00:01:17,464
10,56,247,313,"135 days, 14:02:15",2013-02-04 04:17:18,2010-02-01 10:32:08,2010-06-17 00:34:23,2241
169,538,572,1279,"135 days, 15:42:09",2013-02-05 06:00:20,2010-02-01 10:32:08,2010-06-17 02:14:17,1783
187,7,198,392,"135 days, 18:18:39",2013-02-05 07:02:17,2010-02-01 10:32:08,2010-06-17 04:50:47,7534
938,1,0,939,"135 days, 20:07:37",2013-01-11 03:09:49,2010-02-01 10:32:08,2010-06-17 06:39:45,7915
312,79,255,646,"135 days, 20:11:39",2013-02-03 10:10:33,2010-02-01 10:32:08,2010-06-17 06:43:47,4521
1023,79,222,1324,"135 days, 22:15:35",2013-01-27 01:09:27,2010-02-01 10:32:08,2010-06-17 08:47:43,9256
598,1,3,602,"135 days, 23:11:21",2012-12-30 00:30:53,2010-02-01 10:32:08,2010-06-17 09:43:29,2266
1232,6,122,1360,"135 days, 23:18:45",2013-02-02 02:14:05,2010-02-01 10:32:08,2010-06-17 09:50:53,8347
37,7,120,164,"135 days, 23:52:15",2013-01-27 00:16:31,2010-02-01 10:32:08,2010-06-17 10:24:23,5545
368,1,32,401,"136 days, 0:20:24",2013-01-29 03:32:09,2010-02-01 10:32:08,2010-06-17 10:52:32,821
491,160,294,945,"136 days, 15:54:14",2013-02-02 08:58:39,2010-02-01 10:32:08,2010-06-18 02:26:22,9785
363,109,355,827,"136 days, 16:49:09",2013-01-31 10:19:00,2010-02-01 10:32:08,2010-06-18 03:21:17,1695
35,700,1614,2349,"136 days, 18:22:22",2013-02-06 01:17:57,2010-02-01 10:32:08,2010-06-18 04:54:30,4418
776,58,319,1153,"136 days, 18:22:29",2013-02-01 06:16:16,2010-02-01 10:32:08,2010-06-18 04:54:37,2901
69,9,103,181,"136 days, 18:25:08",2013-02-02 02:28:38,2010-02-01 10:32:08,2010-06-18 04:57:16,6694
356,309,943,1608,"136 days, 19:05:35",2013-02-04 10:14:13,2010-02-01 10:32:08,2010-06-18 05:37:43,7125
96,1137,1779,3012,"136 days, 20:45:11",2013-02-07 05:18:56,2010-02-01 10:32:08,2010-06-18 07:17:19,2165
505,229,566,1300,"136 days, 21:06:45",2013-02-06 00:19:26,2010-02-01 10:32:08,2010-06-18 07:38:53,1944
1439,850,408,2697,"136 days, 21:23:02",2013-02-05 02:26:32,2010-02-01 10:32:08,2010-06-18 07:55:10,843
8,120,351,479,"136 days, 21:41:27",2013-02-06 04:33:57,2010-02-01 10:32:08,2010-06-18 08:13:35,134
1081,4,0,1085,"136 days, 22:37:00",2013-01-30 11:35:13,2010-03-14 09:42:12,2010-07-29 08:19:12,3225
858,0,0,858,"136 days, 23:22:12",2013-01-17 11:35:06,2010-02-01 10:32:08,2010-06-18 09:54:20,3818
49,483,952,1484,"136 days, 23:27:37",2013-02-06 07:32:09,2010-02-01 10:32:08,2010-06-18 09:59:45,968
443,228,194,865,"137 days, 0:33:18",2013-02-05 01:24:28,2010-02-01 10:32:08,2010-06-18 11:05:26,4903
239,516,1002,1757,"137 days, 0:57:08",2013-02-05 07:27:34,2010-02-01 10:32:08,2010-06-18 11:29:16,1424
1128,0,0,1128,"137 days, 14:08:38",2013-01-23 05:36:59,2010-02-01 10:32:08,2010-06-19 00:40:46,8402
263,0,0,263,"137 days, 14:34:32",2013-01-23 03:40:06,2010-02-01 10:32:08,2010-06-19 01:06:40,2775
483,379,525,1387,"137 days, 15:47:33",2013-02-06 06:56:03,2010-02-01 10:32:08,2010-06-19 02:19:41,9969
118,471,802,1391,"137 days, 17:07:56",2013-02-07 05:49:51,2010-02-01 10:32:08,2010-06-19 03:40:04,1154
288,34,236,558,"137 days, 17:28:27",2013-02-06 01:50:09,2010-02-01 10:32:08,2010-06-19 04:00:35,5383
68,235,502,805,"137 days, 18:56:04",2013-02-02 00:14:39,2010-02-01 10:32:08,2010-06-19 05:28:12,6759
99,454,958,1511,"137 days, 19:04:24",2013-02-05 06:52:07,2010-02-01 10:32:08,2010-06-19 05:36:32,9992
745,380,957,2082,"137 days, 19:08:11",2013-02-05 10:49:12,2010-02-01 10:32:08,2010-06-19 05:40:19,714
1260,6,170,1436,"137 days, 20:26:33",2013-01-29 05:09:35,2010-02-01 10:32:08,2010-06-19 06:58:41,2953
727,63,188,978,"137 days, 20:34:35",2013-01-31 11:16:44,2010-02-01 10:32:08,2010-06-19 07:06:43,9564
356,0,5,361,"137 days, 20:57:09",2013-02-11 01:17:58,2010-02-01 10:32:08,2010-06-19 07:29:17,7564
372,0,0,372,"137 days, 22:33:03",2013-01-31 00:54:10,2010-12-24 11:39:18,2011-05-11 10:12:21,2807
443,412,1242,2097,"137 days, 23:30:39",2013-02-03 11:34:35,2010-02-01 10:32:08,2010-06-19 10:02:47,2431
399,63,161,623,"138 days, 1:06:52",2013-02-06 11:00:37,2010-02-01 10:32:08,2010-06-19 11:39:00,9166
16,1,0,17,"138 days, 2:46:07",2012-12-16 08:53:00,2011-06-25 06:49:49,2011-11-10 09:35:56,1467
499,222,650,1371,"138 days, 7:29:11",2013-02-05 06:30:10,2010-03-17 03:01:20,2010-08-02 10:30:31,7135
1294,0,0,1294,"138 days, 14:20:41",2013-01-23 06:36:26,2010-02-01 10:32:08,2010-06-20 00:52:49,163
148,231,609,988,"138 days, 14:24:02",2013-02-04 00:13:21,2010-02-01 10:32:08,2010-06-20 00:56:10,2912
1162,0,0,1162,"138 days, 15:13:27",2013-01-30 11:48:01,2010-02-01 10:32:08,2010-06-20 01:45:35,9365
203,12,94,309,"138 days, 17:25:21",2013-01-28 03:46:25,2010-02-01 10:32:08,2010-06-20 03:57:29,3480
150,300,491,941,"138 days, 17:25:59",2013-02-05 03:46:25,2010-02-01 10:32:08,2010-06-20 03:58:07,969
308,0,51,359,"138 days, 19:57:23",2013-02-06 11:34:43,2010-02-01 10:32:08,2010-06-20 06:29:31,1362
398,42,230,670,"138 days, 20:14:02",2013-02-06 11:10:36,2010-02-01 10:32:08,2010-06-20 06:46:10,8651
339,0,9,348,"138 days, 20:15:10",2013-01-17 03:01:06,2010-02-01 10:32:08,2010-06-20 06:47:18,3930
176,138,475,789,"138 days, 20:33:10",2013-02-01 10:28:05,2010-02-01 10:32:08,2010-06-20 07:05:18,4837
916,124,297,1337,"138 days, 20:47:53",2013-01-31 09:15:06,2010-02-01 10:32:08,2010-06-20 07:20:01,4098
848,87,584,1519,"138 days, 20:55:33",2013-02-05 01:24:14,2010-02-01 10:32:08,2010-06-20 07:27:41,608
1248,3,24,1275,"138 days, 20:56:19",2013-02-01 00:49:33,2010-02-01 10:32:08,2010-06-20 07:28:27,4289
864,490,1408,2762,"139 days, 0:48:34",2013-02-05 10:58:42,2010-02-01 10:32:08,2010-06-20 11:20:42,4268
318,0,0,318,"139 days, 14:49:32",2012-11-22 02:21:56,2010-02-01 10:32:08,2010-06-21 01:21:40,1023
1307,843,1349,3499,"139 days, 15:54:03",2013-02-05 08:03:41,2010-02-01 10:32:08,2010-06-21 02:26:11,4158
500,672,940,2112,"139 days, 17:52:33",2013-02-05 06:05:36,2010-02-01 10:32:08,2010-06-21 04:24:41,6767
6,615,1136,1757,"139 days, 19:04:08",2013-02-10 10:42:47,2010-02-01 10:32:08,2010-06-21 05:36:16,924
144,1160,1506,2810,"139 days, 19:06:38",2013-02-07 04:43:40,2010-02-01 10:32:08,2010-06-21 05:38:46,5255
585,34,197,816,"139 days, 19:22:37",2013-01-31 07:13:18,2010-02-01 10:32:08,2010-06-21 05:54:45,249
203,330,325,858,"139 days, 22:47:02",2013-02-05 08:39:20,2010-02-01 10:32:08,2010-06-21 09:19:10,111
519,1,28,548,"140 days, 0:53:34",2013-01-29 05:12:05,2010-02-01 10:32:08,2010-06-21 11:25:42,5504
314,166,345,825,"140 days, 13:52:30",2013-02-04 01:32:39,2010-02-01 10:32:08,2010-06-22 00:24:38,8330
115,182,390,687,"140 days, 15:12:04",2013-02-06 04:08:14,2010-02-01 10:32:08,2010-06-22 01:44:12,8526
850,312,550,1712,"140 days, 15:43:58",2013-02-07 08:58:41,2010-02-01 10:32:08,2010-06-22 02:16:06,3075
201,509,638,1348,"140 days, 15:48:31",2013-02-07 01:14:47,2010-02-01 10:32:08,2010-06-22 02:20:39,4324
175,395,441,1011,"140 days, 16:14:14",2013-01-29 11:50:51,2010-02-01 10:32:08,2010-06-22 02:46:22,6836
439,82,293,814,"140 days, 16:31:46",2013-02-03 08:39:29,2010-02-01 10:32:08,2010-06-22 03:03:54,1078
63,246,458,767,"140 days, 17:15:27",2013-02-03 10:03:24,2010-02-01 10:32:08,2010-06-22 03:47:35,442
505,798,1866,3169,"140 days, 17:20:24",2013-02-08 02:06:22,2010-02-01 10:32:08,2010-06-22 03:52:32,4350
971,0,50,1021,"140 days, 17:35:29",2013-01-25 06:35:45,2010-02-01 10:32:08,2010-06-22 04:07:37,6519
771,94,178,1043,"140 days, 19:40:12",2013-01-28 01:59:51,2010-02-01 10:32:08,2010-06-22 06:12:20,9135
1315,1083,1389,3787,"140 days, 22:52:34",2013-02-06 07:14:02,2010-02-01 10:32:08,2010-06-22 09:24:42,2103
56,32,193,281,"141 days, 1:19:58",2013-02-04 10:10:52,2010-02-01 10:32:08,2010-06-22 11:52:06,3256
16,0,15,31,"141 days, 7:31:48",2013-01-01 08:41:46,2011-04-12 03:13:50,2011-08-31 10:45:38,3808
923,439,926,2288,"141 days, 15:47:34",2013-02-02 04:28:57,2010-02-01 10:32:08,2010-06-23 02:19:42,5407
528,1,42,571,"141 days, 16:05:25",2013-01-30 00:32:30,2010-02-01 10:32:08,2010-06-23 02:37:33,5805
288,3,7,298,"141 days, 16:10:18",2013-01-22 06:28:55,2010-02-01 10:32:08,2010-06-23 02:42:26,3082
51,192,332,575,"141 days, 16:14:11",2013-01-29 10:49:48,2010-02-01 10:32:08,2010-06-23 02:46:19,5618
109,733,1351,2193,"141 days, 17:04:20",2013-02-04 00:10:44,2010-02-01 10:32:08,2010-06-23 03:36:28,5751
1258,823,1389,3470,"141 days, 18:45:26",2013-02-06 00:50:25,2010-02-01 10:32:08,2010-06-23 05:17:34,6556
165,389,925,1479,"141 days, 19:15:44",2013-02-08 09:53:19,2010-02-01 10:32:08,2010-06-23 05:47:52,8382
568,1346,1737,3651,"141 days, 20:13:29",2013-02-05 11:44:39,2010-02-01 10:32:08,2010-06-23 06:45:37,5159
19,2,13,34,"141 days, 21:16:52",2013-01-29 01:45:40,2010-08-05 02:45:06,2010-12-25 00:01:58,9211
1239,4,78,1321,"141 days, 23:38:14",2013-01-29 05:03:23,2010-02-01 10:32:08,2010-06-23 10:10:22,4333
658,10,90,758,"142 days, 1:00:08",2013-02-02 07:44:47,2010-02-01 10:32:08,2010-06-23 11:32:16,1938
277,81,132,490,"142 days, 14:22:23",2013-02-06 05:41:08,2010-02-01 10:32:08,2010-06-24 00:54:31,3874
634,1165,1559,3358,"142 days, 14:50:58",2013-02-07 11:52:34,2010-02-01 10:32:08,2010-06-24 01:23:06,5827
16,2,52,70,"142 days, 15:50:24",2013-01-29 00:25:41,2010-02-01 10:32:08,2010-06-24 02:22:32,4703
896,284,785,1965,"142 days, 16:58:00",2013-02-11 05:46:10,2010-02-01 10:32:08,2010-06-24 03:30:08,7687
366,318,432,1116,"142 days, 17:07:44",2013-02-06 10:58:47,2010-02-01 10:32:08,2010-06-24 03:39:52,5232
636,3,34,673,"142 days, 17:39:25",2013-01-30 10:09:08,2010-02-01 10:32:08,2010-06-24 04:11:33,3166
802,593,928,2323,"142 days, 21:30:14",2013-02-07 09:17:18,2010-02-01 10:32:08,2010-06-24 08:02:22,4102
324,6,59,389,"142 days, 23:12:27",2013-01-24 06:07:55,2010-06-07 08:12:09,2010-10-28 07:24:36,9144
238,1262,1171,2671,"142 days, 23:25:54",2013-02-07 11:43:41,2010-02-01 10:32:08,2010-06-24 09:58:02,441
498,231,222,951,"143 days, 1:02:37",2013-02-03 01:30:10,2010-02-01 10:32:08,2010-06-24 11:34:45,6323
541,944,1564,3049,"143 days, 14:46:31",2013-02-06 04:18:08,2010-02-01 10:32:08,2010-06-25 01:18:39,4393
9,2,71,82,"143 days, 15:15:06",2013-02-04 11:38:14,2010-02-01 10:32:08,2010-06-25 01:47:14,9892
350,396,440,1186,"143 days, 15:54:38",2013-02-04 10:02:14,2010-02-01 10:32:08,2010-06-25 02:26:46,656
839,5,139,983,"143 days, 17:35:02",2013-01-27 05:43:05,2010-02-01 10:32:08,2010-06-25 04:07:10,9519
891,2,27,920,"143 days, 18:07:01",2013-01-28 09:29:55,2010-02-01 10:32:08,2010-06-25 04:39:09,5442
830,127,242,1199,"143 days, 18:24:13",2013-02-03 11:53:48,2010-02-01 10:32:08,2010-06-25 04:56:21,7726
447,148,126,721,"143 days, 19:27:02",2013-01-30 09:36:55,2010-02-01 10:32:08,2010-06-25 05:59:10,5054
891,3845,2820,7556,"143 days, 20:46:24",2013-02-08 08:01:01,2010-02-01 10:32:08,2010-06-25 07:18:32,3980
201,553,932,1686,"143 days, 21:01:31",2013-02-06 04:22:32,2010-02-01 10:32:08,2010-06-25 07:33:39,2247
332,71,269,672,"143 days, 21:15:06",2013-02-04 06:36:58,2010-02-01 10:32:08,2010-06-25 07:47:14,7684
734,351,645,1730,"144 days, 0:41:25",2013-02-04 01:22:58,2010-02-01 10:32:08,2010-06-25 11:13:33,6313
591,120,252,963,"144 days, 0:55:28",2013-01-29 06:59:51,2010-02-01 10:32:08,2010-06-25 11:27:36,7907
302,36,49,387,"144 days, 5:50:27",2013-02-05 05:35:55,2010-09-19 01:23:42,2011-02-10 07:14:09,9531
367,14,76,457,"144 days, 16:27:08",2013-02-03 07:32:51,2010-02-01 10:32:08,2010-06-26 02:59:16,551
612,1,154,767,"144 days, 16:52:58",2013-02-01 03:19:43,2010-02-01 10:32:08,2010-06-26 03:25:06,279
17,147,589,753,"144 days, 18:32:10",2013-02-05 01:47:32,2010-02-01 10:32:08,2010-06-26 05:04:18,6200
918,0,0,918,"144 days, 19:35:51",2013-01-29 07:11:27,2010-02-01 10:32:08,2010-06-26 06:07:59,5262
324,3,18,345,"144 days, 19:40:54",2013-02-03 07:01:23,2010-02-01 10:32:08,2010-06-26 06:13:02,5543
71,136,217,424,"144 days, 21:27:05",2013-02-04 01:32:23,2010-02-01 10:32:08,2010-06-26 07:59:13,6483
1042,45,63,1150,"144 days, 22:40:02",2013-02-01 11:55:44,2010-05-27 06:31:17,2010-10-19 05:11:19,5249
652,3,71,726,"144 days, 22:42:12",2013-01-17 04:15:22,2010-02-01 10:32:08,2010-06-26 09:14:20,3350
101,123,342,566,"144 days, 22:49:21",2013-02-04 06:11:33,2010-02-01 10:32:08,2010-06-26 09:21:29,6550
18,61,233,312,"144 days, 23:26:21",2013-02-02 01:36:11,2010-02-01 10:32:08,2010-06-26 09:58:29,2217
4,339,680,1023,"145 days, 1:05:44",2013-02-05 07:23:00,2010-02-01 10:32:08,2010-06-26 11:37:52,7097
174,294,701,1169,"145 days, 1:19:21",2013-02-06 03:26:48,2010-02-01 10:32:08,2010-06-26 11:51:29,1432
137,0,35,172,"145 days, 14:04:35",2013-01-29 00:20:23,2010-05-08 10:02:21,2010-10-01 00:06:56,923
166,681,941,1788,"145 days, 14:44:08",2013-02-07 11:33:37,2010-02-01 10:32:08,2010-06-27 01:16:16,7634
23,121,314,458,"145 days, 15:53:38",2013-02-04 10:44:54,2010-02-01 10:32:08,2010-06-27 02:25:46,1884
934,418,761,2113,"145 days, 17:22:57",2013-02-06 10:29:08,2010-02-01 10:32:08,2010-06-27 03:55:05,682
298,34,199,531,"145 days, 17:26:29",2013-02-05 00:34:01,2010-02-01 10:32:08,2010-06-27 03:58:37,2187
192,286,649,1127,"145 days, 17:48:37",2013-02-07 03:51:42,2010-02-01 10:32:08,2010-06-27 04:20:45,695
940,905,2147,3992,"145 days, 18:06:00",2013-02-06 10:33:28,2010-02-01 10:32:08,2010-06-27 04:38:08,112
741,7,100,848,"145 days, 19:33:05",2013-01-28 11:04:58,2010-02-01 10:32:08,2010-06-27 06:05:13,7733
373,41,134,548,"145 days, 22:39:07",2013-02-05 08:32:36,2010-02-01 10:32:08,2010-06-27 09:11:15,6833
334,1,0,335,"145 days, 22:46:48",2013-01-14 05:39:47,2010-02-01 10:32:08,2010-06-27 09:18:56,533
86,6,43,135,"145 days, 23:55:29",2013-02-03 04:21:54,2011-06-13 08:24:38,2011-11-06 08:20:07,4432
544,0,29,573,"146 days, 15:11:35",2013-01-21 03:18:58,2010-02-01 10:32:08,2010-06-28 01:43:43,1843
637,0,8,645,"146 days, 19:50:44",2013-02-05 08:02:57,2010-02-01 10:32:08,2010-06-28 06:22:52,7292
1175,599,1192,2966,"146 days, 19:55:42",2013-02-04 03:12:29,2010-02-01 10:32:08,2010-06-28 06:27:50,4077
17,838,960,1815,"146 days, 20:40:35",2013-02-05 06:29:07,2010-02-01 10:32:08,2010-06-28 07:12:43,2025
839,0,0,839,"146 days, 21:26:51",2013-01-19 07:55:29,2010-02-01 10:32:08,2010-06-28 07:58:59,8927
97,172,146,415,"146 days, 21:55:14",2013-02-02 11:29:00,2010-02-01 10:32:08,2010-06-28 08:27:22,5117
25,0,4,29,"147 days, 0:36:41",2013-01-19 01:37:39,2010-06-06 08:28:47,2010-10-31 09:05:28,2596
35,173,316,524,"147 days, 1:24:21",2013-02-04 00:53:53,2010-02-01 10:32:08,2010-06-28 11:56:29,2149
238,1,36,275,"147 days, 9:53:41",2013-01-24 10:15:36,2011-01-03 01:17:33,2011-05-30 11:11:14,5173
896,0,19,915,"147 days, 14:12:52",2013-01-27 10:20:05,2010-02-01 10:32:08,2010-06-29 00:45:00,1588
412,2,39,453,"147 days, 15:35:08",2013-01-25 10:00:50,2010-02-01 10:32:08,2010-06-29 02:07:16,5569
659,191,155,1005,"147 days, 15:49:17",2013-01-31 09:21:01,2010-02-01 10:32:08,2010-06-29 02:21:25,9123
44,701,1791,2536,"147 days, 17:20:32",2013-02-06 04:08:52,2010-02-01 10:32:08,2010-06-29 03:52:40,8961
408,16,234,658,"147 days, 19:14:44",2013-02-04 09:33:23,2010-02-01 10:32:08,2010-06-29 05:46:52,6845
910,276,578,1764,"147 days, 20:11:35",2013-02-05 00:05:48,2010-02-01 10:32:08,2010-06-29 06:43:43,8126
462,58,293,813,"147 days, 20:30:31",2013-02-04 06:38:00,2010-02-01 10:32:08,2010-06-29 07:02:39,8758
2,1,17,20,"147 days, 21:06:21",2013-01-27 01:45:56,2011-09-27 05:55:51,2012-02-22 03:02:12,7522
292,53,188,533,"147 days, 21:51:41",2013-02-05 07:07:04,2010-02-01 10:32:08,2010-06-29 08:23:49,5168
826,16,99,941,"148 days, 0:40:57",2013-02-03 05:13:33,2010-02-01 10:32:08,2010-06-29 11:13:05,2792
33,173,434,640,"148 days, 2:44:58",2013-02-05 01:40:02,2010-06-27 07:03:23,2010-11-22 09:48:21,974
358,308,736,1402,"148 days, 13:32:52",2013-02-05 10:08:34,2010-02-01 10:32:08,2010-06-30 00:05:00,8865
18,51,310,379,"148 days, 13:43:27",2013-02-09 00:06:23,2010-02-01 10:32:08,2010-06-30 00:15:35,3695
46,36,295,377,"148 days, 15:05:23",2013-01-28 01:39:21,2010-02-01 10:32:08,2010-06-30 01:37:31,8964
302,757,1524,2583,"148 days, 17:23:08",2013-02-06 10:14:13,2010-02-01 10:32:08,2010-06-30 03:55:16,5071
8,16,82,106,"148 days, 17:51:25",2013-02-04 00:09:54,2010-02-01 10:32:08,2010-06-30 04:23:33,9258
3,6,37,46,"148 days, 19:13:08",2013-01-25 07:38:50,2011-06-27 05:25:20,2011-11-23 00:38:28,8445
346,232,292,870,"148 days, 19:34:16",2013-02-07 06:21:19,2010-02-01 10:32:08,2010-06-30 06:06:24,4194
964,66,115,1145,"148 days, 19:37:43",2013-02-06 09:46:16,2010-02-01 10:32:08,2010-06-30 06:09:51,9327
735,40,115,890,"148 days, 20:43:44",2013-02-07 06:03:05,2010-02-01 10:32:08,2010-06-30 07:15:52,9609
296,2,34,332,"149 days, 0:36:46",2013-01-28 05:09:30,2010-02-01 10:32:08,2010-06-30 11:08:54,1895
571,3,11,585,"149 days, 0:51:40",2013-01-22 00:20:50,2010-05-03 10:34:58,2010-09-29 11:26:38,1231
5,95,504,604,"149 days, 5:08:35",2013-02-04 05:18:39,2010-05-14 03:57:40,2010-10-10 09:06:15,3540
726,108,452,1286,"149 days, 13:42:48",2013-02-04 09:29:45,2010-02-01 10:32:08,2010-07-01 00:14:56,1449
576,0,71,647,"149 days, 14:21:22",2013-02-02 10:06:12,2010-02-01 10:32:08,2010-07-01 00:53:30,7085
18,221,298,537,"149 days, 14:51:32",2013-02-02 00:32:19,2010-02-01 10:32:08,2010-07-01 01:23:40,6115
1,1,21,23,"149 days, 16:36:47",2013-01-05 09:25:04,2010-02-01 10:32:08,2010-07-01 03:08:55,932
525,858,1171,2554,"149 days, 16:56:30",2013-02-07 01:43:09,2010-02-01 10:32:08,2010-07-01 03:28:38,1350
638,1,26,665,"149 days, 17:11:28",2013-01-31 08:44:04,2010-02-01 10:32:08,2010-07-01 03:43:36,9952
25,952,847,1824,"149 days, 21:27:17",2013-02-04 10:26:53,2010-02-01 10:32:08,2010-07-01 07:59:25,2152
931,4,18,953,"149 days, 21:54:46",2013-01-16 02:18:51,2010-02-01 10:32:08,2010-07-01 08:26:54,5312
13,1,24,38,"149 days, 23:20:24",2012-12-18 11:31:54,2011-09-19 09:05:33,2012-02-16 08:25:57,3231
354,1,25,380,"149 days, 23:53:55",2013-02-04 06:05:52,2010-02-01 10:32:08,2010-07-01 10:26:03,3948
1101,6,52,1159,"150 days, 0:21:47",2013-01-29 00:04:13,2010-02-01 10:32:08,2010-07-01 10:53:55,1015
277,78,196,551,"150 days, 1:01:21",2013-01-30 05:16:55,2010-02-01 10:32:08,2010-07-01 11:33:29,2049
706,84,200,990,"150 days, 5:28:40",2013-02-06 08:03:43,2010-05-07 01:58:51,2010-10-04 07:27:31,1025
245,161,372,778,"150 days, 13:46:20",2013-02-04 02:12:36,2010-02-01 10:32:08,2010-07-02 00:18:28,4443
633,650,632,1915,"150 days, 14:49:25",2013-02-01 07:59:23,2010-02-01 10:32:08,2010-07-02 01:21:33,198
24,442,630,1096,"150 days, 15:14:33",2013-02-05 10:11:18,2010-02-01 10:32:08,2010-07-02 01:46:41,1133
441,3,38,482,"150 days, 15:38:44",2013-01-27 04:09:40,2010-02-01 10:32:08,2010-07-02 02:10:52,216
15,0,25,40,"150 days, 19:56:12",2013-01-28 03:57:07,2011-02-10 06:38:15,2011-07-11 02:34:27,2903
733,499,886,2118,"150 days, 20:34:42",2013-02-04 09:28:52,2010-02-01 10:32:08,2010-07-02 07:06:50,9158
322,0,34,356,"150 days, 20:44:23",2013-02-01 07:24:10,2010-02-01 10:32:08,2010-07-02 07:16:31,3962
128,182,638,948,"150 days, 23:02:40",2013-01-29 07:30:09,2010-02-01 10:32:08,2010-07-02 09:34:48,8645
208,220,427,855,"150 days, 23:09:53",2013-02-02 01:04:23,2010-02-01 10:32:08,2010-07-02 09:42:01,1177
19,0,41,60,"150 days, 23:24:31",2012-12-23 04:41:26,2010-02-01 10:32:08,2010-07-02 09:56:39,8150
30,119,462,611,"150 days, 23:38:23",2013-02-04 11:17:40,2010-02-01 10:32:08,2010-07-02 10:10:31,4400
422,432,462,1316,"151 days, 1:03:58",2013-02-01 07:19:41,2010-02-01 10:32:08,2010-07-02 11:36:06,1384
191,3,52,246,"151 days, 1:04:44",2013-01-26 02:29:47,2010-09-13 10:07:14,2011-02-11 11:11:58,7022
19,245,505,769,"151 days, 1:11:46",2013-02-14 10:44:38,2010-02-01 10:32:08,2010-07-02 11:43:54,19
326,548,751,1625,"151 days, 1:15:45",2013-02-03 01:41:23,2010-02-01 10:32:08,2010-07-02 11:47:53,1355
176,60,195,431,"151 days, 14:49:18",2013-02-01 08:12:41,2010-02-01 10:32:08,2010-07-03 01:21:26,3526
474,2,48,524,"151 days, 15:20:53",2013-02-02 00:40:49,2010-02-01 10:32:08,2010-07-03 01:53:01,718
11,714,1373,2098,"151 days, 15:21:39",2013-02-05 09:40:17,2010-02-01 10:32:08,2010-07-03 01:53:47,18
576,9,189,774,"151 days, 15:55:57",2013-01-28 04:28:00,2010-02-01 10:32:08,2010-07-03 02:28:05,8363
128,412,498,1038,"151 days, 16:47:18",2013-02-04 06:27:05,2010-02-01 10:32:08,2010-07-03 03:19:26,6735
844,0,37,881,"151 days, 16:57:40",2013-01-27 02:47:31,2010-02-01 10:32:08,2010-07-03 03:29:48,5272
941,99,188,1228,"151 days, 19:15:30",2013-01-30 00:56:48,2010-02-01 10:32:08,2010-07-03 05:47:38,7740
463,2,155,620,"151 days, 19:25:30",2013-02-01 00:36:42,2010-02-01 10:32:08,2010-07-03 05:57:38,7077
485,109,498,1092,"151 days, 19:51:28",2013-02-03 01:00:12,2010-02-01 10:32:08,2010-07-03 06:23:36,3108
374,183,253,810,"151 days, 20:53:10",2013-01-25 10:33:07,2010-02-01 10:32:08,2010-07-03 07:25:18,241
166,564,692,1422,"151 days, 21:41:25",2013-02-06 01:28:03,2010-02-01 10:32:08,2010-07-03 08:13:33,8529
16,1,35,52,"151 days, 22:54:41",2013-01-13 02:49:23,2010-02-01 10:32:08,2010-07-03 09:26:49,4973
363,351,336,1050,"152 days, 0:12:36",2013-02-06 01:55:29,2010-02-01 10:32:08,2010-07-03 10:44:44,5357
5,350,561,916,"152 days, 16:33:19",2013-02-04 03:48:27,2010-02-01 10:32:08,2010-07-04 03:05:27,1574
29,598,1104,1731,"152 days, 16:50:33",2013-02-07 05:05:39,2010-02-01 10:32:08,2010-07-04 03:22:41,1393
506,25,77,608,"152 days, 17:21:15",2013-01-30 04:48:13,2010-02-01 10:32:08,2010-07-04 03:53:23,2979
321,54,182,557,"152 days, 19:06:19",2013-02-05 05:48:43,2010-03-11 09:30:50,2010-08-11 04:37:09,9775
229,926,1728,2883,"152 days, 19:31:29",2013-02-06 10:19:19,2010-02-01 10:32:08,2010-07-04 06:03:37,4555
0,2,53,55,"152 days, 19:50:43",2013-02-03 04:25:16,2010-02-01 10:32:08,2010-07-04 06:22:51,5189
277,96,452,825,"152 days, 22:06:00",2013-01-28 06:43:56,2010-02-01 10:32:08,2010-07-04 08:38:08,5570
515,1,51,567,"153 days, 0:17:57",2013-01-30 06:40:43,2010-02-01 10:32:08,2010-07-04 10:50:05,3457
1245,3,53,1301,"153 days, 14:05:54",2013-02-05 00:14:10,2010-02-01 10:32:08,2010-07-05 00:38:02,1954
232,43,314,589,"153 days, 15:04:19",2013-02-07 03:46:00,2010-02-01 10:32:08,2010-07-05 01:36:27,416
531,3,0,534,"153 days, 15:28:40",2013-01-26 01:04:55,2010-02-01 10:32:08,2010-07-05 02:00:48,5641
377,1,48,426,"153 days, 19:18:22",2013-01-30 10:58:49,2010-02-01 10:32:08,2010-07-05 05:50:30,7832
429,175,333,937,"153 days, 20:43:35",2013-02-01 03:33:37,2010-02-01 10:32:08,2010-07-05 07:15:43,9882
540,162,294,996,"153 days, 21:28:57",2013-02-03 06:17:31,2010-02-01 10:32:08,2010-07-05 08:01:05,6809
437,19,134,590,"153 days, 22:32:07",2013-01-31 09:46:30,2010-02-01 10:32:08,2010-07-05 09:04:15,1645
1251,83,277,1611,"153 days, 22:37:41",2013-02-03 10:47:57,2010-02-01 10:32:08,2010-07-05 09:09:49,3789
56,103,283,442,"153 days, 23:10:21",2013-02-07 00:23:40,2010-02-01 10:32:08,2010-07-05 09:42:29,7438
260,66,237,563,"154 days, 1:11:04",2013-02-05 09:00:08,2010-02-01 10:32:08,2010-07-05 11:43:12,9586
0,2,26,28,"154 days, 5:17:34",2012-12-24 00:54:49,2012-03-24 03:09:12,2012-08-25 08:26:46,61
271,0,26,297,"154 days, 14:07:19",2013-01-27 11:10:17,2010-02-01 10:32:08,2010-07-06 00:39:27,8216
716,19,560,1295,"154 days, 14:16:03",2013-02-01 00:03:21,2010-02-01 10:32:08,2010-07-06 00:48:11,1964
75,45,150,270,"154 days, 14:47:58",2013-02-04 07:32:36,2010-02-01 10:32:08,2010-07-06 01:20:06,7706
269,0,0,269,"154 days, 15:28:43",2013-01-31 09:18:35,2010-02-01 10:32:08,2010-07-06 02:00:51,8596
845,431,823,2099,"154 days, 16:50:16",2013-02-04 09:11:02,2010-02-01 10:32:08,2010-07-06 03:22:24,8771
349,0,2,351,"154 days, 16:50:22",2013-01-16 02:07:18,2010-02-01 10:32:08,2010-07-06 03:22:30,6830
11,794,987,1792,"154 days, 17:34:58",2013-02-06 11:12:21,2010-02-01 10:32:08,2010-07-06 04:07:06,2039
1223,4,41,1268,"154 days, 17:49:35",2013-02-01 09:00:11,2010-02-01 10:32:08,2010-07-06 04:21:43,957
186,64,224,474,"154 days, 18:56:09",2013-02-04 11:10:36,2010-02-01 10:32:08,2010-07-06 05:28:17,6939
26,21,121,168,"154 days, 19:01:26",2013-01-29 06:55:44,2010-02-01 10:32:08,2010-07-06 05:33:34,788
468,437,602,1507,"154 days, 21:18:49",2013-02-02 06:27:35,2010-02-01 10:32:08,2010-07-06 07:50:57,9967
1113,2,89,1204,"154 days, 22:40:16",2013-01-26 10:23:37,2010-02-01 10:32:08,2010-07-06 09:12:24,5443
291,1,0,292,"154 days, 22:52:05",2013-01-16 08:50:03,2010-02-01 10:32:08,2010-07-06 09:24:13,5994
939,127,277,1343,"154 days, 22:55:51",2013-02-07 07:16:16,2010-02-01 10:32:08,2010-07-06 09:27:59,8432
534,196,608,1338,"154 days, 23:08:54",2013-02-04 06:18:07,2010-02-01 10:32:08,2010-07-06 09:41:02,4467
448,138,256,842,"154 days, 23:28:38",2013-02-01 05:32:16,2010-02-01 10:32:08,2010-07-06 10:00:46,9143
265,54,656,975,"154 days, 23:47:43",2013-02-04 05:56:38,2010-02-01 10:32:08,2010-07-06 10:19:51,6808
860,268,276,1404,"155 days, 0:58:23",2013-02-04 06:00:28,2010-02-01 10:32:08,2010-07-06 11:30:31,7417
345,46,250,641,"155 days, 14:08:15",2013-01-29 11:32:43,2010-02-01 10:32:08,2010-07-07 00:40:23,5798
28,417,580,1025,"155 days, 20:36:48",2013-02-02 03:35:43,2010-02-01 10:32:08,2010-07-07 07:08:56,1255
256,293,345,894,"155 days, 22:56:29",2013-02-06 07:29:44,2010-02-01 10:32:08,2010-07-07 09:28:37,9372
230,2,42,274,"155 days, 23:15:19",2013-01-28 11:33:17,2010-04-02 05:44:42,2010-09-05 05:00:01,6277
1017,154,411,1582,"155 days, 23:53:11",2013-02-03 11:25:44,2010-02-01 10:32:08,2010-07-07 10:25:19,5342
195,622,1285,2102,"156 days, 0:02:16",2013-02-07 11:46:18,2010-02-01 10:32:08,2010-07-07 10:34:24,5936
37,2,21,60,"156 days, 0:14:51",2013-02-01 04:24:14,2010-02-01 10:32:08,2010-07-07 10:46:59,865
734,2,0,736,"156 days, 4:12:20",2013-01-21 01:19:18,2010-06-05 05:12:43,2010-11-08 09:25:03,8796
175,622,905,1702,"156 days, 13:34:22",2013-02-06 08:42:44,2010-02-01 10:32:08,2010-07-08 00:06:30,4482
589,1174,1765,3528,"156 days, 16:10:16",2013-02-05 03:37:16,2010-02-01 10:32:08,2010-07-08 02:42:24,1996
24,386,690,1100,"156 days, 17:28:09",2013-02-05 05:48:52,2010-02-01 10:32:08,2010-07-08 04:00:17,1284
432,6,88,526,"156 days, 19:27:13",2013-01-29 07:26:03,2010-02-01 10:32:08,2010-07-08 05:59:21,9267
92,275,441,808,"156 days, 22:01:38",2013-01-31 03:17:21,2010-02-01 10:32:08,2010-07-08 08:33:46,202
448,6,80,534,"156 days, 22:03:43",2013-01-25 10:28:12,2010-02-01 10:32:08,2010-07-08 08:35:51,7897
278,198,391,867,"157 days, 0:50:38",2013-02-05 06:05:16,2010-02-01 10:32:08,2010-07-08 11:22:46,6034
1017,1,21,1039,"157 days, 5:59:52",2013-01-31 04:39:06,2010-05-28 01:00:20,2010-11-01 07:00:12,4273
479,173,514,1166,"157 days, 14:21:19",2013-02-04 11:00:04,2010-02-01 10:32:08,2010-07-09 00:53:27,4495
548,240,300,1088,"157 days, 17:10:09",2013-02-04 04:43:50,2010-02-01 10:32:08,2010-07-09 03:42:17,823
1016,0,22,1038,"157 days, 17:50:50",2013-01-14 00:23:53,2010-02-01 10:32:08,2010-07-09 04:22:58,8039
9,156,189,354,"157 days, 18:08:46",2013-02-04 09:02:34,2010-02-01 10:32:08,2010-07-09 04:40:54,8525
263,28,294,585,"157 days, 18:32:38",2013-02-06 03:46:19,2010-02-01 10:32:08,2010-07-09 05:04:46,4561
300,117,366,783,"157 days, 21:01:03",2013-02-01 07:36:59,2010-02-01 10:32:08,2010-07-09 07:33:11,652
275,1,208,484,"157 days, 22:58:54",2013-01-31 08:11:21,2010-02-01 10:32:08,2010-07-09 09:31:02,3229
259,447,601,1307,"158 days, 0:55:17",2013-01-31 02:57:47,2010-02-01 10:32:08,2010-07-09 11:27:25,3088
922,105,234,1261,"158 days, 13:28:56",2013-02-05 09:44:42,2010-02-01 10:32:08,2010-07-10 00:01:04,540
191,454,544,1189,"158 days, 16:17:02",2013-02-05 09:40:00,2010-02-01 10:32:08,2010-07-10 02:49:10,630
1250,0,0,1250,"158 days, 17:22:21",2013-01-31 07:34:14,2010-02-01 10:32:08,2010-07-10 03:54:29,8079
41,134,154,329,"158 days, 19:14:38",2013-02-02 06:33:08,2010-02-01 10:32:08,2010-07-10 05:46:46,5267
623,150,131,904,"158 days, 20:01:32",2013-02-06 03:40:29,2010-10-03 11:59:09,2011-03-11 08:00:41,2699
727,0,30,757,"158 days, 20:07:40",2013-01-23 04:45:09,2010-02-01 10:32:08,2010-07-10 06:39:48,4852
492,23,154,669,"158 days, 22:15:08",2013-02-01 03:27:45,2010-02-01 10:32:08,2010-07-10 08:47:16,2799
277,192,1093,1562,"159 days, 13:30:51",2013-02-06 01:14:00,2010-02-01 10:32:08,2010-07-11 00:02:59,2844
220,1010,1048,2278,"159 days, 13:50:49",2013-02-05 07:49:30,2010-02-01 10:32:08,2010-07-11 00:22:57,6236
328,1,92,421,"159 days, 14:00:07",2013-02-03 08:34:20,2010-02-01 10:32:08,2010-07-11 00:32:15,3500
40,129,575,744,"159 days, 16:12:18",2013-02-02 07:40:32,2010-02-01 10:32:08,2010-07-11 02:44:26,2841
384,592,1327,2303,"159 days, 16:12:57",2013-02-07 00:02:42,2010-02-01 10:32:08,2010-07-11 02:45:05,7502
7,0,11,18,"159 days, 17:47:02",2013-01-28 07:55:27,2010-02-01 10:32:08,2010-07-11 04:19:10,3014
440,2,95,537,"159 days, 22:24:47",2013-02-01 08:44:55,2010-02-01 10:32:08,2010-07-11 08:56:55,5310
278,2,33,313,"160 days, 0:55:55",2013-01-25 11:38:07,2010-02-01 10:32:08,2010-07-11 11:28:03,1331
23,6,96,125,"160 days, 22:14:08",2013-01-29 05:03:43,2010-02-01 10:32:08,2010-07-12 08:46:16,6391
86,247,1081,1414,"161 days, 0:26:17",2013-02-07 09:14:04,2010-02-01 10:32:08,2010-07-12 10:58:25,3877
901,14,84,999,"161 days, 1:20:00",2013-01-27 05:56:12,2010-02-01 10:32:08,2010-07-12 11:52:08,1711
196,186,134,516,"161 days, 14:43:34",2013-01-31 11:51:17,2010-02-01 10:32:08,2010-07-13 01:15:42,5381
649,74,307,1030,"161 days, 17:36:09",2013-02-04 08:13:45,2010-02-01 10:32:08,2010-07-13 04:08:17,2157
241,2,14,257,"161 days, 18:12:17",2013-01-31 02:19:07,2010-02-01 10:32:08,2010-07-13 04:44:25,2658
16,264,508,788,"161 days, 18:55:29",2013-02-02 11:38:22,2010-02-01 10:32:08,2010-07-13 05:27:37,8172
242,1,58,301,"161 days, 19:13:07",2013-01-20 01:28:59,2010-02-01 10:32:08,2010-07-13 05:45:15,4922
7,20,194,221,"161 days, 19:30:30",2013-02-01 10:29:15,2010-02-01 10:32:08,2010-07-13 06:02:38,9560
42,478,735,1255,"161 days, 21:26:29",2013-02-09 01:38:02,2010-02-01 10:32:08,2010-07-13 07:58:37,6104
262,128,230,620,"161 days, 23:10:47",2013-02-03 04:12:26,2010-02-01 10:32:08,2010-07-13 09:42:55,298
3,4,28,35,"161 days, 23:42:11",2012-12-25 11:41:33,2012-03-11 01:46:42,2012-08-20 01:28:53,9523
1138,341,646,2125,"162 days, 0:11:08",2013-02-04 05:25:14,2010-02-01 10:32:08,2010-07-13 10:43:16,6051
2,242,279,523,"162 days, 18:40:50",2013-02-07 09:14:26,2010-02-01 10:32:08,2010-07-14 05:12:58,6073
567,172,209,948,"162 days, 23:35:17",2013-01-30 09:11:59,2010-02-01 10:32:08,2010-07-14 10:07:25,384
906,185,255,1346,"163 days, 16:11:14",2013-01-31 11:44:23,2010-02-01 10:32:08,2010-07-15 02:43:22,5145
55,0,61,116,"163 days, 16:11:44",2013-01-14 00:51:24,2010-02-01 10:32:08,2010-07-15 02:43:52,8856
126,979,747,1852,"163 days, 17:19:10",2013-02-05 04:07:30,2010-02-01 10:32:08,2010-07-15 03:51:18,6196
38,71,131,240,"163 days, 17:51:13",2013-02-02 03:31:16,2010-02-01 10:32:08,2010-07-15 04:23:21,8951
143,5,28,176,"163 days, 18:32:51",2013-01-28 00:57:56,2010-12-04 08:59:04,2011-05-17 03:31:55,6184
428,140,410,978,"163 days, 21:24:29",2013-02-04 01:41:01,2010-02-01 10:32:08,2010-07-15 07:56:37,4644
312,19,60,391,"163 days, 22:06:04",2013-02-05 05:17:41,2010-02-01 10:32:08,2010-07-15 08:38:12,4340
21,1,5,27,"163 days, 23:50:42",2013-02-03 03:11:59,2011-02-26 09:14:48,2011-08-09 09:05:30,6175
266,114,96,476,"164 days, 1:08:34",2013-01-29 00:29:23,2010-02-01 10:32:08,2010-07-15 11:40:42,4095
691,37,14,742,"164 days, 13:21:32",2013-01-25 05:09:31,2011-02-21 11:24:01,2011-08-05 00:45:33,5663
753,323,587,1663,"164 days, 14:33:13",2013-02-04 03:39:46,2010-02-01 10:32:08,2010-07-16 01:05:21,9589
1112,1,25,1138,"164 days, 15:16:29",2013-01-20 07:46:36,2010-02-01 10:32:08,2010-07-16 01:48:37,8469
9,1,61,71,"164 days, 19:30:57",2013-02-01 08:50:13,2010-02-01 10:32:08,2010-07-16 06:03:05,2451
934,0,6,940,"165 days, 0:53:54",2013-01-29 00:54:57,2010-02-01 10:32:08,2010-07-16 11:26:02,523
25,4,57,86,"165 days, 4:59:04",2013-01-20 06:39:43,2010-05-14 03:50:24,2010-10-26 08:49:28,9863
133,72,286,491,"165 days, 16:10:13",2013-02-05 05:44:52,2010-02-01 10:32:08,2010-07-17 02:42:21,6592
4,9,100,113,"165 days, 16:56:55",2013-01-29 11:31:29,2010-02-01 10:32:08,2010-07-17 03:29:03,9416
18,0,24,42,"165 days, 17:48:24",2013-01-16 10:22:02,2010-02-01 10:32:08,2010-07-17 04:20:32,7729
19,25,182,226,"165 days, 18:15:45",2013-02-08 05:18:16,2010-02-01 10:32:08,2010-07-17 04:47:53,6097
234,176,638,1048,"165 days, 18:20:40",2013-02-03 05:45:50,2010-02-01 10:32:08,2010-07-17 04:52:48,8772
953,0,0,953,"165 days, 20:09:56",2013-01-29 06:20:25,2010-02-01 10:32:08,2010-07-17 06:42:04,7640
29,337,248,614,"166 days, 0:48:45",2013-02-05 11:48:07,2010-02-01 10:32:08,2010-07-17 11:20:53,1819
672,292,404,1368,"166 days, 13:31:13",2013-02-03 01:22:36,2010-02-01 10:32:08,2010-07-18 00:03:21,688
1266,186,370,1822,"166 days, 14:53:47",2013-02-03 09:34:18,2010-02-01 10:32:08,2010-07-18 01:25:55,329
672,384,1233,2289,"166 days, 15:49:56",2013-02-07 03:00:20,2010-02-01 10:32:08,2010-07-18 02:22:04,7347
1008,12,138,1158,"166 days, 17:08:48",2013-02-02 08:57:38,2010-02-01 10:32:08,2010-07-18 03:40:56,3614
4,8,265,277,"166 days, 18:14:34",2013-02-05 04:29:59,2010-02-01 10:32:08,2010-07-18 04:46:42,9844
98,3,30,131,"166 days, 18:19:35",2013-01-29 10:29:36,2010-02-01 10:32:08,2010-07-18 04:51:43,2370
1022,0,3,1025,"166 days, 18:23:03",2013-02-02 07:55:51,2010-02-01 10:32:08,2010-07-18 04:55:11,3834
782,2,30,814,"166 days, 20:08:16",2013-02-06 05:37:59,2010-05-16 05:35:50,2010-10-30 01:44:06,3904
154,182,403,739,"166 days, 21:17:59",2013-02-06 11:24:05,2010-02-01 10:32:08,2010-07-18 07:50:07,3399
629,3,80,712,"166 days, 22:40:29",2013-02-06 06:08:12,2010-02-01 10:32:08,2010-07-18 09:12:37,3660
285,4,66,355,"166 days, 22:52:12",2013-02-02 09:31:30,2010-02-01 10:32:08,2010-07-18 09:24:20,80
4,1,13,18,"166 days, 23:24:11",2013-01-14 04:52:04,2012-07-31 05:27:53,2013-01-14 04:52:04,2738
272,450,711,1433,"166 days, 23:45:52",2013-02-06 00:14:14,2010-02-01 10:32:08,2010-07-18 10:18:00,9566
644,359,554,1557,"167 days, 1:00:17",2013-02-05 00:30:38,2010-02-01 10:32:08,2010-07-18 11:32:25,4845
141,64,462,667,"167 days, 1:11:29",2013-02-04 10:55:24,2010-02-01 10:32:08,2010-07-18 11:43:37,9386
207,235,630,1072,"167 days, 14:06:49",2013-02-02 05:40:44,2010-02-01 10:32:08,2010-07-19 00:38:57,4762
120,129,294,543,"167 days, 15:47:17",2013-01-30 01:10:15,2010-02-01 10:32:08,2010-07-19 02:19:25,6890
345,0,0,345,"167 days, 16:04:53",2013-01-03 11:39:32,2010-02-01 10:32:08,2010-07-19 02:37:01,6881
141,353,829,1323,"167 days, 19:43:00",2013-02-04 04:49:23,2010-02-01 10:32:08,2010-07-19 06:15:08,9766
338,2015,2883,5236,"167 days, 21:08:53",2013-03-02 05:25:40,2010-02-01 10:32:08,2010-07-19 07:41:01,7366
117,4,61,182,"167 days, 21:50:14",2013-01-31 05:37:40,2010-02-01 10:32:08,2010-07-19 08:22:22,3658
256,0,27,283,"167 days, 22:49:47",2012-12-13 07:17:10,2010-02-01 10:32:08,2010-07-19 09:21:55,3343
21,83,291,395,"167 days, 23:10:42",2013-02-05 04:22:47,2010-02-01 10:32:08,2010-07-19 09:42:50,5403
189,73,286,548,"167 days, 23:15:46",2013-02-05 01:52:29,2010-02-01 10:32:08,2010-07-19 09:47:54,5878
21,33,152,206,"168 days, 1:05:37",2013-01-31 09:41:58,2010-02-01 10:32:08,2010-07-19 11:37:45,634
801,174,392,1367,"168 days, 13:56:03",2013-02-06 02:23:27,2010-02-01 10:32:08,2010-07-20 00:28:11,6552
320,39,16,375,"168 days, 14:39:21",2013-02-06 06:19:04,2010-02-01 10:32:08,2010-07-20 01:11:29,9040
319,33,141,493,"168 days, 14:40:28",2013-02-02 00:25:09,2010-02-01 10:32:08,2010-07-20 01:12:36,7093
262,84,565,911,"168 days, 15:08:17",2013-01-30 07:45:04,2010-02-01 10:32:08,2010-07-20 01:40:25,7844
550,2,115,667,"168 days, 15:29:02",2013-01-28 08:32:54,2010-02-01 10:32:08,2010-07-20 02:01:10,8957
510,28,195,733,"168 days, 16:51:49",2013-01-31 08:06:08,2010-02-01 10:32:08,2010-07-20 03:23:57,2983
665,154,291,1110,"168 days, 20:11:24",2013-01-30 07:23:42,2010-02-01 10:32:08,2010-07-20 06:43:32,4592
767,107,187,1061,"169 days, 14:04:52",2013-02-01 00:29:03,2010-02-01 10:32:08,2010-07-21 00:37:00,9876
350,3,31,384,"169 days, 14:14:01",2013-02-05 00:13:40,2010-02-01 10:32:08,2010-07-21 00:46:09,7663
645,0,8,653,"169 days, 17:47:57",2013-01-18 09:50:45,2010-02-01 10:32:08,2010-07-21 04:20:05,5124
186,180,584,950,"169 days, 19:42:51",2013-02-02 02:56:02,2010-02-01 10:32:08,2010-07-21 06:14:59,8969
15,0,313,328,"169 days, 20:05:15",2013-01-24 10:16:10,2011-02-15 10:26:34,2011-08-04 06:31:49,5128
1199,54,216,1469,"169 days, 20:26:45",2013-02-02 02:04:53,2010-02-01 10:32:08,2010-07-21 06:58:53,9075
178,106,516,800,"169 days, 21:04:32",2013-02-06 06:20:26,2010-02-01 10:32:08,2010-07-21 07:36:40,3960
386,1,0,387,"169 days, 21:57:58",2013-01-31 06:15:31,2010-02-01 10:32:08,2010-07-21 08:30:06,768
600,2,26,628,"170 days, 0:07:45",2013-01-31 04:02:18,2010-02-01 10:32:08,2010-07-21 10:39:53,607
21,218,453,692,"170 days, 1:04:29",2013-02-05 11:51:53,2010-02-01 10:32:08,2010-07-21 11:36:37,4001
132,1,31,164,"170 days, 4:01:46",2013-01-26 09:33:51,2012-03-02 07:05:07,2012-08-19 11:06:53,1642
211,118,278,607,"170 days, 13:48:08",2013-02-03 00:56:54,2010-02-01 10:32:08,2010-07-22 00:20:16,5509
548,547,1079,2174,"170 days, 13:54:41",2013-02-11 02:47:43,2010-02-01 10:32:08,2010-07-22 00:26:49,1457
32,113,179,324,"170 days, 16:08:42",2013-02-01 03:46:43,2010-02-01 10:32:08,2010-07-22 02:40:50,1858
89,311,402,802,"170 days, 16:37:47",2013-02-01 02:32:45,2010-02-01 10:32:08,2010-07-22 03:09:55,6387
86,55,120,261,"170 days, 19:34:40",2013-02-01 08:08:39,2010-02-01 10:32:08,2010-07-22 06:06:48,6854
26,473,966,1465,"170 days, 21:20:55",2013-02-03 09:13:56,2010-02-01 10:32:08,2010-07-22 07:53:03,3461
436,124,254,814,"170 days, 22:18:45",2013-02-03 11:46:10,2010-02-01 10:32:08,2010-07-22 08:50:53,2835
6,221,595,822,"171 days, 13:33:43",2013-02-03 08:20:19,2010-02-01 10:32:08,2010-07-23 00:05:51,8884
321,159,335,815,"171 days, 13:41:02",2013-02-06 08:02:23,2010-02-01 10:32:08,2010-07-23 00:13:10,2947
3,11,152,166,"171 days, 13:56:04",2013-02-03 07:14:29,2010-02-01 10:32:08,2010-07-23 00:28:12,9763
36,24,230,290,"171 days, 14:01:55",2013-02-01 07:33:49,2010-02-01 10:32:08,2010-07-23 00:34:03,8977
653,88,250,991,"171 days, 14:32:07",2013-02-07 07:02:27,2010-02-01 10:32:08,2010-07-23 01:04:15,7673
146,332,591,1069,"171 days, 17:43:09",2013-02-06 07:34:14,2010-02-01 10:32:08,2010-07-23 04:15:17,784
22,223,621,866,"171 days, 19:44:03",2013-02-08 00:31:48,2010-02-01 10:32:08,2010-07-23 06:16:11,1265
978,2,32,1012,"171 days, 20:29:21",2013-01-31 11:21:50,2010-02-01 10:32:08,2010-07-23 07:01:29,3233
484,200,529,1213,"171 days, 20:45:24",2013-02-04 02:30:21,2010-02-01 10:32:08,2010-07-23 07:17:32,2900
589,272,473,1334,"171 days, 20:52:22",2013-02-02 09:45:00,2010-02-01 10:32:08,2010-07-23 07:24:30,4734
354,1,27,382,"171 days, 21:56:21",2013-01-22 08:04:29,2010-02-01 10:32:08,2010-07-23 08:28:29,9072
288,0,40,328,"171 days, 22:55:48",2013-02-06 09:56:48,2010-02-01 10:32:08,2010-07-23 09:27:56,6586
1133,12,140,1285,"171 days, 23:09:59",2013-02-01 07:23:44,2010-02-01 10:32:08,2010-07-23 09:42:07,2444
715,83,574,1372,"171 days, 23:54:48",2013-02-05 08:53:45,2010-02-01 10:32:08,2010-07-23 10:26:56,5209
174,2,10,186,"172 days, 0:45:47",2013-01-16 08:08:00,2011-01-24 10:42:59,2011-07-15 11:28:46,5023
112,627,1262,2001,"172 days, 21:30:07",2013-02-06 01:41:59,2010-02-01 10:32:08,2010-07-24 08:02:15,3864
11,3,26,40,"172 days, 21:57:05",2013-02-04 03:16:01,2010-02-01 10:32:08,2010-07-24 08:29:13,2390
786,0,0,786,"172 days, 21:59:40",2013-01-27 00:23:38,2010-02-01 10:32:08,2010-07-24 08:31:48,3465
1001,225,635,1861,"173 days, 14:13:16",2013-02-04 06:42:04,2010-02-01 10:32:08,2010-07-25 00:45:24,1735
412,1,39,452,"173 days, 14:54:01",2013-02-01 02:34:05,2010-07-05 09:59:58,2010-12-26 00:53:59,5708
314,0,0,314,"173 days, 19:48:26",2013-01-18 05:22:30,2010-02-01 10:32:08,2010-07-25 06:20:34,397
768,56,472,1296,"173 days, 20:50:16",2013-02-02 08:33:10,2010-02-01 10:32:08,2010-07-25 07:22:24,1365
610,0,8,618,"173 days, 21:22:27",2012-12-28 04:06:38,2010-02-01 10:32:08,2010-07-25 07:54:35,5652
450,1,15,466,"173 days, 23:13:31",2013-01-27 04:55:24,2010-02-01 10:32:08,2010-07-25 09:45:39,7870
566,0,0,566,"173 days, 23:19:26",2013-01-25 08:12:06,2010-02-01 10:32:08,2010-07-25 09:51:34,4698
310,48,51,409,"174 days, 17:39:32",2013-01-29 05:03:14,2010-02-01 10:32:08,2010-07-26 04:11:40,7193
864,0,76,940,"174 days, 20:09:19",2013-02-06 05:55:16,2010-02-01 10:32:08,2010-07-26 06:41:27,4675
875,92,356,1323,"175 days, 15:54:44",2013-02-04 06:25:50,2010-02-01 10:32:08,2010-07-27 02:26:52,7583
30,63,98,191,"175 days, 15:57:47",2013-02-01 11:40:00,2010-02-01 10:32:08,2010-07-27 02:29:55,1753
82,607,1028,1717,"175 days, 17:48:50",2013-02-05 11:56:21,2010-02-01 10:32:08,2010-07-27 04:20:58,26
277,4,7,288,"175 days, 18:28:47",2013-01-26 02:19:46,2010-02-01 10:32:08,2010-07-27 05:00:55,8424
474,111,244,829,"175 days, 19:03:27",2013-02-03 07:12:54,2010-02-01 10:32:08,2010-07-27 05:35:35,1994
583,1271,1777,3631,"175 days, 19:24:11",2013-02-07 00:01:59,2010-02-01 10:32:08,2010-07-27 05:56:19,1050
30,9,129,168,"175 days, 22:53:05",2013-02-01 07:03:46,2010-02-01 10:32:08,2010-07-27 09:25:13,3238
212,110,282,604,"175 days, 23:37:48",2013-02-03 08:19:17,2010-02-01 10:32:08,2010-07-27 10:09:56,6281
946,0,46,992,"175 days, 23:51:58",2013-01-24 02:05:27,2010-06-20 07:30:02,2010-12-13 07:22:00,2013
116,93,151,360,"176 days, 0:08:20",2013-02-06 06:45:17,2010-02-01 10:32:08,2010-07-27 10:40:28,1385
950,0,6,956,"176 days, 14:37:36",2013-01-27 06:39:19,2010-02-01 10:32:08,2010-07-28 01:09:44,7452
695,77,275,1047,"176 days, 14:59:34",2013-02-01 06:45:09,2010-02-01 10:32:08,2010-07-28 01:31:42,2736
226,27,126,379,"176 days, 18:38:13",2013-02-07 00:14:09,2010-02-01 10:32:08,2010-07-28 05:10:21,3169
267,268,536,1071,"176 days, 20:58:20",2013-02-06 08:50:46,2010-02-01 10:32:08,2010-07-28 07:30:28,1076
1008,212,234,1454,"176 days, 21:39:59",2013-02-01 02:21:57,2010-02-01 10:32:08,2010-07-28 08:12:07,6683
975,57,136,1168,"177 days, 0:25:21",2013-01-31 08:49:48,2010-02-01 10:32:08,2010-07-28 10:57:29,2729
6,2,30,38,"177 days, 2:15:25",2013-02-02 03:56:56,2011-12-07 04:21:42,2012-06-01 06:37:07,7943
15,532,952,1499,"177 days, 15:19:06",2013-02-04 10:32:49,2010-02-01 10:32:08,2010-07-29 01:51:14,9217
748,41,371,1160,"177 days, 17:45:31",2013-02-01 08:10:52,2010-02-01 10:32:08,2010-07-29 04:17:39,8854
290,28,142,460,"177 days, 22:52:52",2013-01-30 09:07:45,2010-02-01 10:32:08,2010-07-29 09:25:00,3357
190,2,23,215,"177 days, 22:54:44",2013-01-30 05:01:23,2011-09-07 06:54:28,2012-03-03 05:49:12,3869
1100,32,94,1226,"177 days, 22:56:00",2013-02-05 07:13:27,2010-02-01 10:32:08,2010-07-29 09:28:08,7605
17,1,42,60,"178 days, 1:15:03",2013-01-31 06:03:11,2010-02-01 10:32:08,2010-07-29 11:47:11,2976
46,4,159,209,"178 days, 13:54:18",2013-02-04 10:14:28,2010-02-01 10:32:08,2010-07-30 00:26:26,6499
386,66,130,582,"178 days, 14:24:04",2013-02-01 11:03:28,2010-02-01 10:32:08,2010-07-30 00:56:12,7261
312,248,358,918,"178 days, 16:16:50",2013-02-03 11:45:02,2010-02-01 10:32:08,2010-07-30 02:48:58,5566
262,0,10,272,"178 days, 18:26:41",2013-01-18 06:35:56,2010-02-01 10:32:08,2010-07-30 04:58:49,5559
275,83,271,629,"178 days, 18:45:57",2013-02-03 05:33:12,2010-02-01 10:32:08,2010-07-30 05:18:05,3184
886,15,32,933,"178 days, 22:04:35",2013-01-31 10:43:44,2010-02-01 10:32:08,2010-07-30 08:36:43,3623
862,0,2,864,"178 days, 22:37:12",2013-01-22 03:27:33,2010-02-01 10:32:08,2010-07-30 09:09:20,6231
428,320,340,1088,"178 days, 22:51:54",2013-02-01 11:57:04,2010-02-01 10:32:08,2010-07-30 09:24:02,452
16,1,0,17,"179 days, 4:16:48",2013-01-17 11:18:15,2012-07-22 07:01:27,2013-01-17 11:18:15,4786
257,0,23,280,"179 days, 6:47:35",2013-01-20 11:06:13,2010-09-02 01:06:30,2011-02-28 07:54:05,2842
71,48,49,168,"179 days, 8:35:58",2013-02-01 08:13:52,2010-07-05 01:15:05,2010-12-31 09:51:03,3205
1277,223,582,2082,"179 days, 15:32:17",2013-02-02 06:51:47,2010-02-01 10:32:08,2010-07-31 02:04:25,127
282,739,1085,2106,"179 days, 17:05:59",2013-02-06 09:14:00,2010-02-01 10:32:08,2010-07-31 03:38:07,455
1227,486,775,2488,"179 days, 17:26:49",2013-02-07 07:44:30,2010-02-01 10:32:08,2010-07-31 03:58:57,3260
365,1,0,366,"179 days, 17:47:23",2012-12-27 04:11:23,2010-02-01 10:32:08,2010-07-31 04:19:31,9834
14,10,140,164,"179 days, 20:32:53",2013-02-03 02:23:40,2010-02-01 10:32:08,2010-07-31 07:05:01,7495
4,55,71,130,"179 days, 23:29:00",2013-02-05 09:52:53,2010-02-01 10:32:08,2010-07-31 10:01:08,6565
45,234,295,574,"180 days, 0:44:30",2013-02-01 04:27:55,2010-02-01 10:32:08,2010-07-31 11:16:38,9039
470,455,1124,2049,"180 days, 0:54:24",2013-02-04 09:08:36,2010-02-01 10:32:08,2010-07-31 11:26:32,4547
575,3,34,612,"180 days, 1:26:55",2013-01-25 06:34:34,2010-02-01 10:32:08,2010-07-31 11:59:03,9167
222,1,26,249,"180 days, 13:46:47",2013-01-12 04:27:44,2010-02-01 10:32:08,2010-08-01 00:18:55,8296
186,24,163,373,"180 days, 16:43:58",2013-02-02 02:40:52,2010-02-01 10:32:08,2010-08-01 03:16:06,1004
504,69,339,912,"180 days, 23:10:10",2013-02-04 10:29:40,2010-02-01 10:32:08,2010-08-01 09:42:18,3478
29,1,38,68,"181 days, 15:31:31",2013-02-06 01:51:07,2010-02-01 10:32:08,2010-08-02 02:03:39,6578
253,427,691,1371,"181 days, 16:51:27",2013-02-06 03:46:32,2010-02-01 10:32:08,2010-08-02 03:23:35,1770
22,294,305,621,"181 days, 21:29:10",2013-02-06 10:31:20,2010-02-01 10:32:08,2010-08-02 08:01:18,6797
602,1,0,603,"182 days, 14:29:55",2013-01-26 04:56:53,2010-02-01 10:32:08,2010-08-03 01:02:03,720
342,191,115,648,"182 days, 15:55:02",2013-01-25 01:25:48,2010-02-01 10:32:08,2010-08-03 02:27:10,2818
29,416,820,1265,"182 days, 17:44:35",2013-02-05 04:26:19,2010-02-01 10:32:08,2010-08-03 04:16:43,1443
1108,208,188,1504,"182 days, 18:12:27",2013-02-04 00:14:53,2010-02-01 10:32:08,2010-08-03 04:44:35,2982
384,3,82,469,"182 days, 18:35:43",2013-01-31 04:18:05,2010-02-01 10:32:08,2010-08-03 05:07:51,3517
1345,94,225,1664,"182 days, 18:52:46",2013-02-03 09:34:16,2010-02-01 10:32:08,2010-08-03 05:24:54,6952
1086,210,638,1934,"182 days, 23:18:37",2013-02-06 08:11:23,2010-02-01 10:32:08,2010-08-03 09:50:45,1147
247,233,394,874,"182 days, 23:51:07",2013-02-06 07:49:42,2010-02-01 10:32:08,2010-08-03 10:23:15,783
7,1,59,67,"183 days, 0:27:05",2013-01-31 10:45:14,2010-02-01 10:32:08,2010-08-03 10:59:13,5437
78,155,251,484,"183 days, 0:48:22",2013-02-07 10:15:24,2010-02-01 10:32:08,2010-08-03 11:20:30,4653
235,1,82,318,"183 days, 17:55:09",2013-01-28 09:29:11,2010-02-01 10:32:08,2010-08-04 04:27:17,3187
555,609,1416,2580,"183 days, 18:04:25",2013-02-05 03:22:40,2010-02-01 10:32:08,2010-08-04 04:36:33,1410
63,4,17,84,"183 days, 18:28:54",2013-01-30 06:48:00,2010-02-01 10:32:08,2010-08-04 05:01:02,3052
41,122,509,672,"183 days, 19:37:57",2013-02-03 09:33:25,2010-02-01 10:32:08,2010-08-04 06:10:05,9479
51,5,170,226,"183 days, 19:43:38",2013-02-01 01:03:45,2010-02-01 10:32:08,2010-08-04 06:15:46,3285
74,34,316,424,"183 days, 20:22:52",2013-02-03 04:38:32,2010-02-01 10:32:08,2010-08-04 06:55:00,9839
52,167,322,541,"183 days, 21:33:54",2013-01-31 00:35:16,2010-02-01 10:32:08,2010-08-04 08:06:02,42
39,1,69,109,"184 days, 1:18:46",2013-01-27 08:00:12,2010-02-01 10:32:08,2010-08-04 11:50:54,8479
56,9,25,90,"184 days, 2:12:42",2013-01-30 02:45:32,2011-02-28 04:32:18,2011-08-31 06:45:00,6143
1191,21,209,1421,"184 days, 15:44:47",2013-02-05 00:12:52,2010-02-01 10:32:08,2010-08-05 02:16:55,4612
146,6,90,242,"185 days, 16:10:28",2013-02-03 05:33:59,2010-02-01 10:32:08,2010-08-06 02:42:36,133
152,536,1119,1807,"185 days, 16:52:13",2013-02-04 00:53:36,2010-02-01 10:32:08,2010-08-06 03:24:21,3983
780,263,500,1543,"185 days, 18:02:02",2013-02-05 07:15:32,2010-02-01 10:32:08,2010-08-06 04:34:10,813
278,218,213,709,"185 days, 19:04:08",2013-01-26 08:09:11,2010-02-01 10:32:08,2010-08-06 05:36:16,3164
50,522,794,1366,"185 days, 20:26:04",2013-02-04 09:24:54,2010-02-01 10:32:08,2010-08-06 06:58:12,5907
559,0,0,559,"185 days, 21:30:37",2013-01-30 08:21:46,2010-02-01 10:32:08,2010-08-06 08:02:45,7396
113,257,313,683,"186 days, 0:24:52",2013-02-01 09:56:51,2010-02-01 10:32:08,2010-08-06 10:57:00,8896
377,874,1239,2490,"186 days, 0:31:12",2013-02-06 06:33:00,2010-02-01 10:32:08,2010-08-06 11:03:20,1521
71,175,401,647,"186 days, 1:00:02",2013-02-02 08:13:03,2010-02-01 10:32:08,2010-08-06 11:32:10,1560
5,233,639,877,"186 days, 1:10:59",2013-02-06 02:32:28,2010-02-01 10:32:08,2010-08-06 11:43:07,9849
305,8,138,451,"186 days, 13:40:20",2013-02-04 00:25:06,2010-02-01 10:32:08,2010-08-07 00:12:28,6427
589,819,1023,2431,"186 days, 14:29:32",2013-02-06 05:25:32,2010-02-01 10:32:08,2010-08-07 01:01:40,3354
13,0,0,13,"186 days, 17:31:57",2012-12-12 03:35:51,2010-02-01 10:32:08,2010-08-07 04:04:05,9074
18,0,50,68,"186 days, 18:20:29",2013-02-02 07:39:46,2010-02-01 10:32:08,2010-08-07 04:52:37,9862
224,247,353,824,"186 days, 21:39:31",2013-02-02 06:18:31,2010-02-01 10:32:08,2010-08-07 08:11:39,2091
21,83,293,397,"187 days, 0:08:49",2013-02-03 05:39:11,2010-02-01 10:32:08,2010-08-07 10:40:57,8717
322,1,69,392,"187 days, 15:59:57",2013-01-23 10:00:00,2010-02-01 10:32:08,2010-08-08 02:32:05,7121
12,9,117,138,"187 days, 16:17:16",2013-02-07 06:57:05,2010-02-01 10:32:08,2010-08-08 02:49:24,8145
96,10,201,307,"187 days, 16:21:53",2013-02-03 04:49:28,2010-02-01 10:32:08,2010-08-08 02:54:01,7693
1256,124,362,1742,"187 days, 16:46:18",2013-02-04 00:53:51,2010-02-01 10:32:08,2010-08-08 03:18:26,5792
6,14,122,142,"187 days, 16:55:51",2013-01-31 01:55:17,2010-02-01 10:32:08,2010-08-08 03:27:59,883
13,2,31,46,"187 days, 17:16:26",2013-02-03 09:29:18,2010-02-01 10:32:08,2010-08-08 03:48:34,6913
17,0,1,18,"187 days, 21:19:42",2013-01-14 10:49:32,2010-07-04 05:45:33,2011-01-08 03:05:15,9601
1001,784,1196,2981,"187 days, 21:20:16",2013-02-05 10:41:45,2010-02-01 10:32:08,2010-08-08 07:52:24,2761
222,0,18,240,"188 days, 1:10:17",2013-01-28 10:19:56,2011-06-24 07:49:28,2011-12-29 08:59:45,7850
633,11,202,846,"188 days, 1:20:35",2013-02-03 03:38:31,2010-02-01 10:32:08,2010-08-08 11:52:43,8220
672,123,280,1075,"188 days, 16:50:12",2013-02-03 06:16:09,2010-02-01 10:32:08,2010-08-09 03:22:20,4997
280,0,13,293,"188 days, 20:28:41",2013-01-29 02:26:48,2011-02-02 10:39:58,2011-08-10 07:08:39,595
17,138,168,323,"188 days, 20:35:22",2013-02-05 10:31:49,2010-02-01 10:32:08,2010-08-09 07:07:30,2926
0,1,15,16,"188 days, 21:19:14",2013-01-09 01:39:50,2012-07-04 04:20:36,2013-01-09 01:39:50,6872
1246,347,842,2435,"189 days, 1:22:17",2013-02-04 05:27:59,2010-02-01 10:32:08,2010-08-09 11:54:25,6616
874,107,172,1153,"189 days, 14:05:06",2013-02-04 02:44:24,2010-02-01 10:32:08,2010-08-10 00:37:14,4081
695,12,203,910,"189 days, 15:23:47",2013-02-04 07:10:39,2010-02-01 10:32:08,2010-08-10 01:55:55,6566
1101,0,0,1101,"189 days, 15:33:11",2013-01-31 06:45:12,2010-02-01 10:32:08,2010-08-10 02:05:19,5295
1186,330,374,1890,"189 days, 15:42:34",2013-02-05 03:38:40,2010-02-01 10:32:08,2010-08-10 02:14:42,9921
181,0,12,193,"189 days, 17:40:43",2013-01-23 11:50:38,2010-02-01 10:32:08,2010-08-10 04:12:51,9902
348,131,141,620,"189 days, 20:49:01",2013-02-04 10:27:55,2010-02-01 10:32:08,2010-08-10 07:21:09,1027
68,229,291,588,"189 days, 21:58:51",2013-02-06 11:47:01,2010-02-01 10:32:08,2010-08-10 08:30:59,1239
1193,0,5,1198,"189 days, 22:52:20",2013-01-17 01:37:23,2010-02-01 10:32:08,2010-08-10 09:24:28,9931
291,263,1001,1555,"189 days, 23:11:06",2013-02-06 01:50:49,2010-02-01 10:32:08,2010-08-10 09:43:14,6141
139,1,100,240,"190 days, 14:47:20",2013-02-06 08:08:47,2010-02-01 10:32:08,2010-08-11 01:19:28,9754
34,73,198,305,"190 days, 15:41:48",2013-01-28 08:33:19,2010-02-01 10:32:08,2010-08-11 02:13:56,6511
23,203,331,557,"190 days, 16:53:30",2013-02-05 01:35:45,2010-02-01 10:32:08,2010-08-11 03:25:38,8718
257,4,155,416,"190 days, 17:36:35",2013-02-02 10:28:33,2010-02-01 10:32:08,2010-08-11 04:08:43,1052
1,36,181,218,"190 days, 20:24:26",2013-01-31 05:20:31,2010-02-01 10:32:08,2010-08-11 06:56:34,9636
344,0,1,345,"190 days, 21:45:07",2013-01-23 03:22:33,2010-02-01 10:32:08,2010-08-11 08:17:15,7313
760,19,174,953,"190 days, 22:52:27",2013-02-04 07:22:25,2010-02-01 10:32:08,2010-08-11 09:24:35,2984
615,150,250,1015,"191 days, 0:07:53",2013-02-04 09:09:32,2010-02-01 10:32:08,2010-08-11 10:40:01,9353
1102,4,91,1197,"191 days, 1:02:07",2013-01-30 02:57:31,2010-02-01 10:32:08,2010-08-11 11:34:15,705
98,3,224,325,"191 days, 5:27:09",2013-02-06 08:27:17,2011-03-01 02:21:30,2011-09-08 07:48:39,195
304,111,226,641,"192 days, 0:11:42",2013-02-02 11:54:05,2010-02-01 10:32:08,2010-08-12 10:43:50,7291
263,137,212,612,"192 days, 1:04:26",2013-02-06 11:09:14,2010-02-01 10:32:08,2010-08-12 11:36:34,3589
26,854,972,1852,"192 days, 1:07:56",2013-02-06 06:15:00,2010-02-01 10:32:08,2010-08-12 11:40:04,6963
870,5,9,884,"192 days, 14:19:39",2013-01-29 08:59:21,2010-02-01 10:32:08,2010-08-13 00:51:47,2834
137,226,640,1003,"192 days, 14:56:49",2013-02-07 07:52:47,2010-02-01 10:32:08,2010-08-13 01:28:57,7010
962,0,2,964,"192 days, 16:42:30",2013-01-30 01:34:02,2010-02-01 10:32:08,2010-08-13 03:14:38,9293
306,178,172,656,"192 days, 18:11:05",2013-02-04 02:56:16,2010-02-01 10:32:08,2010-08-13 04:43:13,3402
837,0,1,838,"192 days, 20:24:37",2013-01-28 03:33:27,2010-02-01 10:32:08,2010-08-13 06:56:45,4452
550,1,0,551,"193 days, 1:08:56",2013-01-31 01:58:24,2010-02-01 10:32:08,2010-08-13 11:41:04,2483
727,201,314,1242,"193 days, 14:42:53",2013-01-30 10:34:13,2010-02-01 10:32:08,2010-08-14 01:15:01,3295
447,2,45,494,"193 days, 14:57:31",2013-01-31 02:44:13,2010-02-01 10:32:08,2010-08-14 01:29:39,9456
237,316,1034,1587,"193 days, 19:22:18",2013-02-07 03:03:50,2010-02-01 10:32:08,2010-08-14 05:54:26,6222
598,527,955,2080,"193 days, 19:26:12",2013-02-05 03:53:46,2010-02-01 10:32:08,2010-08-14 05:58:20,3255
1176,6,477,1659,"193 days, 22:34:01",2013-01-30 05:29:00,2010-02-01 10:32:08,2010-08-14 09:06:09,4998
20,8,41,69,"194 days, 1:52:40",2013-01-31 11:42:45,2010-07-09 02:25:01,2011-01-19 04:17:41,8846
416,3,16,435,"194 days, 3:16:43",2013-01-28 03:57:36,2010-09-17 06:06:28,2011-03-30 09:23:11,6268
1142,0,4,1146,"194 days, 14:53:12",2013-01-30 03:31:53,2010-02-01 10:32:08,2010-08-15 01:25:20,1793
540,107,145,792,"194 days, 17:07:43",2013-02-02 10:48:28,2010-02-01 10:32:08,2010-08-15 03:39:51,666
879,0,663,1542,"194 days, 19:11:48",2013-02-02 11:53:44,2010-02-01 10:32:08,2010-08-15 05:43:56,1677
371,9,54,434,"194 days, 20:01:12",2013-02-02 11:03:22,2010-04-08 04:13:09,2010-10-20 00:14:21,9361
0,124,814,938,"194 days, 20:21:23",2013-01-28 04:20:06,2010-02-01 10:32:08,2010-08-15 06:53:31,3042
37,13,128,178,"195 days, 3:50:12",2013-02-04 02:06:34,2010-06-26 04:11:33,2011-01-07 08:01:45,8585
826,2,0,828,"195 days, 13:36:13",2013-01-31 05:55:00,2010-02-01 10:32:08,2010-08-16 00:08:21,1846
164,285,717,1166,"195 days, 13:46:38",2013-02-07 07:07:04,2010-02-01 10:32:08,2010-08-16 00:18:46,1894
555,1,24,580,"195 days, 16:12:27",2013-01-29 06:52:15,2010-02-01 10:32:08,2010-08-16 02:44:35,1005
975,6,61,1042,"195 days, 21:19:04",2013-02-01 04:45:04,2010-02-01 10:32:08,2010-08-16 07:51:12,4004
341,0,16,357,"196 days, 18:24:04",2013-01-31 04:29:19,2010-02-01 10:32:08,2010-08-17 04:56:12,4057
785,196,370,1351,"196 days, 19:01:09",2013-02-04 08:22:43,2010-02-01 10:32:08,2010-08-17 05:33:17,3352
277,117,445,839,"196 days, 19:30:07",2013-02-02 09:18:47,2010-02-01 10:32:08,2010-08-17 06:02:15,4581
19,7,35,61,"196 days, 20:53:08",2013-01-22 04:50:35,2010-02-01 10:32:08,2010-08-17 07:25:16,2430
4,79,321,404,"197 days, 1:21:06",2013-02-06 07:46:33,2010-02-01 10:32:08,2010-08-17 11:53:14,6772
14,1,13,28,"197 days, 16:55:01",2013-01-17 00:32:47,2010-02-01 10:32:08,2010-08-18 03:27:09,8144
341,3,19,363,"197 days, 19:41:31",2013-01-26 02:17:28,2010-02-01 10:32:08,2010-08-18 06:13:39,4403
71,114,535,720,"197 days, 20:40:53",2013-02-04 11:06:19,2010-02-01 10:32:08,2010-08-18 07:13:01,6423
356,0,0,356,"197 days, 21:37:25",2013-01-30 11:23:49,2010-02-01 10:32:08,2010-08-18 08:09:33,2698
27,25,43,95,"198 days, 1:20:52",2013-02-06 08:34:50,2010-02-01 10:32:08,2010-08-18 11:53:00,3919
1007,754,883,2644,"198 days, 15:02:55",2013-02-04 03:12:26,2010-02-01 10:32:08,2010-08-19 01:35:03,7499
846,0,0,846,"198 days, 15:06:37",2013-01-10 09:07:13,2010-02-01 10:32:08,2010-08-19 01:38:45,7331
154,154,417,725,"198 days, 17:31:12",2013-02-05 10:36:27,2010-02-01 10:32:08,2010-08-19 04:03:20,9183
155,72,272,499,"198 days, 17:36:22",2013-02-01 02:07:56,2010-02-01 10:32:08,2010-08-19 04:08:30,1748
322,149,381,852,"198 days, 17:42:25",2013-02-04 05:29:36,2010-02-01 10:32:08,2010-08-19 04:14:33,9403
1201,9,109,1319,"199 days, 13:32:32",2013-01-28 10:15:07,2010-02-01 10:32:08,2010-08-20 00:04:40,1275
7,144,336,487,"199 days, 17:44:02",2013-01-31 07:01:11,2010-02-01 10:32:08,2010-08-20 04:16:10,829
247,319,542,1108,"199 days, 18:29:12",2013-02-06 07:37:53,2010-02-01 10:32:08,2010-08-20 05:01:20,3226
961,163,381,1505,"199 days, 18:33:42",2013-02-04 07:57:44,2010-02-01 10:32:08,2010-08-20 05:05:50,3174
9,21,75,105,"199 days, 18:39:06",2013-02-05 03:15:21,2010-06-18 09:03:17,2011-01-04 03:42:23,1176
10,115,166,291,"199 days, 19:25:21",2013-02-03 08:14:23,2010-02-01 10:32:08,2010-08-20 05:57:29,4219
20,95,191,306,"199 days, 20:05:06",2013-02-04 02:25:18,2010-02-01 10:32:08,2010-08-20 06:37:14,6039
548,3,194,745,"199 days, 22:37:51",2013-02-05 10:04:35,2010-02-01 10:32:08,2010-08-20 09:09:59,5635
362,562,507,1431,"199 days, 23:18:07",2013-02-04 08:07:24,2010-02-01 10:32:08,2010-08-20 09:50:15,117
602,89,307,998,"199 days, 23:44:02",2013-02-06 10:13:07,2010-02-01 10:32:08,2010-08-20 10:16:10,5485
15,3,80,98,"200 days, 0:14:50",2013-01-23 01:18:30,2010-02-01 10:32:08,2010-08-20 10:46:58,8825
282,0,10,292,"200 days, 1:17:33",2013-01-31 11:04:41,2010-02-01 10:32:08,2010-08-20 11:49:41,760
331,3,82,416,"200 days, 14:43:35",2013-02-06 00:13:50,2010-02-01 10:32:08,2010-08-21 01:15:43,2299
474,7,90,571,"200 days, 14:47:07",2013-02-06 04:25:06,2010-02-01 10:32:08,2010-08-21 01:19:15,8845
766,14,61,841,"200 days, 15:11:20",2013-01-29 03:34:46,2010-02-01 10:32:08,2010-08-21 01:43:28,419
588,46,501,1135,"200 days, 16:34:54",2013-01-30 08:03:30,2010-02-01 10:32:08,2010-08-21 03:07:02,9007
173,163,332,668,"200 days, 19:12:13",2013-02-06 08:03:28,2010-02-01 10:32:08,2010-08-21 05:44:21,1213
566,0,3,569,"200 days, 19:36:15",2013-01-29 09:24:58,2010-02-01 10:32:08,2010-08-21 06:08:23,3236
794,1,93,888,"200 days, 20:40:28",2013-02-04 02:59:26,2010-02-01 10:32:08,2010-08-21 07:12:36,6588
617,1,34,652,"200 days, 20:44:29",2013-01-28 00:02:43,2010-02-01 10:32:08,2010-08-21 07:16:37,9656
949,171,149,1269,"200 days, 23:00:22",2013-02-01 11:05:36,2010-02-01 10:32:08,2010-08-21 09:32:30,8842
310,322,827,1459,"200 days, 23:03:31",2013-02-07 08:21:54,2010-02-01 10:32:08,2010-08-21 09:35:39,9959
384,253,362,999,"200 days, 23:14:18",2013-02-03 11:36:05,2010-02-01 10:32:08,2010-08-21 09:46:26,7764
234,99,294,627,"200 days, 23:20:26",2013-01-24 07:40:01,2010-02-01 10:32:08,2010-08-21 09:52:34,4237
38,594,1001,1633,"201 days, 0:00:00",2013-02-06 08:50:05,2010-02-01 10:32:08,2010-08-21 10:32:08,4009
26,139,497,662,"201 days, 0:23:40",2013-02-04 10:34:36,2010-02-01 10:32:08,2010-08-21 10:55:48,8763
232,35,87,354,"201 days, 16:16:26",2013-01-30 04:54:39,2010-02-01 10:32:08,2010-08-22 02:48:34,1381
579,6,107,692,"201 days, 20:00:04",2013-02-01 10:06:52,2010-02-01 10:32:08,2010-08-22 06:32:12,6505
907,401,570,1878,"201 days, 21:03:48",2013-02-05 04:56:21,2010-02-01 10:32:08,2010-08-22 07:35:56,3384
299,0,64,363,"201 days, 21:05:10",2013-01-31 01:34:38,2010-02-01 10:32:08,2010-08-22 07:37:18,9819
247,56,214,517,"201 days, 22:35:57",2013-02-06 00:18:41,2010-02-01 10:32:08,2010-08-22 09:08:05,403
149,302,578,1029,"201 days, 22:48:08",2013-02-05 01:01:53,2010-02-01 10:32:08,2010-08-22 09:20:16,6212
48,230,795,1073,"201 days, 23:03:28",2013-02-06 08:02:08,2010-02-01 10:32:08,2010-08-22 09:35:36,6773
153,136,513,802,"202 days, 0:30:57",2013-02-12 02:10:53,2010-02-01 10:32:08,2010-08-22 11:03:05,2868
17,0,0,17,"202 days, 3:29:58",2012-09-07 04:18:37,2010-12-14 00:33:58,2011-07-04 04:03:56,7076
165,205,354,724,"202 days, 20:40:03",2013-02-05 01:42:58,2010-02-01 10:32:08,2010-08-23 07:12:11,425
617,187,283,1087,"202 days, 20:59:01",2013-01-29 01:55:22,2010-02-01 10:32:08,2010-08-23 07:31:09,9116
605,3,79,687,"203 days, 0:20:10",2013-01-23 03:35:23,2010-02-01 10:32:08,2010-08-23 10:52:18,1484
40,14,137,191,"203 days, 0:28:34",2013-02-06 11:48:45,2010-02-01 10:32:08,2010-08-23 11:00:42,5398
263,181,439,883,"203 days, 0:32:13",2013-02-03 02:02:39,2010-02-01 10:32:08,2010-08-23 11:04:21,2421
845,2,146,993,"203 days, 1:09:25",2013-02-01 11:04:59,2010-02-01 10:32:08,2010-08-23 11:41:33,7485
7,74,257,338,"203 days, 1:19:28",2013-02-06 03:26:07,2010-02-01 10:32:08,2010-08-23 11:51:36,6674
355,82,492,929,"203 days, 15:40:56",2013-02-04 09:51:52,2010-03-27 09:31:23,2010-10-17 01:12:19,7755
33,47,204,284,"203 days, 16:05:38",2013-01-31 02:19:12,2010-02-01 10:32:08,2010-08-24 02:37:46,6746
285,134,445,864,"203 days, 17:14:20",2013-02-06 11:59:44,2010-02-01 10:32:08,2010-08-24 03:46:28,9469
491,0,0,491,"203 days, 17:17:07",2013-01-20 05:10:32,2010-02-01 10:32:08,2010-08-24 03:49:15,4220
320,235,320,875,"203 days, 19:37:20",2013-02-05 01:19:30,2010-02-01 10:32:08,2010-08-24 06:09:28,3208
428,806,937,2171,"203 days, 23:12:52",2013-02-07 06:55:03,2010-02-01 10:32:08,2010-08-24 09:45:00,3015
472,155,727,1354,"204 days, 0:51:01",2013-02-07 08:15:08,2010-02-01 10:32:08,2010-08-24 11:23:09,8353
603,1,11,615,"204 days, 14:16:45",2013-01-27 09:29:40,2010-02-01 10:32:08,2010-08-25 00:48:53,5522
538,2,16,556,"204 days, 15:56:42",2013-01-31 06:57:44,2010-02-01 10:32:08,2010-08-25 02:28:50,5677
1134,99,243,1476,"204 days, 17:50:49",2013-02-03 05:24:16,2010-02-01 10:32:08,2010-08-25 04:22:57,5977
220,3,40,263,"204 days, 21:29:52",2013-01-25 03:16:04,2010-02-01 10:32:08,2010-08-25 08:02:00,51
913,440,632,1985,"204 days, 22:34:03",2013-02-03 06:28:51,2010-02-01 10:32:08,2010-08-25 09:06:11,5810
617,3,93,713,"205 days, 0:50:40",2013-01-24 08:37:00,2010-02-01 10:32:08,2010-08-25 11:22:48,9701
13,10,22,45,"205 days, 10:34:21",2013-01-30 02:10:23,2011-12-07 01:16:49,2012-06-29 11:51:10,8699
88,7,57,152,"205 days, 13:48:19",2013-01-29 08:24:32,2010-02-01 10:32:08,2010-08-26 00:20:27,1860
261,500,726,1487,"205 days, 14:58:11",2013-02-05 11:19:41,2010-02-01 10:32:08,2010-08-26 01:30:19,5386
13,3,72,88,"205 days, 16:21:02",2013-01-27 09:42:02,2010-02-01 10:32:08,2010-08-26 02:53:10,1881
592,157,312,1061,"205 days, 17:28:50",2013-02-04 04:30:20,2010-02-01 10:32:08,2010-08-26 04:00:58,9043
83,2,21,106,"206 days, 0:15:00",2013-01-27 11:37:55,2011-03-19 00:15:19,2011-10-11 00:30:19,220
17,14,139,170,"206 days, 1:09:52",2013-02-02 08:04:14,2010-02-01 10:32:08,2010-08-26 11:42:00,7427
291,479,774,1544,"206 days, 13:58:12",2013-02-07 07:38:57,2010-02-01 10:32:08,2010-08-27 00:30:20,9195
169,57,113,339,"206 days, 15:44:55",2013-01-29 01:07:48,2010-02-01 10:32:08,2010-08-27 02:17:03,518
119,97,155,371,"206 days, 15:53:21",2013-02-03 11:33:45,2010-02-01 10:32:08,2010-08-27 02:25:29,9068
57,213,224,494,"206 days, 16:00:10",2013-01-26 02:31:19,2010-02-24 09:11:52,2010-09-19 01:12:02,9251
174,170,343,687,"206 days, 18:35:17",2013-02-03 06:30:12,2010-02-01 10:32:08,2010-08-27 05:07:25,609
130,178,553,861,"206 days, 19:27:25",2013-02-03 05:25:07,2010-02-01 10:32:08,2010-08-27 05:59:33,5161
282,5,18,305,"206 days, 20:49:53",2013-02-05 04:21:50,2010-02-01 10:32:08,2010-08-27 07:22:01,4700
88,133,332,553,"206 days, 21:44:05",2013-02-04 04:21:39,2010-02-01 10:32:08,2010-08-27 08:16:13,9010
367,48,218,633,"206 days, 23:30:40",2013-01-31 08:46:51,2010-02-01 10:32:08,2010-08-27 10:02:48,3839
72,277,662,1011,"207 days, 0:22:21",2013-02-04 01:23:13,2010-02-01 10:32:08,2010-08-27 10:54:29,9458
196,149,264,609,"207 days, 0:44:02",2013-02-05 04:38:57,2010-02-01 10:32:08,2010-08-27 11:16:10,5158
753,59,274,1086,"207 days, 16:43:45",2013-01-25 10:58:32,2010-02-01 10:32:08,2010-08-28 03:15:53,7269
182,4,116,302,"207 days, 17:54:37",2013-01-21 04:30:42,2010-02-01 10:32:08,2010-08-28 04:26:45,4153
11,284,448,743,"207 days, 18:43:29",2013-02-03 09:04:28,2010-02-01 10:32:08,2010-08-28 05:15:37,1309
5,3,95,103,"207 days, 19:07:29",2013-01-05 06:20:04,2010-02-01 10:32:08,2010-08-28 05:39:37,893
238,2,18,258,"207 days, 20:25:40",2013-02-01 05:24:39,2010-02-01 10:32:08,2010-08-28 06:57:48,1472
621,2,33,656,"207 days, 21:52:30",2013-02-04 11:57:48,2010-02-01 10:32:08,2010-08-28 08:24:38,2575
310,26,55,391,"207 days, 22:08:36",2013-02-03 06:27:15,2010-02-01 10:32:08,2010-08-28 08:40:44,9502
689,0,18,707,"207 days, 22:48:40",2013-02-03 04:06:58,2010-02-01 10:32:08,2010-08-28 09:20:48,2234
46,14,138,198,"207 days, 23:42:47",2013-02-01 08:30:01,2010-02-01 10:32:08,2010-08-28 10:14:55,1179
432,3,80,515,"207 days, 23:50:45",2013-01-30 09:34:26,2010-02-01 10:32:08,2010-08-28 10:22:53,3114
141,11,27,179,"208 days, 0:51:42",2013-01-30 11:37:55,2010-02-01 10:32:08,2010-08-28 11:23:50,7960
34,9,23,66,"208 days, 2:07:03",2013-01-19 01:19:21,2011-06-16 07:19:34,2012-01-10 09:26:37,8503
294,107,188,589,"208 days, 15:21:00",2013-02-04 04:44:06,2010-02-01 10:32:08,2010-08-29 01:53:08,860
15,0,74,89,"208 days, 15:37:01",2013-01-31 07:57:30,2010-02-01 10:32:08,2010-08-29 02:09:09,9508
51,29,313,393,"208 days, 17:06:49",2013-02-01 05:37:54,2010-02-01 10:32:08,2010-08-29 03:38:57,623
810,0,1,811,"208 days, 18:08:25",2013-01-28 05:22:31,2010-02-01 10:32:08,2010-08-29 04:40:33,6960
325,0,59,384,"208 days, 18:58:40",2013-01-29 01:32:23,2010-02-01 10:32:08,2010-08-29 05:30:48,27
590,354,834,1778,"208 days, 19:30:48",2013-02-07 00:20:16,2010-02-01 10:32:08,2010-08-29 06:02:56,3362
425,191,407,1023,"208 days, 19:37:20",2013-02-07 00:45:29,2010-02-01 10:32:08,2010-08-29 06:09:28,5986
378,37,173,588,"208 days, 21:01:33",2013-02-02 06:33:29,2010-02-01 10:32:08,2010-08-29 07:33:41,1338
226,770,748,1744,"208 days, 21:17:25",2013-02-06 00:42:34,2010-02-01 10:32:08,2010-08-29 07:49:33,7224
153,30,189,372,"208 days, 21:58:30",2013-02-01 04:22:21,2010-02-01 10:32:08,2010-08-29 08:30:38,873
766,0,0,766,"209 days, 0:49:51",2013-01-29 05:00:45,2010-02-01 10:32:08,2010-08-29 11:21:59,5495
416,42,202,660,"209 days, 14:52:07",2013-02-01 09:13:46,2010-02-01 10:32:08,2010-08-30 01:24:15,1914
440,0,12,452,"209 days, 15:15:02",2013-01-29 11:56:56,2010-02-01 10:32:08,2010-08-30 01:47:10,3668
109,154,294,557,"209 days, 15:57:50",2013-01-31 08:05:13,2010-02-01 10:32:08,2010-08-30 02:29:58,9078
252,41,176,469,"209 days, 15:58:05",2013-02-01 08:14:04,2010-02-01 10:32:08,2010-08-30 02:30:13,8134
442,399,849,1690,"209 days, 17:10:27",2013-02-04 03:47:34,2010-02-01 10:32:08,2010-08-30 03:42:35,2963
352,2,9,363,"209 days, 18:42:40",2013-02-03 11:59:46,2010-02-01 10:32:08,2010-08-30 05:14:48,5603
425,21,136,582,"209 days, 18:45:35",2013-02-01 01:25:45,2010-02-01 10:32:08,2010-08-30 05:17:43,8636
286,102,277,665,"209 days, 18:54:14",2013-02-06 03:03:03,2010-02-01 10:32:08,2010-08-30 05:26:22,8205
341,14,47,402,"209 days, 21:24:46",2013-01-31 05:20:13,2010-02-01 10:32:08,2010-08-30 07:56:54,5448
372,32,274,678,"209 days, 21:49:08",2013-02-03 11:38:25,2010-02-01 10:32:08,2010-08-30 08:21:16,3477
209,0,14,223,"209 days, 23:00:00",2013-01-31 11:05:41,2010-02-01 10:32:08,2010-08-30 09:32:08,8754
409,542,713,1664,"209 days, 23:52:44",2013-02-07 01:42:20,2010-02-01 10:32:08,2010-08-30 10:24:52,1494
426,112,151,689,"210 days, 11:19:28",2013-02-02 11:45:40,2010-03-26 00:06:37,2010-10-22 11:26:05,9883
392,22,245,659,"210 days, 13:34:06",2013-02-04 07:15:52,2010-02-01 10:32:08,2010-08-31 00:06:14,161
58,55,339,452,"210 days, 14:07:57",2013-02-07 07:46:19,2010-02-01 10:32:08,2010-08-31 00:40:05,1965
614,30,142,786,"210 days, 18:28:42",2013-02-04 07:58:54,2010-02-01 10:32:08,2010-08-31 05:00:50,2479
19,5,35,59,"210 days, 19:09:32",2013-02-03 08:57:31,2010-02-01 10:32:08,2010-08-31 05:41:40,9527
560,8,31,599,"210 days, 21:04:39",2013-01-30 01:59:04,2010-02-01 10:32:08,2010-08-31 07:36:47,9464
631,223,514,1368,"210 days, 22:21:50",2013-02-07 05:16:52,2010-02-01 10:32:08,2010-08-31 08:53:58,1132
904,184,712,1800,"211 days, 0:20:22",2013-02-05 00:58:06,2010-02-01 10:32:08,2010-08-31 10:52:30,2928
341,15,212,568,"211 days, 13:57:10",2013-02-06 01:52:20,2010-02-01 10:32:08,2010-09-01 00:29:18,6687
289,0,3,292,"211 days, 15:52:23",2013-02-01 08:42:12,2010-02-01 10:32:08,2010-09-01 02:24:31,6626
546,194,378,1118,"211 days, 16:32:41",2013-02-06 03:28:11,2010-02-01 10:32:08,2010-09-01 03:04:49,1490
303,0,5,308,"211 days, 21:35:30",2013-01-12 03:56:28,2010-02-01 10:32:08,2010-09-01 08:07:38,2851
967,312,427,1706,"211 days, 21:45:19",2013-02-03 08:34:50,2010-02-01 10:32:08,2010-09-01 08:17:27,6885
1144,4,92,1240,"212 days, 1:16:09",2013-02-11 09:40:10,2010-02-01 10:32:08,2010-09-01 11:48:17,4969
377,111,188,676,"212 days, 14:16:26",2013-02-02 03:36:11,2010-02-01 10:32:08,2010-09-02 00:48:34,4947
559,1,0,560,"212 days, 15:01:37",2013-01-25 06:41:18,2010-02-01 10:32:08,2010-09-02 01:33:45,1314
330,1,37,368,"212 days, 17:41:35",2013-01-12 09:47:38,2010-02-01 10:32:08,2010-09-02 04:13:43,489
773,114,326,1213,"212 days, 20:01:29",2013-02-07 09:40:34,2010-02-01 10:32:08,2010-09-02 06:33:37,5910
367,148,175,690,"212 days, 23:36:08",2013-02-02 11:22:47,2010-02-01 10:32:08,2010-09-02 10:08:16,1186
895,84,406,1385,"213 days, 0:40:24",2013-02-02 05:27:13,2010-02-01 10:32:08,2010-09-02 11:12:32,4157
72,334,738,1144,"213 days, 1:09:47",2013-02-07 06:14:51,2010-02-01 10:32:08,2010-09-02 11:41:55,2946
5,0,4,9,"213 days, 2:19:27",2012-12-18 08:01:21,2010-08-22 07:21:17,2011-03-23 09:40:44,1525
14,0,8,22,"213 days, 4:29:33",2013-02-02 11:44:18,2011-08-07 00:14:58,2012-03-07 04:44:31,4373
133,131,202,466,"213 days, 18:28:47",2013-02-02 11:30:48,2010-02-01 10:32:08,2010-09-03 05:00:55,8070
26,3,17,46,"213 days, 22:59:03",2013-02-03 00:45:55,2010-04-03 01:32:48,2010-11-03 00:31:51,6761
818,305,733,1856,"213 days, 23:20:29",2013-02-06 11:20:26,2010-02-01 10:32:08,2010-09-03 09:52:37,5899
1357,776,1331,3464,"214 days, 0:07:38",2013-02-05 01:57:44,2010-02-01 10:32:08,2010-09-03 10:39:46,2498
97,6,113,216,"214 days, 0:25:27",2013-02-01 08:28:41,2010-02-01 10:32:08,2010-09-03 10:57:35,346
237,64,263,564,"214 days, 15:51:55",2013-02-04 11:27:31,2010-02-01 10:32:08,2010-09-04 02:24:03,729
143,160,631,934,"214 days, 16:05:12",2013-02-07 04:36:04,2010-02-01 10:32:08,2010-09-04 02:37:20,6463
266,100,355,721,"214 days, 16:27:09",2013-02-06 03:09:33,2010-02-01 10:32:08,2010-09-04 02:59:17,1559
411,65,421,897,"214 days, 16:44:09",2013-02-06 09:12:13,2010-02-01 10:32:08,2010-09-04 03:16:17,2499
1320,98,704,2122,"214 days, 17:09:06",2013-02-08 05:30:26,2010-02-01 10:32:08,2010-09-04 03:41:14,1527
19,2,0,21,"214 days, 18:19:53",2013-01-25 04:01:15,2010-12-10 11:57:07,2011-07-13 06:17:00,9249
316,142,288,746,"214 days, 19:38:35",2013-02-06 00:27:26,2010-02-01 10:32:08,2010-09-04 06:10:43,504
1,0,61,62,"214 days, 20:04:19",2013-01-23 11:36:42,2010-02-01 10:32:08,2010-09-04 06:36:27,5800
514,8,112,634,"214 days, 21:06:37",2013-02-04 06:42:22,2010-02-01 10:32:08,2010-09-04 07:38:45,5703
481,66,146,693,"214 days, 22:21:05",2013-02-05 01:00:40,2010-02-01 10:32:08,2010-09-04 08:53:13,926
547,5,133,685,"214 days, 22:44:24",2013-02-01 09:27:37,2010-02-01 10:32:08,2010-09-04 09:16:32,9715
321,9,20,350,"215 days, 6:35:49",2013-01-25 05:40:52,2010-10-18 01:05:11,2011-05-21 07:41:00,4668
9,141,173,323,"215 days, 20:14:59",2013-01-28 07:47:40,2010-02-01 10:32:08,2010-09-05 06:47:07,8154
254,141,309,704,"215 days, 20:46:39",2013-02-04 01:41:37,2010-02-01 10:32:08,2010-09-05 07:18:47,7114
105,0,54,159,"215 days, 22:08:48",2013-01-28 10:46:27,2010-02-01 10:32:08,2010-09-05 08:40:56,2705
689,85,247,1021,"215 days, 22:08:55",2013-02-02 01:25:49,2010-02-01 10:32:08,2010-09-05 08:41:03,7658
19,81,178,278,"215 days, 22:23:38",2013-01-28 02:26:32,2010-02-01 10:32:08,2010-09-05 08:55:46,7691
1122,12,55,1189,"215 days, 23:52:44",2013-02-06 06:16:27,2010-02-01 10:32:08,2010-09-05 10:24:52,1543
813,1,15,829,"216 days, 0:57:47",2013-01-29 05:41:56,2010-10-21 08:52:11,2011-05-25 09:49:58,7006
57,0,59,116,"216 days, 1:02:58",2013-01-27 06:06:58,2010-02-01 10:32:08,2010-09-05 11:35:06,8956
196,2,74,272,"216 days, 20:45:48",2013-01-29 09:10:51,2010-02-01 10:32:08,2010-09-06 07:17:56,6672
294,0,0,294,"216 days, 21:16:52",2013-01-20 09:27:57,2010-02-01 10:32:08,2010-09-06 07:49:00,2617
348,104,223,675,"217 days, 1:24:58",2013-02-06 03:36:49,2010-02-01 10:32:08,2010-09-06 11:57:06,1203
554,0,2,556,"217 days, 15:43:31",2013-01-11 01:47:07,2010-02-01 10:32:08,2010-09-07 02:15:39,1411
28,303,394,725,"217 days, 16:08:28",2013-02-06 02:17:51,2010-02-01 10:32:08,2010-09-07 02:40:36,9055
67,394,445,906,"217 days, 17:50:22",2013-02-07 05:03:06,2010-02-01 10:32:08,2010-09-07 04:22:30,1956
786,1,0,787,"217 days, 17:59:04",2013-01-25 09:55:43,2010-02-01 10:32:08,2010-09-07 04:31:12,1872
758,4,122,884,"217 days, 19:32:45",2013-02-04 03:55:29,2010-02-01 10:32:08,2010-09-07 06:04:53,9419
940,0,16,956,"217 days, 23:16:39",2013-01-28 09:52:59,2010-02-01 10:32:08,2010-09-07 09:48:47,90
0,363,336,699,"218 days, 1:12:28",2013-01-29 03:49:22,2010-04-10 08:49:50,2010-11-14 10:02:18,1414
122,23,123,268,"218 days, 1:25:44",2013-01-30 09:36:30,2010-02-01 10:32:08,2010-09-07 11:57:52,6764
713,0,42,755,"218 days, 18:03:29",2013-01-26 11:48:17,2010-02-01 10:32:08,2010-09-08 04:35:37,9822
284,203,323,810,"218 days, 18:09:23",2013-02-04 08:48:50,2010-02-01 10:32:08,2010-09-08 04:41:31,967
135,36,157,328,"218 days, 18:23:37",2013-01-27 08:46:00,2010-02-01 10:32:08,2010-09-08 04:55:45,709
535,2,88,625,"218 days, 22:38:27",2013-01-25 05:16:19,2010-02-01 10:32:08,2010-09-08 09:10:35,5218
295,0,18,313,"218 days, 22:39:23",2013-01-10 03:35:30,2010-02-01 10:32:08,2010-09-08 09:11:31,8730
1132,11,65,1208,"218 days, 22:41:52",2013-01-30 03:31:13,2010-02-01 10:32:08,2010-09-08 09:14:00,3282
237,83,285,605,"218 days, 23:39:03",2013-02-06 08:46:23,2010-02-01 10:32:08,2010-09-08 10:11:11,5539
4,0,56,60,"219 days, 13:44:01",2013-01-14 06:24:54,2010-02-01 10:32:08,2010-09-09 00:16:09,7648
583,4,41,628,"219 days, 13:51:20",2013-01-31 07:32:22,2010-02-01 10:32:08,2010-09-09 00:23:28,6105
586,70,520,1176,"219 days, 16:21:59",2013-02-04 10:29:09,2010-02-01 10:32:08,2010-09-09 02:54:07,9187
860,15,108,983,"219 days, 17:27:15",2013-02-06 10:48:16,2010-02-01 10:32:08,2010-09-09 03:59:23,6870
1222,115,310,1647,"219 days, 19:25:20",2013-02-05 09:11:08,2010-02-01 10:32:08,2010-09-09 05:57:28,4728
8,331,591,930,"219 days, 19:57:56",2013-02-06 11:00:21,2010-02-01 10:32:08,2010-09-09 06:30:04,3721
235,2,28,265,"219 days, 19:59:59",2013-01-30 05:36:19,2010-02-01 10:32:08,2010-09-09 06:32:07,4851
254,47,398,699,"219 days, 20:05:01",2013-02-04 04:58:21,2010-02-01 10:32:08,2010-09-09 06:37:09,9777
574,138,362,1074,"219 days, 22:47:42",2013-02-03 06:12:01,2010-02-01 10:32:08,2010-09-09 09:19:50,4024
2,120,148,270,"219 days, 23:42:13",2013-02-14 02:46:18,2010-02-01 10:32:08,2010-09-09 10:14:21,4078
542,0,3,545,"220 days, 0:27:59",2013-01-27 11:17:55,2010-02-01 10:32:08,2010-09-09 11:00:07,5065
565,2,33,600,"220 days, 14:11:11",2013-01-26 05:51:25,2010-02-01 10:32:08,2010-09-10 00:43:19,8844
18,0,12,30,"220 days, 19:13:17",2013-01-31 04:52:34,2010-02-01 10:32:08,2010-09-10 05:45:25,3278
1092,1,2,1095,"220 days, 19:53:04",2013-01-25 06:41:53,2010-02-01 10:32:08,2010-09-10 06:25:12,9639
655,104,135,894,"220 days, 22:03:16",2013-02-16 02:30:31,2010-02-01 10:32:08,2010-09-10 08:35:24,3794
67,136,309,512,"220 days, 22:52:47",2013-02-06 00:52:59,2010-02-01 10:32:08,2010-09-10 09:24:55,5141
46,185,176,407,"221 days, 14:20:48",2013-01-29 05:55:12,2010-02-01 10:32:08,2010-09-11 00:52:56,846
733,114,156,1003,"221 days, 14:23:40",2013-02-05 04:08:27,2010-02-01 10:32:08,2010-09-11 00:55:48,5430
627,84,319,1030,"221 days, 15:48:36",2013-02-01 08:48:27,2010-02-01 10:32:08,2010-09-11 02:20:44,7942
568,20,20,608,"221 days, 17:38:20",2013-01-24 02:00:22,2010-02-01 10:32:08,2010-09-11 04:10:28,3791
371,0,160,531,"221 days, 18:11:20",2013-01-21 01:27:43,2010-02-01 10:32:08,2010-09-11 04:43:28,1152
6,1,18,25,"221 days, 18:21:44",2012-11-11 08:26:15,2010-08-08 10:07:02,2011-03-18 04:28:46,7434
464,476,1361,2301,"221 days, 21:23:47",2013-02-04 10:39:11,2010-02-01 10:32:08,2010-09-11 07:55:55,4159
607,0,5,612,"221 days, 22:10:30",2013-01-28 09:05:15,2010-02-01 10:32:08,2010-09-11 08:42:38,9193
504,176,514,1194,"222 days, 19:22:45",2013-02-02 02:24:48,2010-02-01 10:32:08,2010-09-12 05:54:53,9581
561,1,94,656,"222 days, 20:48:02",2013-02-01 07:54:14,2010-02-01 10:32:08,2010-09-12 07:20:10,436
113,277,1167,1557,"222 days, 23:31:06",2013-02-05 00:52:31,2010-02-01 10:32:08,2010-09-12 10:03:14,2648
816,14,94,924,"223 days, 0:06:04",2013-02-04 09:06:43,2010-02-01 10:32:08,2010-09-12 10:38:12,662
143,124,141,408,"223 days, 0:23:03",2013-02-04 03:16:50,2010-02-01 10:32:08,2010-09-12 10:55:11,8023
39,0,40,79,"223 days, 0:51:57",2013-01-25 06:06:40,2010-02-01 10:32:08,2010-09-12 11:24:05,1487
89,174,288,551,"223 days, 1:14:48",2013-02-03 03:06:51,2010-02-01 10:32:08,2010-09-12 11:46:56,3438
420,82,178,680,"223 days, 13:53:50",2013-02-02 00:18:52,2010-02-01 10:32:08,2010-09-13 00:25:58,4068
1058,122,251,1431,"223 days, 15:58:59",2013-02-04 09:51:00,2010-02-01 10:32:08,2010-09-13 02:31:07,3101
517,18,153,688,"223 days, 17:27:07",2013-02-04 03:11:27,2010-02-01 10:32:08,2010-09-13 03:59:15,9125
223,31,55,309,"223 days, 19:27:44",2013-02-04 01:19:58,2010-02-01 10:32:08,2010-09-13 05:59:52,5492
8,37,181,226,"223 days, 20:53:52",2013-02-04 02:55:28,2011-01-08 07:45:32,2011-08-20 04:39:24,4091
1148,0,8,1156,"223 days, 22:43:28",2013-01-28 09:48:03,2010-02-01 10:32:08,2010-09-13 09:15:36,6194
102,253,337,692,"224 days, 0:20:37",2013-02-06 05:21:42,2010-02-01 10:32:08,2010-09-13 10:52:45,2205
314,2,71,387,"224 days, 16:52:11",2013-02-04 09:33:47,2010-02-01 10:32:08,2010-09-14 03:24:19,7565
535,427,1066,2028,"224 days, 19:59:29",2013-02-05 07:55:39,2010-02-01 10:32:08,2010-09-14 06:31:37,5556
1066,3,102,1171,"224 days, 20:05:13",2013-01-29 07:58:23,2010-02-01 10:32:08,2010-09-14 06:37:21,8494
1028,316,478,1822,"224 days, 21:57:49",2013-02-04 06:12:44,2010-02-01 10:32:08,2010-09-14 08:29:57,6959
1210,8,65,1283,"225 days, 1:06:38",2013-02-07 02:47:55,2010-02-01 10:32:08,2010-09-14 11:38:46,7898
200,28,156,384,"225 days, 1:15:18",2013-01-22 02:49:54,2010-02-01 10:32:08,2010-09-14 11:47:26,9482
743,13,58,814,"225 days, 15:05:12",2013-02-04 00:58:34,2010-02-01 10:32:08,2010-09-15 01:37:20,6457
333,230,772,1335,"225 days, 15:11:26",2013-02-06 11:29:40,2010-02-01 10:32:08,2010-09-15 01:43:34,6921
355,0,2,357,"225 days, 15:12:03",2013-01-20 05:43:06,2010-02-01 10:32:08,2010-09-15 01:44:11,8733
104,25,76,205,"225 days, 15:17:31",2013-01-28 02:08:20,2010-02-01 10:32:08,2010-09-15 01:49:39,6993
23,2,46,71,"225 days, 16:35:19",2013-01-28 00:21:02,2010-02-01 10:32:08,2010-09-15 03:07:27,9574
316,69,296,681,"225 days, 16:59:23",2013-02-04 09:11:30,2010-02-01 10:32:08,2010-09-15 03:31:31,5423
1115,0,50,1165,"225 days, 17:56:16",2013-01-29 07:25:44,2010-02-01 10:32:08,2010-09-15 04:28:24,809
3,81,245,329,"225 days, 19:32:43",2013-01-28 08:26:37,2010-03-04 07:17:16,2010-10-16 02:49:59,5082
873,2,22,897,"225 days, 23:12:37",2013-01-22 03:27:08,2010-02-01 10:32:08,2010-09-15 09:44:45,9422
393,435,434,1262,"225 days, 23:18:28",2013-02-06 02:10:58,2010-02-01 10:32:08,2010-09-15 09:50:36,7324
702,209,311,1222,"226 days, 0:18:06",2013-02-05 08:31:33,2010-02-01 10:32:08,2010-09-15 10:50:14,9847
834,58,213,1105,"226 days, 1:21:30",2013-02-05 10:47:39,2010-02-01 10:32:08,2010-09-15 11:53:38,7730
157,156,670,983,"226 days, 6:23:14",2013-02-06 04:36:27,2010-05-19 01:48:44,2010-12-31 08:11:58,5636
6,2,35,43,"226 days, 14:12:19",2013-01-25 02:43:53,2010-02-01 10:32:08,2010-09-16 00:44:27,8111
46,8,80,134,"226 days, 18:57:19",2013-02-01 05:52:06,2010-02-01 10:32:08,2010-09-16 05:29:27,8305
271,0,0,271,"227 days, 14:37:54",2013-01-29 00:15:23,2010-02-01 10:32:08,2010-09-17 01:10:02,1812
246,47,94,387,"227 days, 16:20:12",2013-02-05 06:47:38,2010-02-01 10:32:08,2010-09-17 02:52:20,2170
1,8,170,179,"227 days, 21:08:49",2013-01-28 01:09:43,2010-02-01 10:32:08,2010-09-17 07:40:57,5828
505,1,24,530,"227 days, 23:52:34",2013-02-02 03:01:30,2010-02-01 10:32:08,2010-09-17 10:24:42,2758
420,3,64,487,"228 days, 13:56:50",2013-01-28 02:01:24,2010-02-01 10:32:08,2010-09-18 00:28:58,3151
860,3,37,900,"228 days, 14:09:52",2013-01-25 06:26:04,2010-02-01 10:32:08,2010-09-18 00:42:00,7351
99,133,139,371,"228 days, 15:49:44",2013-02-01 07:00:28,2010-02-01 10:32:08,2010-09-18 02:21:52,8157
1043,1,31,1075,"228 days, 16:06:09",2013-01-24 02:30:37,2010-02-01 10:32:08,2010-09-18 02:38:17,4704
1217,0,12,1229,"228 days, 18:15:08",2013-01-19 11:31:50,2010-02-01 10:32:08,2010-09-18 04:47:16,9207
266,0,28,294,"228 days, 19:40:02",2013-01-15 11:16:18,2010-02-01 10:32:08,2010-09-18 06:12:10,9083
38,60,70,168,"228 days, 23:36:57",2013-01-28 10:15:33,2010-02-01 10:32:08,2010-09-18 10:09:05,9145
1047,175,551,1773,"228 days, 23:42:08",2013-01-31 10:27:46,2010-02-01 10:32:08,2010-09-18 10:14:16,2366
463,4,30,497,"229 days, 8:05:01",2013-01-18 06:53:16,2010-05-27 03:00:13,2011-01-11 11:05:14,2517
490,0,33,523,"229 days, 13:56:04",2013-01-26 06:12:56,2010-02-01 10:32:08,2010-09-19 00:28:12,8547
235,94,252,581,"229 days, 14:31:56",2013-01-27 03:02:31,2010-02-01 10:32:08,2010-09-19 01:04:04,4600
318,5,34,357,"229 days, 14:56:12",2013-02-06 10:39:33,2010-02-01 10:32:08,2010-09-19 01:28:20,3826
8,228,333,569,"229 days, 15:39:34",2013-02-03 01:41:46,2010-02-01 10:32:08,2010-09-19 02:11:42,8864
696,248,176,1120,"229 days, 15:50:44",2013-02-03 05:44:59,2010-02-01 10:32:08,2010-09-19 02:22:52,9698
303,1,2,306,"229 days, 18:49:17",2013-01-16 07:34:23,2010-02-01 10:32:08,2010-09-19 05:21:25,7456
851,0,0,851,"230 days, 0:30:52",2013-01-28 06:37:55,2010-02-01 10:32:08,2010-09-19 11:03:00,3929
196,3,146,345,"230 days, 16:48:45",2013-01-30 03:33:44,2010-02-01 10:32:08,2010-09-20 03:20:53,6496
571,2,78,651,"230 days, 21:06:43",2013-01-30 01:11:47,2010-02-01 10:32:08,2010-09-20 07:38:51,520
33,108,411,552,"230 days, 23:57:28",2013-02-02 11:20:01,2010-02-01 10:32:08,2010-09-20 10:29:36,3717
114,123,185,422,"231 days, 0:19:11",2013-02-05 09:48:58,2010-02-01 10:32:08,2010-09-20 10:51:19,2929
878,0,13,891,"231 days, 0:53:55",2013-01-26 04:30:37,2010-02-01 10:32:08,2010-09-20 11:26:03,6052
901,124,118,1143,"231 days, 14:27:54",2013-02-06 04:11:31,2010-02-01 10:32:08,2010-09-21 01:00:02,9895
609,78,110,797,"231 days, 15:40:10",2013-01-31 07:08:41,2010-02-01 10:32:08,2010-09-21 02:12:18,1745
3,7,95,105,"231 days, 16:08:41",2013-01-24 03:01:37,2010-02-01 10:32:08,2010-09-21 02:40:49,3138
26,149,252,427,"231 days, 16:37:10",2013-02-05 04:54:15,2010-02-01 10:32:08,2010-09-21 03:09:18,3831
559,71,345,975,"231 days, 20:07:47",2013-02-03 08:24:09,2010-02-23 05:04:30,2010-10-13 01:12:17,1320
413,14,100,527,"231 days, 20:54:41",2013-02-03 07:00:50,2010-02-01 10:32:08,2010-09-21 07:26:49,4975
584,3,9,596,"231 days, 21:36:24",2013-01-25 11:26:38,2010-02-01 10:32:08,2010-09-21 08:08:32,9541
516,1,0,517,"232 days, 14:31:43",2013-01-14 11:40:19,2010-02-01 10:32:08,2010-09-22 01:03:51,4631
247,0,0,247,"232 days, 16:54:21",2013-01-22 11:54:42,2010-02-01 10:32:08,2010-09-22 03:26:29,9705
101,248,986,1335,"232 days, 19:34:02",2013-02-06 08:17:49,2010-02-01 10:32:08,2010-09-22 06:06:10,6827
71,173,432,676,"232 days, 21:04:13",2013-02-06 07:02:30,2010-02-01 10:32:08,2010-09-22 07:36:21,4104
290,4,87,381,"232 days, 22:27:42",2013-01-30 00:41:24,2010-02-01 10:32:08,2010-09-22 08:59:50,1616
4,3,14,21,"233 days, 4:41:03",2013-01-18 04:59:30,2011-08-26 03:20:56,2012-04-15 08:01:59,8595
97,266,635,998,"233 days, 14:55:15",2013-02-04 11:04:40,2010-02-01 10:32:08,2010-09-23 01:27:23,3685
467,142,191,800,"233 days, 16:17:12",2013-02-03 10:13:28,2010-02-01 10:32:08,2010-09-23 02:49:20,1776
7,2,6,15,"233 days, 16:32:40",2013-01-28 07:10:33,2010-05-13 09:11:35,2011-01-02 01:44:15,9095
78,117,356,551,"233 days, 23:52:46",2013-02-04 01:49:06,2010-02-01 10:32:08,2010-09-23 10:24:54,9015
717,314,343,1374,"234 days, 14:32:09",2013-02-05 06:39:11,2010-02-01 10:32:08,2010-09-24 01:04:17,5013
320,0,49,369,"234 days, 18:47:33",2013-01-28 09:51:47,2010-02-01 10:32:08,2010-09-24 05:19:41,3704
861,0,38,899,"234 days, 22:03:03",2013-02-06 07:49:44,2010-02-01 10:32:08,2010-09-24 08:35:11,185
744,37,179,960,"235 days, 1:22:33",2013-01-31 07:02:44,2010-02-01 10:32:08,2010-09-24 11:54:41,469
296,9,71,376,"235 days, 14:46:30",2013-02-02 10:52:02,2010-02-01 10:32:08,2010-09-25 01:18:38,9623
131,29,48,208,"235 days, 15:19:01",2013-01-31 00:47:19,2010-02-01 10:32:08,2010-09-25 01:51:09,1929
795,0,117,912,"235 days, 18:01:54",2013-02-04 02:08:37,2010-02-01 10:32:08,2010-09-25 04:34:02,269
510,108,154,772,"235 days, 20:00:50",2013-01-31 09:15:49,2010-02-01 10:32:08,2010-09-25 06:32:58,3999
54,2,22,78,"235 days, 20:48:24",2013-01-25 02:35:02,2010-12-11 07:40:22,2011-08-04 04:28:46,7694
420,344,547,1311,"235 days, 23:03:03",2013-02-07 00:45:35,2010-02-01 10:32:08,2010-09-25 09:35:11,631
228,276,719,1223,"236 days, 0:42:22",2013-02-07 11:56:47,2010-02-01 10:32:08,2010-09-25 11:14:30,4168
624,0,6,630,"236 days, 14:52:00",2013-01-28 00:47:06,2010-02-01 10:32:08,2010-09-26 01:24:08,317
1191,200,130,1521,"236 days, 18:57:23",2013-02-01 00:07:14,2010-02-01 10:32:08,2010-09-26 05:29:31,9414
39,28,193,260,"236 days, 22:40:16",2013-02-05 04:03:51,2010-02-01 10:32:08,2010-09-26 09:12:24,4378
1,2,73,76,"237 days, 15:26:19",2013-01-27 01:51:01,2010-02-01 10:32:08,2010-09-27 01:58:27,765
957,40,135,1132,"237 days, 18:10:21",2013-02-02 00:09:35,2010-02-01 10:32:08,2010-09-27 04:42:29,2065
308,1,0,309,"237 days, 18:48:47",2012-11-24 01:59:11,2010-02-01 10:32:08,2010-09-27 05:20:55,1339
299,0,0,299,"238 days, 0:40:16",2013-01-27 07:44:27,2010-02-01 10:32:08,2010-09-27 11:12:24,9535
17,4,10,31,"238 days, 16:21:10",2013-01-29 02:11:42,2011-04-06 11:24:59,2011-12-01 03:46:09,5282
1011,40,154,1205,"238 days, 17:22:16",2013-01-31 09:31:31,2010-02-01 10:32:08,2010-09-28 03:54:24,3779
248,159,264,671,"238 days, 18:08:37",2013-02-06 01:05:19,2010-02-01 10:32:08,2010-09-28 04:40:45,8470
308,0,18,326,"238 days, 23:31:15",2013-01-05 05:32:47,2010-02-01 10:32:08,2010-09-28 10:03:23,5841
296,9,78,383,"239 days, 1:12:19",2013-01-30 10:59:15,2010-02-01 10:32:08,2010-09-28 11:44:27,597
194,352,459,1005,"239 days, 13:39:55",2013-02-04 11:06:12,2010-02-01 10:32:08,2010-09-29 00:12:03,7845
37,93,327,457,"239 days, 17:10:12",2013-02-04 10:11:04,2010-02-01 10:32:08,2010-09-29 03:42:20,1738
14,0,11,25,"240 days, 5:43:28",2013-01-30 04:01:18,2011-05-19 00:03:55,2012-01-14 05:47:23,3825
225,0,0,225,"240 days, 15:25:08",2013-01-06 08:35:38,2010-02-01 10:32:08,2010-09-30 01:57:16,6602
1131,0,0,1131,"240 days, 16:50:09",2013-01-19 06:55:38,2010-02-01 10:32:08,2010-09-30 03:22:17,7033
44,11,213,268,"240 days, 17:30:06",2013-02-01 03:04:49,2010-02-01 10:32:08,2010-09-30 04:02:14,7411
542,3,110,655,"240 days, 17:33:47",2013-02-03 05:47:45,2010-02-01 10:32:08,2010-09-30 04:05:55,6543
499,7,89,595,"240 days, 23:01:38",2013-02-04 08:45:08,2010-05-19 05:31:26,2011-01-15 04:33:04,3518
965,306,845,2116,"241 days, 17:11:24",2013-02-05 07:50:21,2010-02-01 10:32:08,2010-10-01 03:43:32,8935
299,1,15,315,"241 days, 19:47:22",2013-01-29 03:18:41,2010-02-01 10:32:08,2010-10-01 06:19:30,7618
290,0,42,332,"241 days, 21:07:27",2013-01-30 09:16:53,2010-02-01 10:32:08,2010-10-01 07:39:35,7736
202,297,556,1055,"242 days, 0:01:47",2013-02-04 10:02:50,2010-02-01 10:32:08,2010-10-01 10:33:55,3743
463,139,362,964,"242 days, 1:16:25",2013-02-03 00:51:43,2010-02-01 10:32:08,2010-10-01 11:48:33,3732
362,159,324,845,"242 days, 14:37:32",2013-01-25 07:44:11,2010-02-01 10:32:08,2010-10-02 01:09:40,5370
1265,93,333,1691,"242 days, 22:08:01",2013-02-04 10:39:37,2010-02-01 10:32:08,2010-10-02 08:40:09,1479
486,246,328,1060,"243 days, 0:36:10",2013-02-02 06:48:18,2010-02-01 10:32:08,2010-10-02 11:08:18,4296
292,0,0,292,"243 days, 0:47:47",2013-01-30 07:10:06,2010-02-01 10:32:08,2010-10-02 11:19:55,5185
785,18,78,881,"243 days, 15:37:47",2013-02-04 11:54:04,2010-02-01 10:32:08,2010-10-03 02:09:55,388
561,0,0,561,"243 days, 19:38:34",2013-01-28 09:06:24,2010-02-01 10:32:08,2010-10-03 06:10:42,7815
272,0,1,273,"243 days, 22:27:43",2013-01-15 03:19:58,2010-02-01 10:32:08,2010-10-03 08:59:51,1719
17,2,54,73,"244 days, 14:46:05",2013-02-02 08:57:57,2010-02-01 10:32:08,2010-10-04 01:18:13,624
1195,124,397,1716,"244 days, 15:01:47",2013-02-05 03:11:47,2010-02-01 10:32:08,2010-10-04 01:33:55,5179
986,42,104,1132,"244 days, 15:16:59",2013-01-31 04:24:44,2010-02-01 10:32:08,2010-10-04 01:49:07,3247
249,76,179,504,"244 days, 15:20:43",2013-01-31 00:51:41,2010-02-01 10:32:08,2010-10-04 01:52:51,9956
90,54,92,236,"244 days, 15:26:42",2013-02-02 09:52:52,2010-02-01 10:32:08,2010-10-04 01:58:50,4141
838,1,13,852,"244 days, 15:49:31",2013-01-26 06:19:48,2010-02-01 10:32:08,2010-10-04 02:21:39,443
22,128,123,273,"244 days, 17:04:37",2013-01-21 08:22:54,2010-02-01 10:32:08,2010-10-04 03:36:45,7011
552,156,262,970,"244 days, 18:10:22",2013-02-04 00:56:57,2010-02-01 10:32:08,2010-10-04 04:42:30,3326
1,0,17,18,"244 days, 18:59:44",2013-01-10 06:38:52,2010-02-01 10:32:08,2010-10-04 05:31:52,889
444,1,23,468,"245 days, 0:17:57",2013-01-20 05:41:02,2010-02-01 10:32:08,2010-10-04 10:50:05,7106
22,79,334,435,"245 days, 16:09:33",2013-02-06 10:30:34,2010-02-01 10:32:08,2010-10-05 02:41:41,4327
13,3,87,103,"245 days, 22:08:52",2013-01-20 10:03:45,2010-02-01 10:32:08,2010-10-05 08:41:00,2942
9,43,152,204,"245 days, 22:32:30",2013-02-04 07:45:16,2010-02-01 10:32:08,2010-10-05 09:04:38,5597
773,1,7,781,"245 days, 22:46:09",2013-01-28 00:02:20,2010-02-01 10:32:08,2010-10-05 09:18:17,2015
122,17,198,337,"246 days, 16:43:47",2013-02-03 09:35:40,2010-02-01 10:32:08,2010-10-06 03:15:55,5195
33,2,65,100,"246 days, 18:50:39",2013-01-26 00:36:44,2010-02-01 10:32:08,2010-10-06 05:22:47,8438
9,0,36,45,"246 days, 19:07:49",2013-01-30 11:41:01,2010-05-06 05:17:54,2011-01-08 00:25:43,5444
471,29,173,673,"246 days, 19:26:15",2013-02-04 06:37:39,2010-02-01 10:32:08,2010-10-06 05:58:23,2569
553,0,8,561,"246 days, 22:47:33",2013-01-27 10:03:16,2010-02-01 10:32:08,2010-10-06 09:19:41,560
31,18,32,81,"246 days, 23:32:23",2013-01-31 01:53:52,2010-02-01 10:32:08,2010-10-06 10:04:31,2052
432,0,0,432,"247 days, 0:27:41",2013-01-29 10:35:21,2010-02-01 10:32:08,2010-10-06 10:59:49,177
208,0,12,220,"247 days, 0:55:44",2013-01-10 00:59:35,2010-02-01 10:32:08,2010-10-06 11:27:52,1444
779,0,0,779,"247 days, 14:52:38",2012-12-27 09:09:49,2010-02-01 10:32:08,2010-10-07 01:24:46,5885
903,1,22,926,"247 days, 17:03:07",2013-01-26 03:45:53,2010-02-01 10:32:08,2010-10-07 03:35:15,4629
588,1,24,613,"247 days, 17:51:25",2013-02-03 06:48:23,2010-02-01 10:32:08,2010-10-07 04:23:33,387
1,15,323,339,"247 days, 19:27:35",2013-02-02 08:23:31,2010-02-01 10:32:08,2010-10-07 05:59:43,2790
140,295,245,680,"248 days, 13:55:35",2013-02-06 10:55:28,2010-02-01 10:32:08,2010-10-08 00:27:43,4259
854,272,37,1163,"248 days, 15:50:32",2013-02-14 07:16:38,2010-02-01 10:32:08,2010-10-08 02:22:40,1657
58,31,354,443,"248 days, 16:58:45",2013-02-02 01:20:33,2010-02-01 10:32:08,2010-10-08 03:30:53,9983
570,11,71,652,"248 days, 18:35:12",2013-02-02 03:29:31,2010-02-01 10:32:08,2010-10-08 05:07:20,8239
222,4,86,312,"248 days, 21:33:05",2013-01-20 02:33:09,2010-02-01 10:32:08,2010-10-08 08:05:13,4372
1,4,23,28,"248 days, 21:35:42",2013-02-05 09:48:11,2010-02-01 10:32:08,2010-10-08 08:07:50,7267
327,0,33,360,"248 days, 22:19:45",2013-01-24 01:02:12,2010-07-14 08:57:39,2011-03-20 07:17:24,5311
406,185,276,867,"248 days, 22:33:18",2013-02-07 03:53:42,2010-02-01 10:32:08,2010-10-08 09:05:26,9136
466,0,3,469,"248 days, 23:36:48",2013-02-03 01:38:09,2010-02-01 10:32:08,2010-10-08 10:08:56,1786
347,158,988,1493,"249 days, 17:52:38",2013-02-03 11:19:37,2010-02-01 10:32:08,2010-10-09 04:24:46,4238
175,0,45,220,"249 days, 23:20:24",2013-01-30 09:21:50,2010-02-01 10:32:08,2010-10-09 09:52:32,1037
734,184,336,1254,"250 days, 13:40:20",2013-02-05 06:23:40,2010-02-01 10:32:08,2010-10-10 00:12:28,4179
296,0,0,296,"250 days, 14:40:12",2013-01-30 06:14:22,2010-02-01 10:32:08,2010-10-10 01:12:20,7140
821,4,150,975,"250 days, 15:32:21",2013-01-30 00:46:03,2010-02-01 10:32:08,2010-10-10 02:04:29,3691
680,0,4,684,"250 days, 15:51:15",2013-01-21 01:15:28,2010-02-01 10:32:08,2010-10-10 02:23:23,9789
30,17,180,227,"250 days, 17:56:50",2013-02-05 11:08:24,2010-02-01 10:32:08,2010-10-10 04:28:58,4107
839,24,300,1163,"250 days, 22:20:53",2013-01-31 11:30:18,2010-02-01 10:32:08,2010-10-10 08:53:01,2867
162,3,91,256,"251 days, 13:28:10",2013-02-06 06:09:15,2010-02-01 10:32:08,2010-10-11 00:00:18,4409
551,0,33,584,"251 days, 15:09:24",2013-01-30 07:39:39,2010-02-01 10:32:08,2010-10-11 01:41:32,2869
44,2,56,102,"251 days, 15:17:42",2013-01-29 09:19:47,2010-02-01 10:32:08,2010-10-11 01:49:50,9648
289,142,573,1004,"251 days, 15:33:27",2013-02-06 08:54:24,2010-02-01 10:32:08,2010-10-11 02:05:35,1167
4,85,191,280,"251 days, 17:51:52",2013-02-07 07:32:06,2010-02-01 10:32:08,2010-10-11 04:24:00,9447
16,0,19,35,"251 days, 17:56:39",2013-02-04 07:50:24,2010-02-01 10:32:08,2010-10-11 04:28:47,8477
1017,17,221,1255,"251 days, 18:15:54",2013-01-31 03:29:18,2010-02-01 10:32:08,2010-10-11 04:48:02,6328
311,63,138,512,"251 days, 21:10:18",2013-02-07 00:12:39,2010-02-01 10:32:08,2010-10-11 07:42:26,8147
36,6,105,147,"251 days, 21:30:53",2013-01-31 08:32:06,2010-02-01 10:32:08,2010-10-11 08:03:01,4496
626,135,389,1150,"251 days, 23:11:33",2013-02-01 09:38:26,2010-02-01 10:32:08,2010-10-11 09:43:41,2570
885,7,65,957,"252 days, 14:39:19",2013-02-03 10:07:11,2010-02-01 10:32:08,2010-10-12 01:11:27,1519
9,0,88,97,"252 days, 15:12:17",2013-01-08 03:56:30,2010-02-01 10:32:08,2010-10-12 01:44:25,6385
6,4,125,135,"252 days, 18:59:37",2013-01-31 09:49:22,2010-05-10 07:00:07,2011-01-18 01:59:44,3272
9,226,340,575,"252 days, 20:35:50",2013-02-05 04:02:56,2010-02-01 10:32:08,2010-10-12 07:07:58,7588
1024,448,439,1911,"252 days, 20:50:25",2013-02-07 06:25:58,2010-02-01 10:32:08,2010-10-12 07:22:33,5834
0,294,720,1014,"252 days, 22:41:00",2013-02-04 02:59:36,2010-02-01 10:32:08,2010-10-12 09:13:08,7330
1145,9,169,1323,"252 days, 23:09:34",2013-02-02 11:42:05,2010-02-01 10:32:08,2010-10-12 09:41:42,9809
9,4,37,50,"252 days, 23:31:25",2013-01-30 07:19:00,2010-02-01 10:32:08,2010-10-12 10:03:33,7312
1069,155,320,1544,"252 days, 23:44:36",2013-02-01 08:11:32,2010-02-01 10:32:08,2010-10-12 10:16:44,9736
1,18,97,116,"253 days, 14:17:26",2013-01-30 06:39:53,2010-02-01 10:32:08,2010-10-13 00:49:34,6697
326,15,115,456,"253 days, 14:28:52",2013-01-16 06:35:14,2010-02-01 10:32:08,2010-10-13 01:01:00,3856
34,259,835,1128,"254 days, 13:55:32",2013-02-03 09:27:39,2010-02-01 10:32:08,2010-10-14 00:27:40,5644
473,8,111,592,"254 days, 13:58:18",2013-02-03 03:03:48,2010-02-01 10:32:08,2010-10-14 00:30:26,293
695,101,627,1423,"254 days, 14:06:40",2013-02-03 02:38:50,2010-02-01 10:32:08,2010-10-14 00:38:48,4161
62,217,323,602,"254 days, 15:26:11",2013-01-26 05:52:34,2010-02-01 10:32:08,2010-10-14 01:58:19,677
32,4,60,96,"254 days, 20:34:08",2013-02-03 02:05:33,2010-02-01 10:32:08,2010-10-14 07:06:16,1258
776,0,19,795,"254 days, 20:59:25",2013-01-27 08:01:55,2010-02-01 10:32:08,2010-10-14 07:31:33,9230
642,132,406,1180,"255 days, 15:13:48",2013-02-05 11:54:49,2010-02-01 10:32:08,2010-10-15 01:45:56,6555
19,0,13,32,"255 days, 16:24:17",2013-01-27 09:45:54,2010-02-01 10:32:08,2010-10-15 02:56:25,9686
282,5,68,355,"255 days, 17:06:56",2013-02-05 00:02:38,2010-02-01 10:32:08,2010-10-15 03:39:04,7521
30,229,299,558,"255 days, 20:08:55",2013-02-04 07:59:31,2010-02-01 10:32:08,2010-10-15 06:41:03,642
16,28,206,250,"255 days, 22:14:33",2013-02-03 02:49:58,2010-02-01 10:32:08,2010-10-15 08:46:41,2880
14,0,13,27,"255 days, 23:41:36",2013-01-17 11:41:07,2010-02-01 10:32:08,2010-10-15 10:13:44,5388
185,288,364,837,"256 days, 13:50:32",2013-01-31 03:43:36,2010-02-01 10:32:08,2010-10-16 00:22:40,2859
751,3,71,825,"256 days, 20:19:29",2013-02-07 07:17:56,2010-02-01 10:32:08,2010-10-16 06:51:37,5274
976,0,3,979,"256 days, 23:02:09",2013-01-22 00:00:35,2010-02-01 10:32:08,2010-10-16 09:34:17,9571
1,0,14,15,"257 days, 0:22:29",2012-12-17 02:18:40,2010-02-01 10:32:08,2010-10-16 10:54:37,9854
466,165,384,1015,"257 days, 16:09:39",2013-01-31 10:44:54,2010-02-01 10:32:08,2010-10-17 02:41:47,1563
8,92,111,211,"257 days, 16:22:11",2013-02-02 05:03:32,2010-02-01 10:32:08,2010-10-17 02:54:19,3159
298,2,53,353,"257 days, 16:53:27",2013-01-18 11:24:53,2010-02-01 10:32:08,2010-10-17 03:25:35,7580
232,179,250,661,"257 days, 19:02:54",2013-02-07 00:20:08,2010-02-01 10:32:08,2010-10-17 05:35:02,4451
36,167,337,540,"257 days, 19:20:32",2013-02-04 05:45:58,2010-02-01 10:32:08,2010-10-17 05:52:40,5606
339,0,12,351,"257 days, 19:44:48",2012-12-30 08:20:04,2010-12-07 06:58:49,2011-08-22 02:43:37,1165
0,3,65,68,"257 days, 21:36:46",2013-01-28 06:23:58,2010-02-01 10:32:08,2010-10-17 08:08:54,8548
240,4,15,259,"257 days, 22:25:56",2013-01-30 05:35:38,2010-02-01 10:32:08,2010-10-17 08:58:04,3649
113,23,149,285,"258 days, 1:03:26",2013-02-02 10:51:42,2010-02-01 10:32:08,2010-10-17 11:35:34,7771
129,2,96,227,"258 days, 14:50:10",2013-02-05 04:30:17,2010-02-01 10:32:08,2010-10-18 01:22:18,6928
357,20,55,432,"258 days, 22:22:36",2013-02-02 05:45:57,2010-02-01 10:32:08,2010-10-18 08:54:44,781
74,4,93,171,"258 days, 23:04:07",2013-01-26 03:33:44,2010-02-01 10:32:08,2010-10-18 09:36:15,6878
456,120,157,733,"258 days, 23:29:54",2013-02-01 07:34:14,2010-02-01 10:32:08,2010-10-18 10:02:02,4101
386,51,119,556,"259 days, 0:00:19",2013-02-03 08:59:13,2010-02-01 10:32:08,2010-10-18 10:32:27,1659
625,1,23,649,"259 days, 0:17:38",2013-01-31 07:15:06,2010-02-01 10:32:08,2010-10-18 10:49:46,8620
85,107,214,406,"259 days, 0:53:35",2013-02-05 10:21:26,2010-02-01 10:32:08,2010-10-18 11:25:43,6304
267,0,11,278,"259 days, 1:03:29",2013-01-15 03:10:28,2010-02-01 10:32:08,2010-10-18 11:35:37,2445
164,2,83,249,"259 days, 15:52:37",2013-02-03 06:49:08,2010-02-01 10:32:08,2010-10-19 02:24:45,2540
299,1,16,316,"259 days, 15:55:50",2013-01-17 07:05:15,2010-02-01 10:32:08,2010-10-19 02:27:58,8271
17,0,1,18,"259 days, 16:27:00",2013-01-21 02:32:07,2010-02-01 10:32:08,2010-10-19 02:59:08,600
15,0,15,30,"259 days, 19:13:53",2013-01-09 11:52:47,2010-02-01 10:32:08,2010-10-19 05:46:01,2975
1059,131,179,1369,"259 days, 19:33:06",2013-02-06 06:36:46,2010-02-01 10:32:08,2010-10-19 06:05:14,4335
726,2,28,756,"259 days, 19:59:55",2013-01-30 02:52:09,2010-02-01 10:32:08,2010-10-19 06:32:03,9513
190,3,26,219,"260 days, 3:31:38",2013-02-08 06:47:06,2011-04-27 06:40:48,2012-01-12 10:12:26,5022
155,55,232,442,"260 days, 14:22:41",2013-02-03 08:37:37,2010-02-01 10:32:08,2010-10-20 00:54:49,8628
497,59,155,711,"260 days, 17:01:03",2013-02-03 08:33:29,2010-02-01 10:32:08,2010-10-20 03:33:11,7578
528,1,52,581,"260 days, 17:58:48",2013-01-27 01:22:02,2010-02-01 10:32:08,2010-10-20 04:30:56,6946
468,0,65,533,"260 days, 18:29:17",2013-02-05 11:28:15,2010-02-01 10:32:08,2010-10-20 05:01:25,9449
739,99,352,1190,"260 days, 18:29:30",2013-02-07 03:06:17,2010-02-01 10:32:08,2010-10-20 05:01:38,566
504,0,2,506,"260 days, 19:22:09",2013-01-18 09:07:10,2010-02-01 10:32:08,2010-10-20 05:54:17,6246
833,80,79,992,"260 days, 19:32:06",2013-02-02 04:54:26,2010-02-01 10:32:08,2010-10-20 06:04:14,4156
1041,301,429,1771,"260 days, 20:29:48",2013-02-05 05:10:47,2010-02-01 10:32:08,2010-10-20 07:01:56,1757
45,1,28,74,"260 days, 20:33:54",2013-02-05 10:13:20,2010-02-01 10:32:08,2010-10-20 07:06:02,9155
51,1,82,134,"260 days, 22:12:58",2013-01-27 02:08:39,2010-02-01 10:32:08,2010-10-20 08:45:06,4257
435,274,229,938,"261 days, 0:17:56",2013-02-02 08:13:20,2010-02-01 10:32:08,2010-10-20 10:50:04,933
14,96,192,302,"261 days, 15:11:27",2013-02-06 05:16:21,2010-02-01 10:32:08,2010-10-21 01:43:35,5467
206,6,86,298,"261 days, 16:00:59",2013-02-06 10:59:27,2010-02-01 10:32:08,2010-10-21 02:33:07,5038
297,0,0,297,"261 days, 19:05:08",2013-01-28 04:36:43,2010-02-01 10:32:08,2010-10-21 05:37:16,3149
768,0,63,831,"261 days, 21:09:42",2013-01-29 04:15:46,2010-02-01 10:32:08,2010-10-21 07:41:50,9291
295,10,116,421,"261 days, 21:19:48",2013-02-05 06:25:40,2010-02-01 10:32:08,2010-10-21 07:51:56,6465
269,5,29,303,"261 days, 21:42:34",2013-01-28 03:48:51,2010-02-01 10:32:08,2010-10-21 08:14:42,9906
731,341,674,1746,"262 days, 0:29:27",2013-02-05 06:57:17,2010-02-01 10:32:08,2010-10-21 11:01:35,7248
1027,0,1,1028,"262 days, 13:57:57",2013-01-22 09:45:57,2010-02-01 10:32:08,2010-10-22 00:30:05,354
245,3,139,387,"262 days, 14:29:51",2013-01-25 08:29:25,2010-02-01 10:32:08,2010-10-22 01:01:59,8473
279,3,3,285,"262 days, 15:01:40",2013-01-25 11:55:51,2010-02-01 10:32:08,2010-10-22 01:33:48,2871
714,30,203,947,"262 days, 16:08:11",2013-02-05 02:43:32,2010-02-01 10:32:08,2010-10-22 02:40:19,8053
1074,0,0,1074,"262 days, 18:40:23",2013-01-21 06:02:46,2010-02-01 10:32:08,2010-10-22 05:12:31,1957
13,81,344,438,"262 days, 20:21:43",2013-02-06 09:25:19,2010-03-26 07:58:10,2010-12-14 04:19:53,5438
275,5,162,442,"262 days, 22:33:24",2013-02-02 01:46:40,2010-02-01 10:32:08,2010-10-22 09:05:32,8080
1052,1,111,1164,"263 days, 0:11:24",2013-02-04 03:04:28,2010-02-01 10:32:08,2010-10-22 10:43:32,282
790,1,24,815,"263 days, 13:28:36",2013-01-28 10:56:41,2010-02-01 10:32:08,2010-10-23 00:00:44,8507
4,18,111,133,"263 days, 14:29:24",2013-02-01 11:10:15,2010-02-01 10:32:08,2010-10-23 01:01:32,4474
18,59,71,148,"263 days, 15:02:02",2013-01-28 00:19:45,2010-02-01 10:32:08,2010-10-23 01:34:10,1713
223,42,355,620,"263 days, 17:00:11",2013-02-05 10:37:16,2010-02-01 10:32:08,2010-10-23 03:32:19,1936
47,69,167,283,"263 days, 17:45:05",2013-01-27 06:04:01,2010-02-01 10:32:08,2010-10-23 04:17:13,1428
1,79,191,271,"263 days, 18:17:37",2013-02-05 05:43:06,2010-02-01 10:32:08,2010-10-23 04:49:45,5084
18,109,217,344,"263 days, 21:01:33",2013-02-01 05:28:07,2010-02-01 10:32:08,2010-10-23 07:33:41,1856
5,5,83,93,"264 days, 14:52:39",2013-01-29 08:10:38,2010-02-01 10:32:08,2010-10-24 01:24:47,4126
1031,19,13,1063,"264 days, 17:05:59",2013-01-31 06:07:38,2010-02-01 10:32:08,2010-10-24 03:38:07,5362
724,122,279,1125,"265 days, 13:56:12",2013-02-05 08:36:27,2010-02-01 10:32:08,2010-10-25 00:28:20,6308
25,0,15,40,"265 days, 16:41:51",2013-01-29 05:43:28,2010-02-01 10:32:08,2010-10-25 03:13:59,1621
107,0,453,560,"265 days, 17:17:36",2013-02-03 11:42:16,2010-02-01 10:32:08,2010-10-25 03:49:44,8384
9,0,6,15,"265 days, 23:05:53",2012-12-25 07:48:28,2010-02-01 10:32:08,2010-10-25 09:38:01,4070
255,0,10,265,"265 days, 23:40:58",2013-01-30 11:19:15,2010-02-01 10:32:08,2010-10-25 10:13:06,521
292,0,5,297,"266 days, 17:40:50",2013-01-28 10:52:34,2010-02-01 10:32:08,2010-10-26 04:12:58,5757
687,24,123,834,"266 days, 23:44:05",2013-02-01 08:16:15,2010-02-01 10:32:08,2010-10-26 10:16:13,288
470,0,0,470,"267 days, 14:40:21",2013-01-27 11:18:03,2010-02-01 10:32:08,2010-10-27 01:12:29,4739
321,120,131,572,"267 days, 14:41:28",2013-01-31 03:49:23,2010-02-01 10:32:08,2010-10-27 01:13:36,3292
237,11,60,308,"267 days, 15:35:37",2013-01-26 06:59:25,2010-02-01 10:32:08,2010-10-27 02:07:45,766
382,12,292,686,"268 days, 0:48:23",2013-02-02 03:12:46,2010-02-01 10:32:08,2010-10-27 11:20:31,1273
527,5,5,537,"268 days, 3:23:20",2013-01-19 10:00:28,2010-08-08 02:20:01,2011-05-03 05:43:21,739
510,57,223,790,"268 days, 16:46:26",2013-02-06 07:53:02,2010-02-01 10:32:08,2010-10-28 03:18:34,6858
21,108,304,433,"268 days, 16:48:53",2013-02-03 11:32:15,2010-02-01 10:32:08,2010-10-28 03:21:01,8311
475,0,0,475,"268 days, 19:51:28",2013-01-26 01:35:52,2010-02-01 10:32:08,2010-10-28 06:23:36,3882
5,0,16,21,"268 days, 20:08:29",2013-01-24 06:37:20,2010-02-01 10:32:08,2010-10-28 06:40:37,4904
5,2,42,49,"268 days, 22:06:42",2013-02-04 09:42:48,2010-02-01 10:32:08,2010-10-28 08:38:50,1870
10,0,3,13,"268 days, 23:15:39",2013-02-02 07:36:21,2010-12-01 11:54:12,2011-08-27 11:09:51,9226
568,0,68,636,"269 days, 15:40:59",2013-02-01 09:22:55,2010-02-01 10:32:08,2010-10-29 02:13:07,2338
2,1,64,67,"269 days, 18:17:57",2013-02-02 09:09:10,2010-02-01 10:32:08,2010-10-29 04:50:05,9805
384,193,394,971,"269 days, 19:21:24",2013-02-05 07:24:00,2010-02-01 10:32:08,2010-10-29 05:53:32,8835
88,14,109,211,"269 days, 23:07:57",2013-02-02 06:15:29,2010-02-01 10:32:08,2010-10-29 09:40:05,5333
252,172,444,868,"269 days, 23:12:41",2013-01-31 05:25:54,2010-02-01 10:32:08,2010-10-29 09:44:49,2496
796,3,31,830,"270 days, 16:31:34",2013-01-27 06:04:31,2010-02-01 10:32:08,2010-10-30 03:03:42,231
1086,10,108,1204,"270 days, 23:55:42",2013-02-01 11:14:44,2010-02-01 10:32:08,2010-10-30 10:27:50,1686
900,85,112,1097,"271 days, 0:29:11",2013-02-02 08:32:42,2010-02-01 10:32:08,2010-10-30 11:01:19,9688
272,0,14,286,"271 days, 1:43:56",2013-01-26 11:25:27,2011-03-30 02:51:11,2011-12-26 04:35:07,4514
88,118,97,303,"271 days, 11:32:19",2013-02-04 01:52:27,2010-03-10 00:19:29,2010-12-06 11:51:48,6730
1076,1,0,1077,"271 days, 13:37:07",2013-01-24 02:41:08,2010-02-01 10:32:08,2010-10-31 00:09:15,7150
15,8,5,28,"271 days, 22:43:50",2013-01-31 07:52:19,2010-08-08 04:47:49,2011-05-07 03:31:39,9572
22,32,247,301,"272 days, 0:26:20",2013-02-05 11:49:59,2010-02-01 10:32:08,2010-10-31 10:58:28,6577
213,1,35,249,"272 days, 13:30:14",2013-01-19 05:56:09,2010-02-01 10:32:08,2010-11-01 00:02:22,9537
548,6,121,675,"272 days, 15:58:42",2013-02-04 00:18:47,2010-02-01 10:32:08,2010-11-01 02:30:50,2477
21,2,29,52,"272 days, 18:49:32",2013-01-21 05:45:23,2010-02-01 10:32:08,2010-11-01 05:21:40,5937
322,176,372,870,"272 days, 21:34:47",2013-02-05 02:53:25,2010-02-01 10:32:08,2010-11-01 08:06:55,5147
880,6,23,909,"273 days, 0:05:51",2013-01-31 11:37:43,2010-02-01 10:32:08,2010-11-01 10:37:59,6644
809,8,65,882,"273 days, 20:25:01",2013-02-06 05:13:19,2010-02-01 10:32:08,2010-11-02 06:57:09,8354
36,1,20,57,"274 days, 0:11:22",2013-02-04 03:30:17,2011-05-13 09:40:41,2012-02-11 09:52:03,7489
70,59,109,238,"274 days, 1:14:41",2013-02-01 03:13:14,2010-02-01 10:32:08,2010-11-02 11:46:49,2115
560,98,281,939,"274 days, 19:50:39",2013-02-07 02:11:32,2010-02-01 10:32:08,2010-11-03 06:22:47,4384
261,55,280,596,"274 days, 20:06:01",2013-02-04 06:26:16,2010-02-01 10:32:08,2010-11-03 06:38:09,9137
21,12,52,85,"274 days, 20:39:18",2013-02-01 06:30:28,2010-02-01 10:32:08,2010-11-03 07:11:26,5966
1087,0,0,1087,"275 days, 0:33:25",2013-01-31 02:14:47,2010-02-01 10:32:08,2010-11-03 11:05:33,6743
27,8,74,109,"275 days, 1:24:14",2013-01-26 08:25:39,2010-02-01 10:32:08,2010-11-03 11:56:22,7568
1084,169,223,1476,"275 days, 15:49:41",2013-01-29 04:01:55,2010-02-01 10:32:08,2010-11-04 02:21:49,1502
71,23,176,270,"275 days, 16:38:02",2013-02-06 06:02:56,2010-02-01 10:32:08,2010-11-04 03:10:10,737
37,107,235,379,"275 days, 17:40:36",2013-02-01 00:34:46,2010-02-01 10:32:08,2010-11-04 04:12:44,8465
245,0,0,245,"275 days, 20:16:58",2013-01-17 05:11:12,2010-02-01 10:32:08,2010-11-04 06:49:06,3185
258,289,486,1033,"275 days, 21:41:24",2013-02-04 10:56:46,2010-02-01 10:32:08,2010-11-04 08:13:32,5532
566,219,343,1128,"275 days, 23:37:49",2013-02-04 01:29:49,2010-02-01 10:32:08,2010-11-04 10:09:57,3561
509,0,0,509,"276 days, 0:23:59",2012-12-16 06:04:33,2010-02-01 10:32:08,2010-11-04 10:56:07,2467
999,0,0,999,"276 days, 16:29:42",2013-01-31 03:30:17,2010-02-01 10:32:08,2010-11-05 03:01:50,5961
59,89,167,315,"276 days, 21:36:46",2013-02-01 00:46:59,2010-02-01 10:32:08,2010-11-05 08:08:54,1317
43,131,158,332,"277 days, 14:20:07",2013-02-03 04:10:52,2010-02-01 10:32:08,2010-11-06 00:52:15,4491
19,610,887,1516,"277 days, 15:31:02",2013-02-05 11:52:32,2010-02-01 10:32:08,2010-11-06 02:03:10,9138
263,1,39,303,"277 days, 17:41:52",2013-01-25 05:52:22,2010-02-01 10:32:08,2010-11-06 04:14:00,2590
524,1,48,573,"277 days, 18:07:01",2013-01-27 05:21:33,2010-02-01 10:32:08,2010-11-06 04:39:09,7940
96,33,78,207,"277 days, 19:09:46",2013-02-03 09:23:52,2010-02-01 10:32:08,2010-11-06 05:41:54,6017
299,0,0,299,"277 days, 20:21:30",2013-01-25 02:05:52,2010-02-01 10:32:08,2010-11-06 06:53:38,615
33,50,432,515,"277 days, 21:30:11",2013-02-03 11:30:38,2010-02-01 10:32:08,2010-11-06 08:02:19,7227
456,1,1,458,"277 days, 23:30:54",2013-01-10 09:27:08,2010-02-01 10:32:08,2010-11-06 10:03:02,8986
67,165,154,386,"278 days, 16:11:44",2013-02-06 08:12:11,2010-02-01 10:32:08,2010-11-07 02:43:52,8556
384,0,7,391,"278 days, 19:26:15",2013-02-04 06:11:46,2010-02-01 10:32:08,2010-11-07 05:58:23,4172
55,263,423,741,"278 days, 20:41:09",2013-02-05 02:25:55,2010-02-01 10:32:08,2010-11-07 07:13:17,4763
147,106,161,414,"278 days, 23:50:13",2013-02-06 10:10:37,2010-02-01 10:32:08,2010-11-07 10:22:21,1901
245,0,9,254,"279 days, 0:43:17",2013-01-23 09:39:11,2010-02-01 10:32:08,2010-11-07 11:15:25,5722
35,437,920,1392,"279 days, 14:02:30",2013-02-06 03:18:58,2010-02-01 10:32:08,2010-11-08 00:34:38,1458
23,0,176,199,"279 days, 15:17:18",2013-01-09 04:10:26,2010-02-01 10:32:08,2010-11-08 01:49:26,3687
1034,1,28,1063,"279 days, 15:30:17",2013-02-05 11:17:14,2010-02-01 10:32:08,2010-11-08 02:02:25,1704
895,1,89,985,"279 days, 22:59:33",2013-02-06 02:07:11,2010-02-01 10:32:08,2010-11-08 09:31:41,3872
196,46,334,576,"279 days, 23:31:00",2013-02-04 05:31:06,2010-02-01 10:32:08,2010-11-08 10:03:08,2493
620,145,537,1302,"280 days, 1:06:01",2013-02-06 05:20:00,2010-02-01 10:32:08,2010-11-08 11:38:09,4798
659,2,3,664,"280 days, 1:23:40",2013-01-27 11:59:44,2010-02-01 10:32:08,2010-11-08 11:55:48,4567
492,4,26,522,"280 days, 13:41:38",2013-01-25 06:02:08,2010-02-01 10:32:08,2010-11-09 00:13:46,4099
240,98,327,665,"280 days, 18:43:49",2013-02-04 00:58:48,2010-02-01 10:32:08,2010-11-09 05:15:57,2168
42,24,62,128,"280 days, 20:02:56",2013-02-07 05:44:07,2010-02-01 10:32:08,2010-11-09 06:35:04,8786
367,14,150,531,"281 days, 1:00:00",2013-02-01 09:12:13,2010-07-01 07:39:27,2011-04-08 08:39:27,3189
603,56,204,863,"281 days, 20:22:27",2013-02-02 03:16:17,2010-02-01 10:32:08,2010-11-10 06:54:35,8442
797,0,15,812,"281 days, 21:01:33",2013-01-20 08:31:07,2010-02-01 10:32:08,2010-11-10 07:33:41,6428
327,42,167,536,"281 days, 21:26:27",2013-02-05 05:15:05,2010-02-01 10:32:08,2010-11-10 07:58:35,2019
148,236,937,1321,"282 days, 1:18:04",2013-02-07 07:40:11,2010-02-01 10:32:08,2010-11-10 11:50:12,5848
734,0,7,741,"282 days, 1:23:17",2013-02-07 00:25:15,2010-02-01 10:32:08,2010-11-10 11:55:25,9608
637,155,305,1097,"282 days, 14:51:23",2013-02-05 03:25:00,2010-02-01 10:32:08,2010-11-11 01:23:31,1890
472,0,0,472,"282 days, 16:31:13",2012-12-27 05:53:36,2010-02-01 10:32:08,2010-11-11 03:03:21,3161
26,1,56,83,"282 days, 18:51:04",2013-02-07 00:49:10,2010-02-01 10:32:08,2010-11-11 05:23:12,1394
413,92,261,766,"282 days, 23:10:30",2013-02-03 07:45:46,2010-02-01 10:32:08,2010-11-11 09:42:38,3376
283,0,0,283,"282 days, 23:15:30",2013-01-18 09:02:42,2010-02-01 10:32:08,2010-11-11 09:47:38,3641
131,362,849,1342,"283 days, 0:39:52",2013-02-05 08:37:43,2010-02-01 10:32:08,2010-11-11 11:12:00,1371
44,10,94,148,"283 days, 21:41:50",2013-01-29 10:27:25,2010-02-01 10:32:08,2010-11-12 08:13:58,8727
674,12,113,799,"283 days, 21:42:28",2013-02-05 04:58:29,2010-02-01 10:32:08,2010-11-12 08:14:36,6456
822,1,0,823,"283 days, 21:55:19",2013-01-22 10:16:07,2010-02-01 10:32:08,2010-11-12 08:27:27,6062
1005,1,13,1019,"284 days, 0:06:52",2013-01-30 02:02:37,2010-02-01 10:32:08,2010-11-12 10:39:00,8885
556,0,33,589,"284 days, 14:01:57",2013-01-23 02:34:57,2010-02-01 10:32:08,2010-11-13 00:34:05,9706
6,0,35,41,"284 days, 15:07:17",2013-02-01 07:29:58,2010-02-01 10:32:08,2010-11-13 01:39:25,8785
303,1,131,435,"284 days, 15:21:14",2013-02-05 07:22:01,2010-02-01 10:32:08,2010-11-13 01:53:22,5690
4,5,87,96,"284 days, 20:43:37",2013-01-31 03:41:28,2010-02-01 10:32:08,2010-11-13 07:15:45,6123
102,0,13,115,"284 days, 21:49:01",2013-01-26 01:09:21,2010-02-01 10:32:08,2010-11-13 08:21:09,2048
21,0,13,34,"284 days, 23:49:55",2013-01-30 07:45:46,2010-02-01 10:32:08,2010-11-13 10:22:03,9430
7,31,212,250,"285 days, 14:59:23",2013-02-01 08:36:16,2010-02-01 10:32:08,2010-11-14 01:31:31,3762
960,0,0,960,"285 days, 15:11:27",2013-01-23 09:17:20,2010-02-01 10:32:08,2010-11-14 01:43:35,8242
348,953,1670,2971,"285 days, 19:49:46",2013-02-07 10:50:35,2010-02-01 10:32:08,2010-11-14 06:21:54,7372
10,1,49,60,"285 days, 23:35:22",2013-01-31 01:08:25,2010-02-01 10:32:08,2010-11-14 10:07:30,5210
185,13,166,364,"286 days, 13:59:18",2013-02-02 05:23:43,2010-02-01 10:32:08,2010-11-15 00:31:26,1743
212,98,644,954,"286 days, 19:17:32",2013-02-05 04:48:11,2010-02-01 10:32:08,2010-11-15 05:49:40,6846
792,1,10,803,"286 days, 20:48:40",2013-01-22 09:40:04,2010-02-01 10:32:08,2010-11-15 07:20:48,7181
585,186,536,1307,"287 days, 0:01:10",2013-02-06 09:05:43,2010-02-01 10:32:08,2010-11-15 10:33:18,5374
1049,0,8,1057,"287 days, 0:18:41",2013-02-04 00:56:25,2010-02-01 10:32:08,2010-11-15 10:50:49,2771
37,2,35,74,"287 days, 1:06:34",2013-01-26 03:23:37,2010-02-01 10:32:08,2010-11-15 11:38:42,8182
8,28,40,76,"287 days, 15:34:16",2013-02-02 09:36:31,2010-02-01 10:32:08,2010-11-16 02:06:24,3243
138,207,428,773,"287 days, 16:02:15",2013-01-30 07:04:43,2010-02-01 10:32:08,2010-11-16 02:34:23,3621
319,886,1092,2297,"287 days, 20:15:27",2013-02-03 09:53:18,2010-02-01 10:32:08,2010-11-16 06:47:35,2562
279,1,53,333,"287 days, 22:56:08",2013-02-04 00:59:01,2010-02-01 10:32:08,2010-11-16 09:28:16,5093
473,3,90,566,"287 days, 23:57:41",2013-01-31 11:05:17,2010-02-01 10:32:08,2010-11-16 10:29:49,8149
485,2,44,531,"288 days, 0:59:36",2013-02-01 05:29:29,2010-02-01 10:32:08,2010-11-16 11:31:44,1747
23,199,412,634,"288 days, 1:19:13",2013-02-03 09:25:13,2010-02-01 10:32:08,2010-11-16 11:51:21,7804
835,1,24,860,"288 days, 15:54:22",2013-01-28 07:45:41,2010-02-01 10:32:08,2010-11-17 02:26:30,6476
0,4,40,44,"288 days, 21:46:09",2013-02-01 09:29:22,2010-02-01 10:32:08,2010-11-17 08:18:17,8413
1167,4,33,1204,"288 days, 23:20:59",2013-02-01 03:46:06,2010-02-01 10:32:08,2010-11-17 09:53:07,6077
519,199,209,927,"290 days, 14:22:54",2013-02-04 09:08:31,2010-02-01 10:32:08,2010-11-19 00:55:02,8966
103,0,26,129,"290 days, 16:07:31",2013-01-30 05:21:43,2010-02-01 10:32:08,2010-11-19 02:39:39,6732
23,0,10,33,"290 days, 16:25:55",2013-01-07 11:54:05,2010-02-01 10:32:08,2010-11-19 02:58:03,8837
28,3,23,54,"290 days, 22:09:46",2013-01-23 03:51:31,2010-02-01 10:32:08,2010-11-19 08:41:54,8329
27,293,669,989,"291 days, 0:09:07",2013-02-07 01:09:16,2010-02-01 10:32:08,2010-11-19 10:41:15,1463
262,2,39,303,"291 days, 0:44:01",2013-01-25 01:45:44,2010-02-01 10:32:08,2010-11-19 11:16:09,9297
86,0,66,152,"291 days, 14:08:20",2013-02-02 03:42:33,2010-02-01 10:32:08,2010-11-20 00:40:28,8151
191,4,61,256,"291 days, 15:23:02",2013-01-28 10:14:33,2010-02-01 10:32:08,2010-11-20 01:55:10,3626
8,2,3,13,"291 days, 19:11:52",2013-01-29 10:05:33,2010-02-01 10:32:08,2010-11-20 05:44:00,1771
1015,3,27,1045,"291 days, 19:25:53",2013-02-03 01:24:53,2010-02-01 10:32:08,2010-11-20 05:58:01,1158
64,221,561,846,"291 days, 19:44:13",2013-02-03 09:30:38,2010-02-01 10:32:08,2010-11-20 06:16:21,2284
148,1,7,156,"291 days, 20:50:18",2013-01-18 03:52:04,2010-09-25 10:22:05,2011-07-14 07:12:23,580
25,97,232,354,"291 days, 22:37:35",2013-02-05 00:02:50,2010-02-01 10:32:08,2010-11-20 09:09:43,7679
1111,11,218,1340,"292 days, 16:50:22",2013-01-31 10:14:14,2010-02-01 10:32:08,2010-11-21 03:22:30,6181
687,0,25,712,"292 days, 17:33:20",2013-01-23 04:04:46,2010-02-01 10:32:08,2010-11-21 04:05:28,563
107,88,334,529,"292 days, 18:54:47",2013-02-04 04:38:52,2010-02-01 10:32:08,2010-11-21 05:26:55,8559
234,7,55,296,"292 days, 19:47:10",2013-01-25 08:40:33,2010-02-01 10:32:08,2010-11-21 06:19:18,8930
3,98,204,305,"293 days, 0:08:03",2013-02-06 01:37:43,2010-02-01 10:32:08,2010-11-21 10:40:11,3592
162,93,342,597,"293 days, 15:58:51",2013-02-05 08:08:07,2010-02-01 10:32:08,2010-11-22 02:30:59,5651
516,0,36,552,"293 days, 16:45:02",2013-01-27 00:15:41,2010-02-01 10:32:08,2010-11-22 03:17:10,5640
771,1,13,785,"293 days, 22:04:34",2013-01-30 01:58:04,2010-02-01 10:32:08,2010-11-22 08:36:42,7638
274,0,22,296,"294 days, 19:39:58",2013-01-28 05:29:20,2010-02-01 10:32:08,2010-11-23 06:12:06,4926
494,193,381,1068,"294 days, 19:53:16",2013-01-30 08:57:37,2010-02-01 10:32:08,2010-11-23 06:25:24,4498
970,0,1,971,"295 days, 16:47:29",2013-01-26 00:40:04,2010-02-01 10:32:08,2010-11-24 03:19:37,9687
8,4,13,25,"295 days, 20:03:59",2013-01-30 09:54:35,2010-02-01 10:32:08,2010-11-24 06:36:07,6147
263,105,149,517,"295 days, 20:32:30",2013-02-03 06:24:13,2010-02-01 10:32:08,2010-11-24 07:04:38,8077
954,0,16,970,"295 days, 21:41:28",2013-02-06 01:15:08,2010-02-01 10:32:08,2010-11-24 08:13:36,3235
140,2,34,176,"296 days, 13:42:10",2013-01-31 04:45:57,2010-02-01 10:32:08,2010-11-25 00:14:18,2240
1003,1,20,1024,"296 days, 20:49:48",2013-02-01 00:16:28,2010-02-01 10:32:08,2010-11-25 07:21:56,8871
1033,9,5,1047,"296 days, 21:22:03",2013-01-26 01:46:15,2010-02-01 10:32:08,2010-11-25 07:54:11,6601
126,1,19,146,"296 days, 22:54:55",2013-01-19 02:09:10,2010-02-01 10:32:08,2010-11-25 09:27:03,9890
467,8,12,487,"297 days, 22:11:45",2013-01-26 10:25:29,2010-02-01 10:32:08,2010-11-26 08:43:53,2426
304,4,107,415,"297 days, 22:39:08",2013-02-06 05:00:25,2010-02-01 10:32:08,2010-11-26 09:11:16,2296
13,1,0,14,"297 days, 22:41:29",2012-11-06 00:05:34,2010-02-01 10:32:08,2010-11-26 09:13:37,8790
36,4,28,68,"297 days, 23:51:01",2013-01-31 01:01:24,2010-02-01 10:32:08,2010-11-26 10:23:09,4938
106,114,122,342,"298 days, 0:48:40",2013-02-03 05:03:24,2010-02-01 10:32:08,2010-11-26 11:20:48,7400
78,114,116,308,"298 days, 13:37:23",2013-02-02 09:58:48,2010-02-01 10:32:08,2010-11-27 00:09:31,2872
250,349,750,1349,"298 days, 14:49:52",2013-02-06 04:15:24,2010-02-01 10:32:08,2010-11-27 01:22:00,224
30,2,63,95,"298 days, 16:51:26",2013-02-06 10:42:14,2010-02-01 10:32:08,2010-11-27 03:23:34,2
681,0,12,693,"298 days, 16:54:23",2013-01-26 05:07:26,2010-02-01 10:32:08,2010-11-27 03:26:31,1251
311,224,296,831,"298 days, 17:00:33",2013-02-02 02:52:06,2010-02-01 10:32:08,2010-11-27 03:32:41,4677
197,118,223,538,"298 days, 19:51:13",2013-02-04 08:45:01,2010-02-01 10:32:08,2010-11-27 06:23:21,8819
200,2,2,204,"298 days, 21:38:19",2013-01-17 11:39:42,2010-09-01 05:24:07,2011-06-27 03:02:26,340
493,0,0,493,"298 days, 21:57:55",2013-01-22 11:20:56,2010-02-01 10:32:08,2010-11-27 08:30:03,2016
31,0,16,47,"299 days, 14:23:00",2013-01-28 10:49:46,2010-02-01 10:32:08,2010-11-28 00:55:08,8474
24,1,73,98,"299 days, 15:05:39",2013-01-24 06:59:50,2010-02-01 10:32:08,2010-11-28 01:37:47,7467
586,131,217,934,"299 days, 18:16:27",2013-02-01 07:16:43,2010-02-01 10:32:08,2010-11-28 04:48:35,8716
21,41,143,205,"299 days, 19:26:22",2013-02-02 08:47:06,2010-02-01 10:32:08,2010-11-28 05:58:30,4205
1137,6,70,1213,"299 days, 19:34:55",2013-01-30 00:18:50,2010-02-01 10:32:08,2010-11-28 06:07:03,5924
710,290,650,1650,"299 days, 21:32:49",2013-02-04 07:09:34,2010-02-01 10:32:08,2010-11-28 08:04:57,6092
665,1,17,683,"299 days, 22:14:57",2013-02-01 11:25:39,2010-02-01 10:32:08,2010-11-28 08:47:05,6729
612,0,8,620,"300 days, 0:00:03",2013-01-22 10:17:27,2010-02-01 10:32:08,2010-11-28 10:32:11,7536
476,34,304,814,"300 days, 18:08:21",2013-02-02 09:54:15,2010-02-01 10:32:08,2010-11-29 04:40:29,7334
478,0,79,557,"300 days, 18:55:43",2013-02-02 06:08:04,2010-02-01 10:32:08,2010-11-29 05:27:51,7072
62,4,51,117,"300 days, 19:12:37",2013-02-02 08:57:44,2010-02-01 10:32:08,2010-11-29 05:44:45,4586
460,0,6,466,"300 days, 21:58:06",2013-01-28 06:57:54,2010-02-01 10:32:08,2010-11-29 08:30:14,8184
263,0,7,270,"301 days, 0:53:31",2013-01-30 11:22:07,2010-02-01 10:32:08,2010-11-29 11:25:39,6373
765,1,42,808,"301 days, 16:59:08",2013-01-26 09:11:04,2010-02-01 10:32:08,2010-11-30 03:31:16,511
461,0,1,462,"301 days, 19:20:28",2013-01-27 02:05:52,2010-02-01 10:32:08,2010-11-30 05:52:36,8487
276,0,6,282,"301 days, 21:40:09",2013-01-15 11:49:03,2010-02-01 10:32:08,2010-11-30 08:12:17,6812
695,27,231,953,"302 days, 1:04:48",2013-02-03 05:18:56,2010-02-01 10:32:08,2010-11-30 11:36:56,3250
240,49,166,455,"302 days, 17:02:59",2013-01-24 03:15:56,2010-02-01 10:32:08,2010-12-01 03:35:07,9827
512,55,101,668,"302 days, 22:04:47",2013-02-02 06:29:22,2010-02-01 10:32:08,2010-12-01 08:36:55,3775
390,195,193,778,"302 days, 22:28:26",2013-02-06 02:09:08,2010-02-01 10:32:08,2010-12-01 09:00:34,2346
725,0,35,760,"302 days, 23:29:32",2013-01-23 06:17:03,2010-02-01 10:32:08,2010-12-01 10:01:40,5332
7,1,28,36,"303 days, 0:50:28",2013-01-27 09:44:06,2010-05-15 08:07:01,2011-03-14 08:57:29,9250
20,25,82,127,"303 days, 0:57:45",2013-01-13 11:03:50,2010-02-01 10:32:08,2010-12-01 11:29:53,3398
370,1,16,387,"303 days, 15:36:05",2013-01-25 03:34:04,2010-02-01 10:32:08,2010-12-02 02:08:13,1876
83,17,117,217,"303 days, 16:05:07",2013-02-01 02:15:37,2010-02-01 10:32:08,2010-12-02 02:37:15,6756
16,1,0,17,"303 days, 16:05:41",2013-01-25 10:59:32,2010-02-01 10:32:08,2010-12-02 02:37:49,3257
349,171,223,743,"303 days, 18:18:35",2013-02-04 07:33:51,2010-02-01 10:32:08,2010-12-02 04:50:43,4086
260,45,494,799,"303 days, 20:26:16",2013-02-05 10:38:15,2010-02-01 10:32:08,2010-12-02 06:58:24,4198
3,26,151,180,"304 days, 1:21:25",2013-02-03 09:50:03,2010-02-01 10:32:08,2010-12-02 11:53:33,2726
509,0,11,520,"304 days, 15:31:09",2013-01-29 08:58:58,2010-02-01 10:32:08,2010-12-03 02:03:17,4500
829,0,15,844,"305 days, 13:35:38",2013-01-24 01:48:25,2010-02-01 10:32:08,2010-12-04 00:07:46,6445
711,10,150,871,"305 days, 14:11:03",2013-02-04 05:13:41,2010-02-01 10:32:08,2010-12-04 00:43:11,5491
982,0,0,982,"305 days, 15:14:39",2013-01-24 11:38:38,2010-02-01 10:32:08,2010-12-04 01:46:47,3181
22,82,527,631,"305 days, 16:23:01",2013-01-31 11:36:22,2010-02-01 10:32:08,2010-12-04 02:55:09,1461
2,28,254,284,"305 days, 17:38:19",2013-02-01 03:06:04,2010-02-01 10:32:08,2010-12-04 04:10:27,3670
724,0,0,724,"305 days, 18:24:03",2013-01-28 10:15:53,2010-02-01 10:32:08,2010-12-04 04:56:11,1516
307,7,0,314,"305 days, 19:37:05",2013-02-01 11:23:18,2010-02-01 10:32:08,2010-12-04 06:09:13,6203
513,37,201,751,"305 days, 22:00:17",2013-02-02 05:26:26,2010-02-01 10:32:08,2010-12-04 08:32:25,5892
55,75,114,244,"305 days, 23:14:29",2013-02-03 07:51:03,2010-02-01 10:32:08,2010-12-04 09:46:37,6506
616,8,49,673,"306 days, 0:51:01",2013-01-31 08:34:29,2010-05-29 06:24:07,2011-03-31 07:15:08,56
571,282,389,1242,"306 days, 16:23:25",2013-02-02 00:35:13,2010-02-01 10:32:08,2010-12-05 02:55:33,2847
11,92,57,160,"306 days, 19:01:51",2013-02-03 01:35:24,2010-02-01 10:32:08,2010-12-05 05:33:59,9976
30,10,99,139,"307 days, 0:57:11",2013-01-22 07:46:04,2010-02-01 10:32:08,2010-12-05 11:29:19,4562
238,18,178,434,"307 days, 13:49:50",2013-02-02 01:22:30,2010-02-01 10:32:08,2010-12-06 00:21:58,4528
542,192,272,1006,"307 days, 14:02:36",2013-02-04 03:14:22,2010-02-01 10:32:08,2010-12-06 00:34:44,6376
309,3,217,529,"307 days, 14:55:27",2013-02-05 09:22:13,2010-02-01 10:32:08,2010-12-06 01:27:35,8627
482,0,90,572,"307 days, 17:27:56",2013-02-02 08:31:12,2010-02-01 10:32:08,2010-12-06 04:00:04,9748
295,511,1004,1810,"307 days, 18:12:29",2013-02-06 05:47:24,2010-02-01 10:32:08,2010-12-06 04:44:37,8163
306,135,125,566,"307 days, 19:46:29",2013-02-01 07:08:37,2010-02-01 10:32:08,2010-12-06 06:18:37,5817
186,82,162,430,"307 days, 23:00:49",2013-02-05 01:33:57,2010-02-01 10:32:08,2010-12-06 09:32:57,6526
647,3,33,683,"307 days, 23:17:28",2013-01-21 10:15:17,2010-02-01 10:32:08,2010-12-06 09:49:36,9690
137,198,383,718,"308 days, 0:15:16",2013-02-05 10:57:31,2010-02-01 10:32:08,2010-12-06 10:47:24,6273
17,149,598,764,"308 days, 1:03:20",2013-02-05 03:33:54,2010-02-01 10:32:08,2010-12-06 11:35:28,4187
226,9,122,357,"308 days, 19:31:08",2013-02-04 04:18:37,2010-02-01 10:32:08,2010-12-07 06:03:16,315
155,25,180,360,"308 days, 19:59:34",2013-02-03 06:06:22,2010-02-01 10:32:08,2010-12-07 06:31:42,4211
63,10,202,275,"308 days, 20:16:51",2013-02-05 11:36:22,2010-02-01 10:32:08,2010-12-07 06:48:59,9897
1053,1,57,1111,"309 days, 0:49:32",2013-02-06 01:55:43,2010-02-01 10:32:08,2010-12-07 11:21:40,6974
272,3,9,284,"309 days, 14:01:48",2013-01-20 02:41:55,2010-02-01 10:32:08,2010-12-08 00:33:56,2533
1059,224,156,1439,"309 days, 15:29:15",2013-02-06 05:59:07,2010-02-01 10:32:08,2010-12-08 02:01:23,4396
369,448,300,1117,"309 days, 16:09:50",2013-02-04 08:53:21,2010-02-01 10:32:08,2010-12-08 02:41:58,5816
555,0,7,562,"309 days, 21:22:57",2013-01-30 06:35:16,2010-02-01 10:32:08,2010-12-08 07:55:05,1612
433,126,286,845,"309 days, 22:26:08",2013-02-03 05:05:03,2010-02-01 10:32:08,2010-12-08 08:58:16,2192
4,19,105,128,"310 days, 1:05:02",2013-02-04 02:33:40,2010-02-01 10:32:08,2010-12-08 11:37:10,9179
406,1,111,518,"310 days, 1:23:31",2013-01-25 06:23:24,2010-02-01 10:32:08,2010-12-08 11:55:39,5242
318,13,102,433,"310 days, 17:41:24",2013-02-03 09:36:58,2010-02-01 10:32:08,2010-12-09 04:13:32,5520
28,319,570,917,"311 days, 14:26:42",2013-02-06 05:45:59,2010-02-01 10:32:08,2010-12-10 00:58:50,5550
11,1,8,20,"311 days, 17:37:20",2013-02-02 01:35:25,2010-02-01 10:32:08,2010-12-10 04:09:28,1801
15,0,4,19,"311 days, 20:19:14",2013-02-07 07:37:33,2010-02-01 10:32:08,2010-12-10 06:51:22,8074
55,0,159,214,"312 days, 0:51:40",2013-01-29 10:17:43,2010-02-01 10:32:08,2010-12-10 11:23:48,7970
215,419,347,981,"312 days, 18:40:22",2013-02-06 09:32:08,2010-02-01 10:32:08,2010-12-11 05:12:30,3122
30,2,18,50,"312 days, 20:20:43",2013-02-01 00:45:16,2010-02-01 10:32:08,2010-12-11 06:52:51,3245
127,0,28,155,"312 days, 22:00:11",2013-01-31 03:42:05,2010-02-01 10:32:08,2010-12-11 08:32:19,3391
182,0,0,182,"313 days, 0:03:42",2013-01-05 02:26:19,2010-02-01 10:32:08,2010-12-11 10:35:50,302
401,104,351,856,"313 days, 0:15:24",2013-02-03 04:56:48,2010-02-01 10:32:08,2010-12-11 10:47:32,6637
514,4,75,593,"313 days, 1:02:22",2013-02-02 06:06:28,2010-02-01 10:32:08,2010-12-11 11:34:30,2153
961,118,269,1348,"313 days, 13:45:50",2013-02-06 11:37:56,2010-02-01 10:32:08,2010-12-12 00:17:58,6935
489,19,262,770,"313 days, 22:00:17",2013-02-04 04:03:47,2010-02-01 10:32:08,2010-12-12 08:32:25,2916
179,49,269,497,"314 days, 0:42:58",2013-02-06 03:48:53,2010-02-01 10:32:08,2010-12-12 11:15:06,2369
267,2,61,330,"315 days, 13:52:19",2013-02-01 02:49:36,2010-02-01 10:32:08,2010-12-14 00:24:27,1039
46,9,109,164,"315 days, 16:05:39",2013-02-03 06:37:28,2010-02-01 10:32:08,2010-12-14 02:37:47,8922
366,41,132,539,"315 days, 16:09:27",2013-02-03 08:49:38,2010-02-01 10:32:08,2010-12-14 02:41:35,6136
6,24,103,133,"315 days, 17:12:02",2013-01-27 07:37:00,2010-02-01 10:32:08,2010-12-14 03:44:10,5601
323,32,238,593,"315 days, 22:37:10",2013-02-04 09:06:27,2010-02-01 10:32:08,2010-12-14 09:09:18,7161
180,4,69,253,"316 days, 0:10:16",2013-02-04 00:32:32,2010-02-01 10:32:08,2010-12-14 10:42:24,1605
157,96,137,390,"316 days, 19:21:28",2013-02-02 01:57:11,2010-02-01 10:32:08,2010-12-15 05:53:36,5406
314,4,12,330,"317 days, 15:09:47",2013-02-02 02:54:53,2010-02-01 10:32:08,2010-12-16 01:41:55,8746
319,19,239,577,"317 days, 15:24:53",2013-02-04 00:31:46,2010-02-01 10:32:08,2010-12-16 01:57:01,9646
61,1,31,93,"317 days, 15:53:28",2013-01-09 07:35:34,2010-02-01 10:32:08,2010-12-16 02:25:36,6455
499,6,29,534,"317 days, 20:23:14",2013-02-06 02:22:21,2010-02-01 10:32:08,2010-12-16 06:55:22,806
1136,94,370,1600,"318 days, 1:05:14",2013-02-07 06:16:24,2010-02-01 10:32:08,2010-12-16 11:37:22,5560
18,52,123,193,"318 days, 20:07:18",2013-01-16 06:24:06,2010-02-01 10:32:08,2010-12-17 06:39:26,1763
962,23,81,1066,"318 days, 21:22:58",2013-02-04 11:35:43,2010-02-01 10:32:08,2010-12-17 07:55:06,2894
43,34,109,186,"318 days, 22:35:40",2013-02-05 08:16:12,2010-02-01 10:32:08,2010-12-17 09:07:48,2742
843,6,95,944,"319 days, 1:06:07",2013-02-04 11:15:22,2010-02-01 10:32:08,2010-12-17 11:38:15,2117
3,1,36,40,"319 days, 1:11:41",2013-02-04 06:38:48,2010-02-01 10:32:08,2010-12-17 11:43:49,1447
502,120,478,1100,"319 days, 14:03:20",2013-02-02 10:31:59,2010-02-01 10:32:08,2010-12-18 00:35:28,218
33,46,169,248,"319 days, 19:09:57",2013-02-07 07:45:47,2010-02-01 10:32:08,2010-12-18 05:42:05,5116
273,0,19,292,"319 days, 21:20:03",2013-01-25 04:12:47,2010-02-01 10:32:08,2010-12-18 07:52:11,7866
763,1,1,765,"319 days, 23:11:16",2013-01-19 03:17:56,2010-02-01 10:32:08,2010-12-18 09:43:24,126
57,449,728,1234,"320 days, 0:22:44",2013-02-05 01:23:23,2010-02-01 10:32:08,2010-12-18 10:54:52,5329
189,5,32,226,"320 days, 14:43:16",2013-01-26 08:42:35,2010-02-01 10:32:08,2010-12-19 01:15:24,1452
826,57,161,1044,"320 days, 16:07:24",2013-01-31 01:15:32,2010-02-01 10:32:08,2010-12-19 02:39:32,8655
227,1,10,238,"320 days, 21:03:42",2013-01-14 10:48:24,2010-02-01 10:32:08,2010-12-19 07:35:50,6026
285,0,0,285,"321 days, 13:47:24",2013-01-24 10:05:26,2010-02-01 10:32:08,2010-12-20 00:19:32,994
1,34,74,109,"321 days, 14:03:20",2013-02-06 05:51:37,2010-02-01 10:32:08,2010-12-20 00:35:28,2882
101,3,39,143,"321 days, 20:31:57",2013-02-01 04:48:24,2010-02-01 10:32:08,2010-12-20 07:04:05,8947
74,24,106,204,"321 days, 21:04:16",2013-02-05 05:02:50,2010-04-20 04:35:31,2011-03-08 01:39:47,4286
1000,1,0,1001,"321 days, 22:37:10",2013-01-27 09:01:06,2010-02-01 10:32:08,2010-12-20 09:09:18,4109
16,3,5,24,"321 days, 23:02:21",2013-02-01 00:14:23,2010-02-01 10:32:08,2010-12-20 09:34:29,382
16,2,10,28,"322 days, 15:53:14",2013-01-31 11:48:47,2010-02-01 10:32:08,2010-12-21 02:25:22,2472
987,3,7,997,"322 days, 17:27:22",2013-02-03 11:29:12,2010-02-01 10:32:08,2010-12-21 03:59:30,5300
9,26,111,146,"322 days, 17:36:13",2013-02-06 02:52:25,2010-02-01 10:32:08,2010-12-21 04:08:21,322
224,176,404,804,"322 days, 17:48:50",2013-02-03 09:04:06,2010-02-01 10:32:08,2010-12-21 04:20:58,7520
929,2,42,973,"322 days, 18:08:26",2013-01-31 01:59:13,2010-02-01 10:32:08,2010-12-21 04:40:34,6927
217,31,148,396,"322 days, 19:08:49",2013-02-06 08:03:36,2010-02-01 10:32:08,2010-12-21 05:40:57,498
311,21,225,557,"322 days, 22:01:37",2013-02-02 07:05:57,2010-02-01 10:32:08,2010-12-21 08:33:45,8744
11,4,40,55,"323 days, 0:33:43",2013-01-05 03:12:22,2010-02-01 10:32:08,2010-12-21 11:05:51,7594
380,0,20,400,"323 days, 15:54:18",2013-01-30 08:17:39,2010-02-01 10:32:08,2010-12-22 02:26:26,3909
237,0,7,244,"323 days, 18:56:36",2013-01-11 04:51:40,2010-02-01 10:32:08,2010-12-22 05:28:44,6241
29,6,207,242,"324 days, 0:16:43",2013-01-29 02:41:54,2010-02-01 10:32:08,2010-12-22 10:48:51,7982
823,1,35,859,"324 days, 18:05:53",2013-01-26 01:39:15,2010-02-01 10:32:08,2010-12-23 04:38:01,6000
3,1,18,22,"324 days, 19:36:50",2013-01-13 06:21:37,2010-02-01 10:32:08,2010-12-23 06:08:58,7825
124,34,95,253,"324 days, 23:08:56",2013-02-03 05:17:58,2010-02-01 10:32:08,2010-12-23 09:41:04,9594
693,0,12,705,"325 days, 0:16:53",2013-01-30 06:56:34,2010-02-01 10:32:08,2010-12-23 10:49:01,1986
310,10,197,517,"325 days, 0:35:23",2013-02-05 06:44:19,2010-02-01 10:32:08,2010-12-23 11:07:31,30
503,0,8,511,"325 days, 14:19:59",2013-01-27 07:43:42,2010-02-01 10:32:08,2010-12-24 00:52:07,6859
361,168,391,920,"325 days, 16:00:47",2013-02-04 08:18:47,2010-02-01 10:32:08,2010-12-24 02:32:55,3790
4,191,285,480,"325 days, 22:14:07",2013-02-04 08:00:32,2010-02-01 10:32:08,2010-12-24 08:46:15,1969
109,109,416,634,"325 days, 23:10:54",2013-02-02 04:38:01,2010-02-01 10:32:08,2010-12-24 09:43:02,7182
325,79,549,953,"325 days, 23:13:26",2013-02-05 08:00:11,2010-02-01 10:32:08,2010-12-24 09:45:34,644
285,3,0,288,"326 days, 2:36:17",2013-01-08 08:17:53,2010-11-13 05:38:33,2011-10-05 08:14:50,2980
480,2,133,615,"326 days, 18:43:48",2013-02-05 02:04:05,2010-02-01 10:32:08,2010-12-25 05:15:56,7988
295,8,17,320,"327 days, 1:17:40",2013-02-05 11:24:46,2010-02-01 10:32:08,2010-12-25 11:49:48,2466
61,16,179,256,"327 days, 14:17:44",2013-02-04 08:27:57,2010-02-01 10:32:08,2010-12-26 00:49:52,8488
139,2,34,175,"327 days, 16:16:34",2013-02-03 08:08:23,2010-02-01 10:32:08,2010-12-26 02:48:42,5953
700,0,40,740,"327 days, 19:03:23",2013-02-06 06:22:34,2010-02-01 10:32:08,2010-12-26 05:35:31,9131
214,7,55,276,"327 days, 20:51:24",2013-02-06 06:09:16,2010-02-01 10:32:08,2010-12-26 07:23:32,9113
5,0,0,5,"327 days, 21:56:15",2013-01-09 06:53:36,2011-05-03 10:08:21,2012-03-26 08:04:36,3474
45,67,341,453,"327 days, 23:17:56",2013-02-05 09:51:22,2010-02-01 10:32:08,2010-12-26 09:50:04,9511
393,231,949,1573,"328 days, 0:08:20",2013-02-05 10:19:36,2010-02-01 10:32:08,2010-12-26 10:40:28,2704
801,0,2,803,"328 days, 17:51:43",2013-01-29 00:34:52,2010-02-01 10:32:08,2010-12-27 04:23:51,6258
111,0,36,147,"328 days, 19:27:20",2012-12-28 06:19:50,2010-02-01 10:32:08,2010-12-27 05:59:28,6068
19,13,101,133,"328 days, 20:03:42",2013-01-31 07:25:20,2010-02-01 10:32:08,2010-12-27 06:35:50,411
67,187,457,711,"328 days, 20:13:48",2013-02-05 08:39:10,2010-02-01 10:32:08,2010-12-27 06:45:56,5280
347,80,285,712,"328 days, 22:55:17",2013-02-02 11:44:32,2010-02-01 10:32:08,2010-12-27 09:27:25,39
10,0,17,27,"328 days, 22:59:37",2012-12-23 04:01:20,2010-02-01 10:32:08,2010-12-27 09:31:45,9185
382,0,74,456,"329 days, 1:14:10",2013-01-24 03:59:35,2010-02-01 10:32:08,2010-12-27 11:46:18,6734
5,25,77,107,"329 days, 20:07:53",2013-01-30 11:56:37,2010-02-01 10:32:08,2010-12-28 06:40:01,9857
845,2,27,874,"329 days, 22:03:02",2013-01-25 04:01:17,2010-02-01 10:32:08,2010-12-28 08:35:10,6401
681,6,15,702,"330 days, 0:00:06",2013-02-03 10:06:49,2010-02-01 10:32:08,2010-12-28 10:32:14,4414
236,1,19,256,"330 days, 0:36:24",2013-01-29 04:01:45,2010-02-01 10:32:08,2010-12-28 11:08:32,6442
478,1,26,505,"330 days, 14:44:30",2013-01-17 06:13:21,2010-02-01 10:32:08,2010-12-29 01:16:38,3820
1023,0,0,1023,"330 days, 15:54:14",2013-01-25 07:47:51,2010-02-01 10:32:08,2010-12-29 02:26:22,5548
419,22,63,504,"330 days, 17:36:30",2013-02-03 04:41:28,2010-02-01 10:32:08,2010-12-29 04:08:38,8740
236,4,60,300,"330 days, 17:46:23",2013-01-28 10:07:08,2010-02-01 10:32:08,2010-12-29 04:18:31,9602
764,3,5,772,"330 days, 19:19:20",2013-02-04 05:57:33,2010-02-01 10:32:08,2010-12-29 05:51:28,2550
430,6,49,485,"331 days, 0:42:54",2013-01-29 09:38:46,2010-02-01 10:32:08,2010-12-29 11:15:02,8941
271,0,3,274,"331 days, 13:51:47",2013-01-23 06:54:00,2010-02-01 10:32:08,2010-12-30 00:23:55,7056
286,17,361,664,"331 days, 15:27:20",2013-02-04 03:28:08,2010-02-01 10:32:08,2010-12-30 01:59:28,5278
266,2,0,268,"331 days, 15:44:18",2013-01-29 10:23:25,2010-02-01 10:32:08,2010-12-30 02:16:26,3710
10,0,44,54,"331 days, 16:24:26",2013-01-09 10:29:44,2010-02-01 10:32:08,2010-12-30 02:56:34,3763
458,1,44,503,"331 days, 20:42:27",2013-01-29 03:42:31,2010-02-01 10:32:08,2010-12-30 07:14:35,4899
1048,0,1,1049,"332 days, 13:55:24",2013-01-31 09:27:44,2010-02-01 10:32:08,2010-12-31 00:27:32,2151
14,5,110,129,"332 days, 17:11:15",2013-01-30 11:03:05,2010-02-01 10:32:08,2010-12-31 03:43:23,5058
931,3,84,1018,"332 days, 17:12:43",2013-01-31 10:36:13,2010-02-01 10:32:08,2010-12-31 03:44:51,9390
35,62,728,825,"332 days, 18:15:31",2013-02-06 00:57:18,2010-02-01 10:32:08,2010-12-31 04:47:39,4542
143,10,215,368,"332 days, 18:41:03",2013-02-05 04:56:59,2010-02-01 10:32:08,2010-12-31 05:13:11,4033
586,74,237,897,"332 days, 19:18:58",2013-02-05 00:39:32,2010-04-12 09:41:45,2011-03-11 05:00:43,5378
115,5,88,208,"333 days, 16:25:57",2013-02-04 03:59:09,2010-02-01 10:32:08,2011-01-01 02:58:05,5919
87,72,109,268,"333 days, 16:31:50",2013-02-01 05:07:43,2010-02-01 10:32:08,2011-01-01 03:03:58,8887
570,125,439,1134,"333 days, 18:38:24",2013-02-05 04:32:58,2010-02-01 10:32:08,2011-01-01 05:10:32,6840
769,0,20,789,"333 days, 21:25:09",2013-01-25 00:15:08,2010-02-01 10:32:08,2011-01-01 07:57:17,5432
332,1,33,366,"333 days, 22:13:31",2013-02-04 07:26:29,2010-02-01 10:32:08,2011-01-01 08:45:39,1445
410,0,58,468,"333 days, 23:16:47",2013-01-08 05:34:37,2010-02-01 10:32:08,2011-01-01 09:48:55,6352
498,119,189,806,"333 days, 23:45:21",2013-01-30 11:53:21,2010-02-01 10:32:08,2011-01-01 10:17:29,9294
435,168,416,1019,"333 days, 23:52:36",2013-02-05 07:56:25,2010-02-01 10:32:08,2011-01-01 10:24:44,2379
328,163,276,767,"334 days, 22:00:03",2013-02-05 00:26:17,2010-02-01 10:32:08,2011-01-02 08:32:11,4292
383,91,290,764,"334 days, 22:01:51",2013-02-04 09:50:07,2010-02-01 10:32:08,2011-01-02 08:33:59,5223
203,52,165,420,"335 days, 0:16:24",2013-02-04 09:41:21,2010-02-01 10:32:08,2011-01-02 10:48:32,9437
569,1,4,574,"335 days, 2:32:37",2013-01-31 07:50:30,2010-07-22 08:25:57,2011-06-22 10:58:34,1281
269,3,165,437,"335 days, 15:18:35",2013-01-31 03:01:16,2010-02-01 10:32:08,2011-01-03 01:50:43,2118
485,0,25,510,"335 days, 15:45:15",2013-01-22 01:29:57,2010-02-01 10:32:08,2011-01-03 02:17:23,4071
32,4,111,147,"335 days, 16:00:46",2013-02-01 06:17:18,2010-02-01 10:32:08,2011-01-03 02:32:54,4351
724,6,70,800,"336 days, 15:24:16",2013-02-02 05:26:44,2010-02-01 10:32:08,2011-01-04 01:56:24,9330
9,0,32,41,"336 days, 16:17:11",2012-12-07 03:55:48,2010-02-01 10:32:08,2011-01-04 02:49:19,4129
9,0,0,9,"336 days, 16:36:05",2013-01-07 05:20:11,2010-02-01 10:32:08,2011-01-04 03:08:13,1246
556,115,189,860,"336 days, 17:45:07",2013-02-04 09:21:13,2010-02-01 10:32:08,2011-01-04 04:17:15,3261
5,0,0,5,"336 days, 19:56:57",2013-01-11 00:55:53,2010-02-01 10:32:08,2011-01-04 06:29:05,439
28,247,535,810,"336 days, 21:52:06",2013-02-07 01:40:24,2010-02-01 10:32:08,2011-01-04 08:24:14,8410
592,5,210,807,"336 days, 22:44:34",2013-02-03 11:32:24,2010-02-01 10:32:08,2011-01-04 09:16:42,8520
873,1,16,890,"337 days, 15:30:29",2013-02-03 08:08:09,2010-02-01 10:32:08,2011-01-05 02:02:37,2378
430,16,42,488,"337 days, 17:06:12",2013-02-05 01:28:54,2010-02-01 10:32:08,2011-01-05 03:38:20,8340
46,63,241,350,"337 days, 21:26:47",2013-02-04 07:52:33,2010-02-01 10:32:08,2011-01-05 07:58:55,9691
35,1,12,48,"337 days, 22:39:43",2013-01-31 09:04:22,2010-02-01 10:32:08,2011-01-05 09:11:51,8092
19,0,0,19,"337 days, 22:50:14",2012-12-08 05:32:09,2010-02-01 10:32:08,2011-01-05 09:22:22,5505
182,8,62,252,"338 days, 14:27:56",2013-01-29 06:03:22,2010-02-01 10:32:08,2011-01-06 01:00:04,6191
949,20,25,994,"338 days, 15:23:47",2013-02-03 01:29:34,2010-02-01 10:32:08,2011-01-06 01:55:55,7830
403,2,25,430,"338 days, 17:43:18",2013-01-31 01:27:45,2010-02-01 10:32:08,2011-01-06 04:15:26,1235
496,3,118,617,"338 days, 19:34:06",2013-01-27 00:39:04,2010-02-01 10:32:08,2011-01-06 06:06:14,5221
186,4,85,275,"338 days, 20:18:52",2013-01-31 10:35:29,2010-02-01 10:32:08,2011-01-06 06:51:00,335
119,121,372,612,"338 days, 23:19:21",2013-02-05 08:35:18,2010-02-01 10:32:08,2011-01-06 09:51:29,3576
531,0,0,531,"339 days, 16:11:37",2013-01-28 03:50:39,2010-02-01 10:32:08,2011-01-07 02:43:45,5822
376,9,19,404,"339 days, 16:37:46",2013-01-30 09:54:26,2010-02-01 10:32:08,2011-01-07 03:09:54,7358
7,75,227,309,"339 days, 22:17:10",2013-02-06 03:00:05,2010-02-01 10:32:08,2011-01-07 08:49:18,6860
158,0,25,183,"339 days, 22:55:20",2013-01-25 10:37:52,2010-02-01 10:32:08,2011-01-07 09:27:28,5191
0,22,146,168,"340 days, 22:36:12",2013-02-06 10:57:47,2010-02-01 10:32:08,2011-01-08 09:08:20,3020
15,29,2,46,"341 days, 0:57:46",2013-01-21 05:04:19,2010-02-01 10:32:08,2011-01-08 11:29:54,6638
138,8,91,237,"341 days, 14:39:36",2013-01-22 09:17:38,2010-02-01 10:32:08,2011-01-09 01:11:44,79
57,0,14,71,"341 days, 15:43:48",2013-01-27 00:03:21,2010-02-01 10:32:08,2011-01-09 02:15:56,645
24,14,169,207,"342 days, 0:29:27",2013-01-30 10:29:29,2010-02-01 10:32:08,2011-01-09 11:01:35,343
1042,45,150,1237,"342 days, 13:49:30",2013-02-03 09:25:13,2010-02-01 10:32:08,2011-01-10 00:21:38,3541
201,54,322,577,"342 days, 15:29:06",2013-01-30 02:38:31,2010-02-01 10:32:08,2011-01-10 02:01:14,1178
47,141,189,377,"342 days, 18:45:30",2013-02-03 08:16:49,2010-02-01 10:32:08,2011-01-10 05:17:38,5286
238,1,3,242,"342 days, 19:50:38",2013-01-30 11:32:12,2010-02-01 10:32:08,2011-01-10 06:22:46,3584
6,0,7,13,"342 days, 23:58:34",2012-11-29 11:37:59,2010-02-01 10:32:08,2011-01-10 10:30:42,2216
12,2,3,17,"343 days, 15:49:10",2013-02-01 03:00:00,2010-02-01 10:32:08,2011-01-11 02:21:18,5796
978,9,147,1134,"343 days, 22:46:09",2013-02-06 10:59:17,2010-02-01 10:32:08,2011-01-11 09:18:17,8112
712,80,219,1011,"344 days, 1:09:19",2013-02-06 05:50:38,2010-02-01 10:32:08,2011-01-11 11:41:27,5360
78,5,122,205,"344 days, 15:22:19",2013-02-02 09:44:01,2010-02-01 10:32:08,2011-01-12 01:54:27,8441
35,289,460,784,"344 days, 20:57:21",2013-02-01 10:19:06,2010-02-01 10:32:08,2011-01-12 07:29:29,6696
788,0,25,813,"344 days, 22:19:47",2013-01-27 11:26:07,2010-02-01 10:32:08,2011-01-12 08:51:55,2534
11,29,103,143,"345 days, 0:49:33",2013-02-04 06:55:18,2010-02-01 10:32:08,2011-01-12 11:21:41,4415
259,84,30,373,"345 days, 20:49:24",2013-02-12 03:09:14,2010-06-16 07:24:51,2011-05-28 04:14:15,8751
237,0,2,239,"346 days, 18:39:07",2013-01-23 02:11:50,2010-02-01 10:32:08,2011-01-14 05:11:15,114
490,1,62,553,"346 days, 18:54:56",2013-01-27 11:07:36,2010-02-01 10:32:08,2011-01-14 05:27:04,7603
194,27,52,273,"346 days, 22:12:20",2013-02-03 08:52:29,2010-02-01 10:32:08,2011-01-14 08:44:28,1949
490,1,35,526,"346 days, 22:37:58",2013-01-30 06:00:33,2010-02-01 10:32:08,2011-01-14 09:10:06,5033
105,308,516,929,"347 days, 14:38:22",2013-02-04 10:31:40,2010-02-01 10:32:08,2011-01-15 01:10:30,1837
4,0,13,17,"347 days, 18:11:33",2012-10-10 10:15:17,2010-02-01 10:32:08,2011-01-15 04:43:41,9640
33,0,1,34,"347 days, 18:30:44",2013-01-28 07:38:42,2010-02-01 10:32:08,2011-01-15 05:02:52,4424
268,0,59,327,"347 days, 19:23:21",2013-01-29 05:54:45,2010-02-01 10:32:08,2011-01-15 05:55:29,5944
70,2,31,103,"347 days, 21:54:03",2013-01-27 05:10:28,2010-02-01 10:32:08,2011-01-15 08:26:11,681
27,18,227,272,"347 days, 21:59:36",2013-01-30 00:22:44,2010-02-01 10:32:08,2011-01-15 08:31:44,7370
20,0,30,50,"348 days, 18:34:30",2013-01-29 09:53:15,2010-02-01 10:32:08,2011-01-16 05:06:38,2429
431,9,37,477,"348 days, 19:34:40",2013-01-16 04:51:05,2010-02-01 10:32:08,2011-01-16 06:06:48,787
305,8,184,497,"348 days, 21:28:45",2013-02-06 05:31:56,2010-02-01 10:32:08,2011-01-16 08:00:53,7126
670,11,34,715,"349 days, 0:38:41",2013-02-06 03:37:50,2010-02-01 10:32:08,2011-01-16 11:10:49,8978
499,41,177,717,"349 days, 1:20:54",2013-01-29 01:27:51,2010-02-01 10:32:08,2011-01-16 11:53:02,1707
477,1,39,517,"349 days, 21:19:03",2013-02-04 03:32:45,2010-02-01 10:32:08,2011-01-17 07:51:11,3190
683,1,20,704,"350 days, 1:16:23",2013-02-03 11:15:29,2010-02-01 10:32:08,2011-01-17 11:48:31,707
109,2,77,188,"350 days, 1:17:43",2013-01-26 08:16:05,2010-02-01 10:32:08,2011-01-17 11:49:51,9133
482,4,23,509,"350 days, 14:52:34",2013-02-05 00:11:53,2010-02-01 10:32:08,2011-01-18 01:24:42,917
16,3,0,19,"350 days, 15:45:44",2012-11-04 09:36:44,2010-02-01 10:32:08,2011-01-18 02:17:52,3555
90,215,460,765,"350 days, 19:29:47",2013-02-06 05:33:59,2010-02-01 10:32:08,2011-01-18 06:01:55,4094
69,354,503,926,"351 days, 16:41:32",2013-02-05 03:53:07,2010-02-01 10:32:08,2011-01-19 03:13:40,7821
780,2,0,782,"351 days, 23:24:05",2013-01-29 08:31:56,2010-02-01 10:32:08,2011-01-19 09:56:13,7407
473,0,1,474,"351 days, 23:38:11",2013-01-24 01:03:03,2010-02-01 10:32:08,2011-01-19 10:10:19,4766
11,6,110,127,"352 days, 14:02:14",2013-02-04 09:45:48,2010-02-01 10:32:08,2011-01-20 00:34:22,7064
282,56,92,430,"352 days, 16:06:33",2013-02-07 05:48:31,2010-02-01 10:32:08,2011-01-20 02:38:41,6421
143,121,138,402,"352 days, 18:09:52",2013-02-02 09:10:14,2010-02-01 10:32:08,2011-01-20 04:42:00,2636
822,116,714,1652,"352 days, 21:48:50",2013-02-06 07:46:00,2010-02-01 10:32:08,2011-01-20 08:20:58,4715
104,127,161,392,"353 days, 0:07:51",2013-02-05 08:26:18,2010-02-01 10:32:08,2011-01-20 10:39:59,3857
210,42,153,405,"353 days, 16:02:09",2013-02-02 10:32:42,2010-02-01 10:32:08,2011-01-21 02:34:17,390
134,10,135,279,"353 days, 17:33:53",2013-02-04 10:16:54,2010-02-01 10:32:08,2011-01-21 04:06:01,553
471,2,18,491,"353 days, 19:33:56",2013-01-26 10:32:57,2010-02-01 10:32:08,2011-01-21 06:06:04,6579
630,16,12,658,"354 days, 14:56:09",2013-02-06 06:08:34,2010-02-01 10:32:08,2011-01-22 01:28:17,8573
581,103,482,1166,"354 days, 21:46:35",2013-02-06 07:22:39,2010-02-01 10:32:08,2011-01-22 08:18:43,7759
4,0,29,33,"355 days, 18:49:24",2013-01-09 05:31:39,2010-02-01 10:32:08,2011-01-23 05:21:32,6159
7,6,34,47,"355 days, 19:32:45",2013-01-31 10:38:29,2011-02-03 09:15:53,2012-01-25 04:48:38,1984
1005,0,0,1005,"355 days, 21:15:21",2013-01-30 10:50:31,2010-02-01 10:32:08,2011-01-23 07:47:29,753
468,0,31,499,"355 days, 21:30:30",2013-02-05 00:24:16,2010-02-01 10:32:08,2011-01-23 08:02:38,7215
500,16,40,556,"356 days, 15:22:02",2013-01-30 03:49:39,2010-02-01 10:32:08,2011-01-24 01:54:10,7322
156,5,70,231,"356 days, 21:01:29",2013-01-30 09:14:21,2010-02-01 10:32:08,2011-01-24 07:33:37,386
1,0,49,50,"356 days, 21:24:24",2012-11-22 03:06:28,2010-02-01 10:32:08,2011-01-24 07:56:32,816
235,99,415,749,"356 days, 23:13:38",2013-02-03 00:39:09,2010-02-01 10:32:08,2011-01-24 09:45:46,966
16,72,203,291,"356 days, 23:17:58",2013-02-04 05:47:18,2010-02-01 10:32:08,2011-01-24 09:50:06,9950
330,2,12,344,"356 days, 23:53:21",2013-01-24 05:35:25,2010-02-01 10:32:08,2011-01-24 10:25:29,4454
885,4,111,1000,"357 days, 15:21:07",2013-01-31 08:11:42,2010-02-01 10:32:08,2011-01-25 01:53:15,3419
971,0,10,981,"357 days, 15:46:52",2013-01-22 11:34:30,2010-02-01 10:32:08,2011-01-25 02:19:00,6452
7,197,523,727,"357 days, 16:25:51",2013-02-03 03:45:41,2010-02-01 10:32:08,2011-01-25 02:57:59,6040
61,118,438,617,"357 days, 16:57:28",2013-02-04 05:13:08,2010-02-01 10:32:08,2011-01-25 03:29:36,7576
378,30,236,644,"357 days, 21:52:12",2013-02-03 04:23:06,2010-02-01 10:32:08,2011-01-25 08:24:20,3441
29,6,162,197,"358 days, 15:01:19",2013-02-01 04:02:20,2010-02-01 10:32:08,2011-01-26 01:33:27,2555
338,0,21,359,"358 days, 22:58:08",2013-01-23 00:32:51,2010-02-01 10:32:08,2011-01-26 09:30:16,6228
68,0,62,130,"358 days, 23:50:56",2013-01-27 02:29:07,2010-02-01 10:32:08,2011-01-26 10:23:04,4438
314,53,233,600,"358 days, 23:53:10",2013-02-05 05:17:23,2010-02-01 10:32:08,2011-01-26 10:25:18,1899
12,0,5,17,"359 days, 0:22:42",2013-02-02 09:53:45,2010-02-01 10:32:08,2011-01-26 10:54:50,44
314,0,24,338,"359 days, 14:54:27",2013-02-03 03:09:04,2010-02-01 10:32:08,2011-01-27 01:26:35,796
20,3,16,39,"359 days, 16:13:37",2013-02-07 11:46:01,2010-02-01 10:32:08,2011-01-27 02:45:45,6956
462,0,3,465,"360 days, 14:55:52",2013-01-31 09:32:54,2010-02-01 10:32:08,2011-01-28 01:28:00,7305
377,13,129,519,"360 days, 17:42:51",2013-02-01 09:44:44,2010-02-01 10:32:08,2011-01-28 04:14:59,6207
526,42,90,658,"360 days, 19:53:29",2013-02-06 01:46:30,2010-02-01 10:32:08,2011-01-28 06:25:37,3275
7,6,152,165,"360 days, 20:30:34",2013-02-01 11:36:31,2010-02-01 10:32:08,2011-01-28 07:02:42,6628
986,5,40,1031,"360 days, 21:40:17",2013-02-04 06:49:04,2010-02-01 10:32:08,2011-01-28 08:12:25,6850
7,1,41,49,"360 days, 23:28:34",2013-02-03 07:08:08,2010-02-01 10:32:08,2011-01-28 10:00:42,2075
10,0,13,23,"361 days, 13:44:50",2013-01-17 11:41:27,2010-02-01 10:32:08,2011-01-29 00:16:58,8041
242,0,0,242,"361 days, 17:26:59",2013-01-22 05:41:13,2010-02-01 10:32:08,2011-01-29 03:59:07,4422
2,4,14,20,"361 days, 23:43:16",2013-01-30 03:54:41,2010-02-01 10:32:08,2011-01-29 10:15:24,9796
989,0,24,1013,"361 days, 23:49:03",2013-02-01 03:37:38,2010-02-01 10:32:08,2011-01-29 10:21:11,1400
331,1,98,430,"362 days, 15:31:25",2013-01-30 03:06:59,2010-02-01 10:32:08,2011-01-30 02:03:33,6573
12,1,18,31,"362 days, 18:48:45",2013-01-24 01:29:09,2010-02-01 10:32:08,2011-01-30 05:20:53,6612
258,48,104,410,"362 days, 18:48:52",2013-01-26 05:54:03,2010-02-01 10:32:08,2011-01-30 05:21:00,2077
756,0,20,776,"362 days, 22:07:46",2013-02-01 06:56:26,2010-02-01 10:32:08,2011-01-30 08:39:54,4585
5,138,31,174,"364 days, 14:41:00",2013-01-31 10:25:41,2010-02-01 10:32:08,2011-02-01 01:13:08,355
694,0,55,749,"364 days, 18:28:50",2013-01-28 11:34:43,2010-02-01 10:32:08,2011-02-01 05:00:58,5774
5,320,399,724,"364 days, 20:38:36",2013-02-03 09:46:32,2010-02-01 10:32:08,2011-02-01 07:10:44,5723
493,9,93,595,"365 days, 0:56:09",2013-01-27 11:56:38,2010-02-01 10:32:08,2011-02-01 11:28:17,3681
250,51,220,521,"365 days, 15:26:44",2013-02-05 02:47:12,2010-02-01 10:32:08,2011-02-02 01:58:52,9860
84,7,24,115,"365 days, 17:37:45",2013-01-28 07:30:13,2010-02-01 10:32:08,2011-02-02 04:09:53,4693
255,49,87,391,"365 days, 22:22:35",2013-01-30 06:05:06,2010-02-01 10:32:08,2011-02-02 08:54:43,2725
925,0,0,925,"366 days, 1:15:20",2013-01-22 08:15:57,2010-02-01 10:32:08,2011-02-02 11:47:28,4962
10,1,58,69,"366 days, 17:32:04",2013-02-04 08:42:26,2010-02-01 10:32:08,2011-02-03 04:04:12,1285
7,0,8,15,"367 days, 14:33:17",2013-02-05 07:14:44,2010-02-01 10:32:08,2011-02-04 01:05:25,9851
644,0,0,644,"367 days, 22:04:09",2013-01-26 08:14:31,2010-02-01 10:32:08,2011-02-04 08:36:17,7309
118,0,19,137,"368 days, 17:22:00",2013-01-07 11:43:10,2010-02-01 10:32:08,2011-02-05 03:54:08,6274
223,0,11,234,"368 days, 18:38:18",2013-01-07 07:17:55,2010-02-01 10:32:08,2011-02-05 05:10:26,8116
467,4,23,494,"368 days, 19:23:59",2013-01-27 10:34:45,2010-02-01 10:32:08,2011-02-05 05:56:07,6011
234,0,7,241,"369 days, 15:48:54",2013-02-05 04:33:24,2010-02-01 10:32:08,2011-02-06 02:21:02,2442
25,0,47,72,"369 days, 19:01:20",2012-12-26 05:45:54,2010-02-01 10:32:08,2011-02-06 05:33:28,9005
885,118,294,1297,"370 days, 16:28:32",2013-02-03 08:32:50,2010-02-01 10:32:08,2011-02-07 03:00:40,4902
299,0,27,326,"370 days, 18:28:13",2013-02-04 03:52:16,2010-02-01 10:32:08,2011-02-07 05:00:21,4961
63,0,25,88,"371 days, 17:05:43",2013-01-30 02:59:32,2010-02-01 10:32:08,2011-02-08 03:37:51,5092
349,1,24,374,"371 days, 19:43:12",2013-02-06 04:52:51,2010-02-01 10:32:08,2011-02-08 06:15:20,7798
455,0,0,455,"372 days, 13:52:18",2013-01-22 08:27:32,2010-02-01 10:32:08,2011-02-09 00:24:26,9874
28,144,270,442,"372 days, 15:33:18",2013-02-04 08:15:08,2010-02-01 10:32:08,2011-02-09 02:05:26,5293
481,3,74,558,"372 days, 19:50:44",2013-01-26 05:08:54,2010-02-01 10:32:08,2011-02-09 06:22:52,4538
179,106,127,412,"373 days, 0:05:33",2013-02-02 02:10:04,2010-02-01 10:32:08,2011-02-09 10:37:41,877
215,0,13,228,"373 days, 15:24:01",2013-02-02 02:34:55,2010-02-01 10:32:08,2011-02-10 01:56:09,3119
860,1,7,868,"373 days, 16:40:42",2013-01-31 03:09:41,2010-02-01 10:32:08,2011-02-10 03:12:50,8953
18,155,143,316,"373 days, 22:16:24",2013-02-03 00:55:59,2010-02-01 10:32:08,2011-02-10 08:48:32,6485
686,2,55,743,"374 days, 0:31:30",2013-01-31 07:19:31,2010-02-01 10:32:08,2011-02-10 11:03:38,8597
299,21,282,602,"374 days, 16:16:11",2013-02-06 03:59:01,2010-02-01 10:32:08,2011-02-11 02:48:19,1648
865,0,0,865,"374 days, 20:16:32",2013-01-11 00:26:53,2010-02-01 10:32:08,2011-02-11 06:48:40,535
0,3,79,82,"374 days, 22:02:34",2013-01-12 00:36:02,2010-02-01 10:32:08,2011-02-11 08:34:42,8333
609,0,12,621,"374 days, 22:31:28",2013-01-31 06:25:57,2010-02-01 10:32:08,2011-02-11 09:03:36,7243
597,4,91,692,"375 days, 1:18:17",2013-02-01 01:51:37,2010-02-01 10:32:08,2011-02-11 11:50:25,8211
17,0,7,24,"375 days, 18:03:56",2013-01-22 09:59:53,2010-02-01 10:32:08,2011-02-12 04:36:04,2751
494,5,47,546,"375 days, 19:06:52",2013-01-28 08:01:23,2010-02-01 10:32:08,2011-02-12 05:39:00,1503
564,4,44,612,"376 days, 22:39:00",2013-01-23 03:26:37,2010-06-19 10:57:24,2011-07-01 09:36:24,4934
674,1,1,676,"376 days, 22:51:31",2013-02-03 03:48:40,2010-02-01 10:32:08,2011-02-13 09:23:39,6659
85,0,22,107,"376 days, 23:56:01",2013-01-20 08:27:35,2010-02-01 10:32:08,2011-02-13 10:28:09,8223
3,130,91,224,"377 days, 1:00:20",2013-02-02 07:43:35,2010-02-01 10:32:08,2011-02-13 11:32:28,6849
213,1,34,248,"377 days, 19:36:48",2013-01-15 02:11:22,2010-02-01 10:32:08,2011-02-14 06:08:56,1973
249,3,64,316,"377 days, 20:55:59",2013-01-29 08:53:16,2010-02-01 10:32:08,2011-02-14 07:28:07,8644
602,179,125,906,"378 days, 0:42:10",2013-01-27 05:16:49,2010-02-01 10:32:08,2011-02-14 11:14:18,6546
225,1,67,293,"378 days, 0:46:15",2013-01-20 09:43:30,2010-02-01 10:32:08,2011-02-14 11:18:23,1717
160,243,478,881,"378 days, 0:48:00",2013-02-05 11:28:48,2010-02-01 10:32:08,2011-02-14 11:20:08,5676
193,0,48,241,"378 days, 17:43:49",2013-01-29 11:42:40,2010-02-01 10:32:08,2011-02-15 04:15:57,159
18,0,33,51,"378 days, 20:23:55",2013-01-03 08:10:12,2010-02-01 10:32:08,2011-02-15 06:56:03,4103
426,2,23,451,"378 days, 21:55:27",2013-01-28 03:28:56,2010-02-01 10:32:08,2011-02-15 08:27:35,6420
158,1,10,169,"379 days, 0:19:25",2013-01-27 04:12:25,2010-08-26 06:16:27,2011-09-09 06:35:52,1097
0,2,140,142,"379 days, 1:01:52",2013-02-07 05:42:56,2010-02-01 10:32:08,2011-02-15 11:34:00,6832
0,1,6,7,"379 days, 14:52:43",2013-01-24 10:45:50,2011-01-21 11:07:50,2012-02-05 02:00:33,2663
150,9,19,178,"380 days, 0:47:58",2013-02-03 04:54:08,2010-02-01 10:32:08,2011-02-16 11:20:06,6035
714,0,4,718,"380 days, 14:58:45",2013-01-07 09:09:36,2010-02-01 10:32:08,2011-02-17 01:30:53,5083
12,128,147,287,"380 days, 17:17:57",2013-02-03 03:53:25,2010-02-01 10:32:08,2011-02-17 03:50:05,6727
194,126,378,698,"380 days, 21:37:20",2013-01-31 07:38:29,2010-02-01 10:32:08,2011-02-17 08:09:28,7823
503,5,106,614,"381 days, 0:01:07",2013-02-04 01:48:01,2010-02-01 10:32:08,2011-02-17 10:33:15,1829
884,36,35,955,"381 days, 20:43:31",2013-01-29 08:55:04,2010-02-01 10:32:08,2011-02-18 07:15:39,4834
684,4,38,726,"381 days, 21:19:25",2013-02-07 03:04:36,2010-02-01 10:32:08,2011-02-18 07:51:33,4108
493,20,200,713,"381 days, 22:06:52",2013-01-31 07:32:03,2010-02-01 10:32:08,2011-02-18 08:39:00,992
306,109,157,572,"381 days, 23:29:08",2013-02-04 10:42:12,2010-02-01 10:32:08,2011-02-18 10:01:16,5148
10,0,0,10,"382 days, 13:07:17",2012-08-12 10:11:30,2011-05-15 11:29:31,2012-06-01 00:36:48,5829
514,3,29,546,"382 days, 23:01:43",2013-02-03 05:46:53,2010-02-01 10:32:08,2011-02-19 09:33:51,1932
29,116,260,405,"383 days, 0:19:54",2013-02-06 04:43:41,2010-02-01 10:32:08,2011-02-19 10:52:02,3814
847,0,0,847,"383 days, 14:05:07",2013-01-30 08:58:57,2010-02-01 10:32:08,2011-02-20 00:37:15,4667
1,1,10,12,"383 days, 16:15:05",2013-01-08 02:17:22,2010-02-01 10:32:08,2011-02-20 02:47:13,5867
77,1,38,116,"383 days, 20:36:24",2013-01-15 09:42:48,2010-02-01 10:32:08,2011-02-20 07:08:32,9985
26,4,15,45,"384 days, 0:02:11",2013-01-20 02:36:02,2011-01-13 08:28:04,2012-02-01 08:30:15,1247
74,3,76,153,"384 days, 0:36:17",2013-01-28 10:52:29,2010-02-01 10:32:08,2011-02-20 11:08:25,2074
177,259,419,855,"384 days, 15:46:12",2013-02-03 02:30:03,2010-02-01 10:32:08,2011-02-21 02:18:20,7885
875,0,19,894,"384 days, 23:21:36",2013-01-30 09:18:54,2010-02-01 10:32:08,2011-02-21 09:53:44,7490
157,185,353,695,"385 days, 20:19:30",2013-02-06 04:33:58,2010-02-01 10:32:08,2011-02-22 06:51:38,7910
853,1,100,954,"385 days, 22:44:03",2013-01-25 02:09:29,2010-02-01 10:32:08,2011-02-22 09:16:11,7464
18,94,317,429,"386 days, 15:13:52",2013-02-02 01:38:32,2010-02-01 10:32:08,2011-02-23 01:46:00,4025
215,1,0,216,"386 days, 15:32:56",2013-01-29 04:14:58,2010-02-01 10:32:08,2011-02-23 02:05:04,8097
224,0,15,239,"386 days, 18:22:03",2012-12-30 06:55:45,2010-02-01 10:32:08,2011-02-23 04:54:11,7948
315,3,164,482,"386 days, 18:36:25",2013-02-08 09:56:34,2010-02-01 10:32:08,2011-02-23 05:08:33,1361
861,33,155,1049,"387 days, 0:56:47",2013-02-01 05:48:19,2010-02-01 10:32:08,2011-02-23 11:28:55,6886
368,162,449,979,"387 days, 19:39:08",2013-02-05 10:08:24,2010-02-01 10:32:08,2011-02-24 06:11:16,4839
452,1,25,478,"388 days, 15:24:06",2013-01-31 06:02:04,2010-02-01 10:32:08,2011-02-25 01:56:14,5331
39,1,37,77,"388 days, 15:46:21",2013-01-26 02:35:55,2010-02-01 10:32:08,2011-02-25 02:18:29,4252
35,122,183,340,"388 days, 22:27:14",2013-02-05 06:30:06,2010-02-01 10:32:08,2011-02-25 08:59:22,2130
33,3,36,72,"388 days, 22:42:55",2013-02-05 08:23:29,2010-02-01 10:32:08,2011-02-25 09:15:03,2204
0,3,68,71,"388 days, 23:56:53",2013-01-18 11:42:51,2010-02-01 10:32:08,2011-02-25 10:29:01,5689
1,65,135,201,"389 days, 17:00:50",2013-01-29 09:43:51,2010-02-01 10:32:08,2011-02-26 03:32:58,5935
280,1,25,306,"390 days, 0:38:37",2013-01-31 11:35:52,2010-02-01 10:32:08,2011-02-26 11:10:45,1066
267,6,143,416,"390 days, 16:23:15",2013-02-01 07:01:42,2010-02-01 10:32:08,2011-02-27 02:55:23,3967
5,0,6,11,"390 days, 19:11:49",2013-01-16 06:32:06,2010-02-01 10:32:08,2011-02-27 05:43:57,1434
54,8,173,235,"390 days, 19:15:59",2013-02-01 09:45:05,2010-02-01 10:32:08,2011-02-27 05:48:07,9803
391,1,22,414,"391 days, 15:23:14",2013-01-25 09:31:44,2010-02-01 10:32:08,2011-02-28 01:55:22,2889
200,11,186,397,"391 days, 18:17:34",2013-01-29 01:02:44,2010-02-01 10:32:08,2011-02-28 04:49:42,8818
39,94,165,298,"391 days, 21:13:05",2013-02-02 05:49:54,2010-02-01 10:32:08,2011-02-28 07:45:13,2757
211,1,0,212,"392 days, 1:22:45",2013-01-06 07:44:16,2010-02-01 10:32:08,2011-02-28 11:54:53,4379
764,130,200,1094,"392 days, 13:50:09",2013-02-01 03:47:26,2010-02-01 10:32:08,2011-03-01 00:22:17,7699
468,1,102,571,"392 days, 16:59:56",2013-01-19 07:45:40,2010-02-01 10:32:08,2011-03-01 03:32:04,3949
1043,1,10,1054,"392 days, 18:53:31",2013-02-03 03:52:16,2010-02-01 10:32:08,2011-03-01 05:25:39,2124
633,114,147,894,"393 days, 0:08:31",2013-01-29 07:05:32,2010-02-01 10:32:08,2011-03-01 10:40:39,2597
919,0,0,919,"393 days, 1:04:46",2013-01-29 07:48:29,2010-02-01 10:32:08,2011-03-01 11:36:54,2391
805,2,16,823,"393 days, 21:28:47",2013-01-29 05:41:47,2010-02-01 10:32:08,2011-03-02 08:00:55,285
7,1,12,20,"393 days, 22:09:22",2013-01-31 10:23:52,2010-07-09 04:49:58,2011-08-07 02:59:20,314
629,0,3,632,"393 days, 22:14:55",2013-01-18 06:11:39,2010-02-01 10:32:08,2011-03-02 08:47:03,5047
490,1,20,511,"394 days, 1:24:31",2013-01-31 02:39:23,2010-02-01 10:32:08,2011-03-02 11:56:39,3031
4,0,45,49,"394 days, 21:32:54",2013-01-24 00:40:40,2010-02-01 10:32:08,2011-03-03 08:05:02,2795
373,21,187,581,"394 days, 23:28:23",2013-02-04 02:21:32,2010-02-01 10:32:08,2011-03-03 10:00:31,2762
486,0,0,486,"395 days, 13:27:58",2013-01-18 09:10:44,2010-02-01 10:32:08,2011-03-04 00:00:06,7363
374,1,12,387,"395 days, 16:53:58",2013-02-01 06:43:22,2010-02-01 10:32:08,2011-03-04 03:26:06,7964
737,155,245,1137,"395 days, 17:56:59",2013-01-31 07:40:23,2010-02-01 10:32:08,2011-03-04 04:29:07,8769
10,0,13,23,"395 days, 19:02:58",2013-01-28 10:04:23,2010-02-01 10:32:08,2011-03-04 05:35:06,527
840,4,80,924,"395 days, 19:58:39",2013-02-01 07:43:29,2010-02-01 10:32:08,2011-03-04 06:30:47,7637
96,1,32,129,"396 days, 17:17:56",2012-12-10 07:04:27,2010-02-01 10:32:08,2011-03-05 03:50:04,4992
3,1,54,58,"396 days, 17:40:38",2013-01-28 05:37:16,2010-02-01 10:32:08,2011-03-05 04:12:46,8581
193,0,4,197,"397 days, 0:41:34",2013-01-31 03:52:00,2010-02-01 10:32:08,2011-03-05 11:13:42,9607
863,105,191,1159,"397 days, 15:51:58",2013-02-04 10:23:26,2010-02-01 10:32:08,2011-03-06 02:24:06,9762
24,0,89,113,"397 days, 20:22:20",2013-02-04 00:18:34,2010-02-01 10:32:08,2011-03-06 06:54:28,6451
218,136,139,493,"397 days, 20:49:12",2013-02-05 02:26:09,2010-02-01 10:32:08,2011-03-06 07:21:20,8381
821,17,29,867,"397 days, 21:46:36",2013-02-01 08:13:38,2010-02-01 10:32:08,2011-03-06 08:18:44,5353
182,4,0,186,"398 days, 0:21:15",2013-01-29 10:23:34,2010-02-01 10:32:08,2011-03-06 10:53:23,1507
807,0,26,833,"398 days, 14:02:13",2013-01-29 10:06:43,2010-02-01 10:32:08,2011-03-07 00:34:21,1315
15,0,6,21,"398 days, 14:03:24",2013-01-20 08:43:41,2010-02-01 10:32:08,2011-03-07 00:35:32,4242
261,62,150,473,"398 days, 16:49:04",2013-01-31 11:50:52,2010-02-01 10:32:08,2011-03-07 03:21:12,5802
937,0,1,938,"398 days, 18:48:27",2013-01-26 10:55:47,2010-02-01 10:32:08,2011-03-07 05:20:35,949
7,0,0,7,"398 days, 19:52:09",2012-04-14 06:30:00,2010-02-01 10:32:08,2011-03-07 06:24:17,1084
22,120,200,342,"398 days, 21:21:18",2013-02-07 00:31:16,2010-02-01 10:32:08,2011-03-07 07:53:26,3049
2,6,58,66,"398 days, 22:24:47",2013-01-31 06:30:56,2010-02-01 10:32:08,2011-03-07 08:56:55,3729
259,2,33,294,"399 days, 15:06:01",2013-02-03 09:49:48,2010-02-01 10:32:08,2011-03-08 01:38:09,3449
236,44,255,535,"399 days, 18:18:18",2013-02-02 04:33:33,2010-02-01 10:32:08,2011-03-08 04:50:26,2365
186,2,172,360,"399 days, 22:51:51",2013-01-25 10:10:28,2010-02-01 10:32:08,2011-03-08 09:23:59,2061
9,0,0,9,"400 days, 1:05:44",2012-09-21 06:25:27,2011-03-09 00:51:42,2012-04-12 01:57:26,3932
599,3,11,613,"400 days, 17:43:58",2013-01-14 00:40:07,2010-02-01 10:32:08,2011-03-09 04:16:06,7666
589,1,2,592,"400 days, 22:04:04",2013-01-30 01:40:38,2010-02-01 10:32:08,2011-03-09 08:36:12,7141
10,1,8,19,"401 days, 18:59:37",2013-01-21 00:59:23,2010-02-01 10:32:08,2011-03-10 05:31:45,8600
6,0,0,6,"401 days, 21:21:06",2012-12-07 09:31:41,2010-08-27 06:29:06,2011-10-03 03:50:12,9348
143,0,26,169,"401 days, 22:44:36",2013-01-28 00:53:08,2010-02-01 10:32:08,2011-03-10 09:16:44,7724
655,1,0,656,"402 days, 17:42:13",2013-01-31 10:35:26,2010-02-01 10:32:08,2011-03-11 04:14:21,2144
880,1,5,886,"402 days, 17:46:24",2013-01-28 03:02:35,2010-02-01 10:32:08,2011-03-11 04:18:32,9547
949,40,175,1164,"402 days, 19:26:23",2013-02-03 05:32:20,2010-02-01 10:32:08,2011-03-11 05:58:31,4407
662,0,7,669,"403 days, 0:11:42",2013-01-08 05:31:18,2010-02-01 10:32:08,2011-03-11 10:43:50,9810
259,1,0,260,"403 days, 13:43:20",2013-01-22 02:59:18,2010-02-01 10:32:08,2011-03-12 00:15:28,7649
28,131,407,566,"403 days, 16:03:22",2013-02-04 01:01:41,2010-02-01 10:32:08,2011-03-12 02:35:30,6576
265,7,271,543,"403 days, 16:48:11",2013-02-03 00:45:23,2010-02-01 10:32:08,2011-03-12 03:20:19,4010
11,4,80,95,"403 days, 16:56:38",2013-01-23 04:51:04,2010-02-01 10:32:08,2011-03-12 03:28:46,3637
873,0,5,878,"403 days, 17:05:02",2013-01-31 08:18:32,2010-02-01 10:32:08,2011-03-12 03:37:10,5657
18,0,41,59,"403 days, 22:53:07",2013-01-24 06:04:08,2010-02-01 10:32:08,2011-03-12 09:25:15,9425
198,0,25,223,"404 days, 17:10:22",2013-02-10 10:43:52,2010-02-01 10:32:08,2011-03-13 03:42:30,9486
1001,5,12,1018,"404 days, 17:18:15",2013-02-05 08:29:06,2010-02-01 10:32:08,2011-03-13 03:50:23,497
24,28,40,92,"404 days, 18:16:15",2013-02-03 11:01:24,2010-10-25 10:40:26,2011-12-04 04:56:41,2521
1,86,76,163,"404 days, 19:00:19",2013-02-01 06:24:51,2010-02-01 10:32:08,2011-03-13 05:32:27,5346
463,0,18,481,"404 days, 21:21:18",2013-01-28 10:14:42,2010-02-01 10:32:08,2011-03-13 07:53:26,8321
468,14,116,598,"405 days, 1:04:54",2013-01-31 05:53:58,2010-02-01 10:32:08,2011-03-13 11:37:02,9641
232,0,0,232,"405 days, 15:49:30",2013-01-10 00:25:00,2010-02-01 10:32:08,2011-03-14 02:21:38,3574
227,2,0,229,"405 days, 16:10:52",2013-01-14 11:35:41,2010-02-01 10:32:08,2011-03-14 02:43:00,7447
113,131,330,574,"405 days, 22:51:20",2013-02-03 04:58:12,2010-02-01 10:32:08,2011-03-14 09:23:28,6111
797,31,127,955,"406 days, 0:54:35",2013-02-06 00:40:48,2010-02-01 10:32:08,2011-03-14 11:26:43,2005
394,0,0,394,"406 days, 16:57:20",2012-12-26 10:21:58,2010-02-01 10:32:08,2011-03-15 03:29:28,9642
210,1,25,236,"406 days, 18:40:24",2013-01-07 06:55:48,2010-02-01 10:32:08,2011-03-15 05:12:32,6866
1,1,34,36,"407 days, 14:54:10",2013-01-19 10:46:52,2010-02-01 10:32:08,2011-03-16 01:26:18,2586
449,9,110,568,"407 days, 15:34:22",2013-02-05 04:06:25,2010-02-01 10:32:08,2011-03-16 02:06:30,3723
238,1,7,246,"407 days, 23:35:14",2013-01-31 08:49:00,2010-02-01 10:32:08,2011-03-16 10:07:22,8386
714,1,38,753,"408 days, 0:29:04",2013-01-21 05:51:20,2010-02-01 10:32:08,2011-03-16 11:01:12,6535
18,2,52,72,"408 days, 14:37:27",2013-01-24 11:28:53,2010-02-01 10:32:08,2011-03-17 01:09:35,2159
9,1,29,39,"408 days, 16:43:39",2013-01-23 07:55:57,2010-02-01 10:32:08,2011-03-17 03:15:47,4977
426,1,42,469,"408 days, 18:00:32",2013-01-27 02:05:54,2010-02-01 10:32:08,2011-03-17 04:32:40,6630
427,2,36,465,"409 days, 18:25:36",2013-02-03 04:44:12,2010-02-01 10:32:08,2011-03-18 04:57:44,881
253,27,7,287,"409 days, 20:41:10",2013-02-04 09:54:24,2010-02-01 10:32:08,2011-03-18 07:13:18,363
822,0,0,822,"409 days, 22:43:14",2013-01-26 02:14:42,2010-02-01 10:32:08,2011-03-18 09:15:22,7439
430,91,242,763,"409 days, 23:36:28",2013-02-02 09:35:22,2010-02-01 10:32:08,2011-03-18 10:08:36,2955
790,5,15,810,"410 days, 16:07:31",2013-02-02 07:51:39,2010-02-01 10:32:08,2011-03-19 02:39:39,2176
189,7,113,309,"410 days, 23:01:55",2013-02-03 04:15:13,2010-02-01 10:32:08,2011-03-19 09:34:03,6883
852,0,0,852,"411 days, 0:34:03",2013-01-31 01:55:19,2010-02-01 10:32:08,2011-03-19 11:06:11,4727
255,4,103,362,"411 days, 16:53:18",2013-01-25 02:53:15,2010-02-01 10:32:08,2011-03-20 03:25:26,4995
215,6,67,288,"411 days, 18:18:01",2013-02-04 00:21:04,2010-02-01 10:32:08,2011-03-20 04:50:09,8274
865,9,65,939,"411 days, 18:32:41",2013-01-30 07:53:39,2010-02-01 10:32:08,2011-03-20 05:04:49,8472
740,20,80,840,"412 days, 21:06:38",2013-01-28 11:06:09,2010-02-01 10:32:08,2011-03-21 07:38:46,8766
246,23,78,347,"413 days, 0:02:15",2013-02-09 01:02:27,2010-02-01 10:32:08,2011-03-21 10:34:23,8783
404,0,4,408,"413 days, 0:21:33",2013-01-28 02:50:47,2010-02-01 10:32:08,2011-03-21 10:53:41,9186
925,0,45,970,"414 days, 15:07:56",2013-02-04 08:30:59,2010-02-01 10:32:08,2011-03-23 01:40:04,7220
187,0,19,206,"414 days, 17:19:15",2013-01-12 02:34:33,2010-02-01 10:32:08,2011-03-23 03:51:23,8900
338,12,223,573,"414 days, 18:01:18",2013-01-30 03:47:06,2010-02-01 10:32:08,2011-03-23 04:33:26,6663
4,0,2,6,"414 days, 20:36:36",2012-12-22 09:44:29,2010-02-01 10:32:08,2011-03-23 07:08:44,1558
372,1,49,422,"415 days, 18:32:51",2013-01-27 10:48:26,2010-02-01 10:32:08,2011-03-24 05:04:59,4878
208,58,222,488,"415 days, 22:28:08",2013-02-02 00:56:13,2010-02-01 10:32:08,2011-03-24 09:00:16,4914
651,1,65,717,"416 days, 20:00:50",2013-01-29 07:24:20,2010-02-01 10:32:08,2011-03-25 06:32:58,1208
585,9,12,606,"416 days, 22:20:01",2013-02-04 07:12:44,2010-02-01 10:32:08,2011-03-25 08:52:09,9741
646,2,48,696,"417 days, 16:37:21",2013-01-22 00:03:02,2010-02-01 10:32:08,2011-03-26 03:09:29,5201
647,20,70,737,"417 days, 17:29:47",2013-02-03 07:15:19,2010-02-01 10:32:08,2011-03-26 04:01:55,8324
624,0,16,640,"417 days, 21:41:55",2013-01-22 09:47:47,2010-02-01 10:32:08,2011-03-26 08:14:03,9466
157,157,337,651,"418 days, 22:44:22",2013-02-04 04:18:06,2010-02-01 10:32:08,2011-03-27 09:16:30,1291
435,1,22,458,"419 days, 14:01:07",2013-02-02 09:58:27,2010-02-01 10:32:08,2011-03-28 00:33:15,130
161,38,182,381,"419 days, 16:22:14",2013-02-01 03:24:51,2010-02-01 10:32:08,2011-03-28 02:54:22,8913
982,3,48,1033,"419 days, 18:21:25",2013-01-30 06:05:00,2010-02-01 10:32:08,2011-03-28 04:53:33,5862
141,9,38,188,"419 days, 21:50:25",2013-02-04 01:52:31,2010-02-01 10:32:08,2011-03-28 08:22:33,8960
486,0,2,488,"419 days, 23:26:04",2013-01-19 06:39:59,2010-02-01 10:32:08,2011-03-28 09:58:12,9298
860,12,31,903,"419 days, 23:53:38",2013-02-05 08:26:02,2010-02-01 10:32:08,2011-03-28 10:25:46,7688
75,2,0,77,"420 days, 17:04:45",2013-01-10 00:26:23,2010-02-01 10:32:08,2011-03-29 03:36:53,2002
0,0,38,38,"420 days, 19:27:37",2013-01-16 01:57:08,2010-02-01 10:32:08,2011-03-29 05:59:45,2639
408,0,25,433,"421 days, 16:37:39",2013-01-29 02:18:49,2010-02-01 10:32:08,2011-03-30 03:09:47,2572
247,24,14,285,"421 days, 20:48:51",2013-02-05 00:41:15,2010-02-01 10:32:08,2011-03-30 07:20:59,2764
2,91,126,219,"422 days, 16:46:35",2013-02-03 10:16:00,2010-02-01 10:32:08,2011-03-31 03:18:43,8629
778,0,0,778,"422 days, 16:48:25",2013-01-27 01:06:46,2010-02-01 10:32:08,2011-03-31 03:20:33,4780
498,12,178,688,"422 days, 21:51:07",2013-02-07 06:41:26,2010-02-01 10:32:08,2011-03-31 08:23:15,8588
241,0,0,241,"423 days, 14:10:17",2012-12-29 11:29:50,2010-02-01 10:32:08,2011-04-01 00:42:25,7731
9,1,6,16,"423 days, 18:05:13",2013-02-04 03:23:24,2010-02-01 10:32:08,2011-04-01 04:37:21,3331
35,12,102,149,"423 days, 18:24:47",2013-02-02 02:04:49,2010-02-01 10:32:08,2011-04-01 04:56:55,5170
218,0,43,261,"423 days, 20:16:00",2013-02-02 11:40:23,2010-02-01 10:32:08,2011-04-01 06:48:08,4385
512,76,143,731,"423 days, 21:13:40",2013-02-01 04:57:46,2010-02-01 10:32:08,2011-04-01 07:45:48,9141
205,0,15,220,"423 days, 21:59:00",2013-01-24 06:19:30,2010-02-01 10:32:08,2011-04-01 08:31:08,7398
171,3,44,218,"424 days, 14:27:14",2013-01-30 06:34:09,2010-02-01 10:32:08,2011-04-02 00:59:22,6261
391,0,9,400,"424 days, 15:29:47",2013-01-10 05:06:54,2010-02-01 10:32:08,2011-04-02 02:01:55,749
10,0,49,59,"424 days, 18:52:27",2013-01-19 10:41:42,2010-02-01 10:32:08,2011-04-02 05:24:35,2113
565,41,63,669,"424 days, 22:58:19",2013-02-06 01:48:55,2010-02-01 10:32:08,2011-04-02 09:30:27,3783
45,155,355,555,"425 days, 0:24:28",2013-02-06 00:48:00,2010-02-01 10:32:08,2011-04-02 10:56:36,213
481,1,4,486,"425 days, 13:48:19",2013-01-29 11:45:54,2010-02-01 10:32:08,2011-04-03 00:20:27,2056
934,3,4,941,"425 days, 14:18:49",2013-02-03 11:34:18,2010-02-01 10:32:08,2011-04-03 00:50:57,248
133,5,29,167,"425 days, 18:03:55",2013-02-03 08:41:59,2010-02-01 10:32:08,2011-04-03 04:36:03,6614
486,0,49,535,"425 days, 23:30:08",2013-01-30 05:09:09,2010-02-01 10:32:08,2011-04-03 10:02:16,990
921,0,7,928,"425 days, 23:59:10",2013-02-03 00:41:59,2010-02-01 10:32:08,2011-04-03 10:31:18,8661
5,8,17,30,"426 days, 14:05:23",2013-02-06 11:38:53,2010-02-01 10:32:08,2011-04-04 00:37:31,8923
6,0,0,6,"426 days, 17:36:33",2013-01-14 10:49:07,2010-05-18 09:30:20,2011-07-19 03:06:53,9497
34,6,40,80,"426 days, 18:57:58",2013-02-01 04:28:09,2010-02-01 10:32:08,2011-04-04 05:30:06,1439
39,2,35,76,"426 days, 21:17:11",2013-01-31 07:13:27,2010-02-01 10:32:08,2011-04-04 07:49:19,1934
903,2,87,992,"427 days, 14:47:44",2013-01-26 08:56:34,2010-02-01 10:32:08,2011-04-05 01:19:52,67
0,1,14,15,"427 days, 21:09:26",2012-11-21 10:35:29,2010-02-01 10:32:08,2011-04-05 07:41:34,9616
380,2,9,391,"428 days, 18:05:21",2013-01-30 08:41:57,2010-02-01 10:32:08,2011-04-06 04:37:29,8171
489,9,141,639,"428 days, 19:10:31",2013-01-30 11:56:33,2010-02-01 10:32:08,2011-04-06 05:42:39,4191
505,1,3,509,"428 days, 21:26:17",2013-01-23 09:06:45,2010-02-01 10:32:08,2011-04-06 07:58:25,1749
319,3,36,358,"428 days, 22:25:25",2013-02-03 10:37:07,2010-09-08 11:10:35,2011-11-11 09:36:00,7444
271,3,21,295,"428 days, 22:50:01",2013-01-30 04:20:33,2010-09-27 09:00:52,2011-11-30 07:50:53,9898
620,1,0,621,"429 days, 15:53:03",2013-01-04 07:50:06,2010-02-01 10:32:08,2011-04-07 02:25:11,9272
605,0,15,620,"429 days, 16:58:52",2013-01-31 05:23:31,2010-02-01 10:32:08,2011-04-07 03:31:00,818
169,19,45,233,"429 days, 17:19:15",2013-02-07 00:56:38,2010-02-01 10:32:08,2011-04-07 03:51:23,3060
205,2,25,232,"430 days, 15:52:40",2013-02-04 04:26:33,2010-02-01 10:32:08,2011-04-08 02:24:48,9017
466,8,128,602,"430 days, 21:06:36",2013-02-02 11:28:43,2010-02-01 10:32:08,2011-04-08 07:38:44,85
799,0,23,822,"430 days, 23:34:13",2013-01-31 04:36:38,2010-02-01 10:32:08,2011-04-08 10:06:21,690
681,0,11,692,"430 days, 23:48:41",2013-01-28 07:27:22,2010-02-01 10:32:08,2011-04-08 10:20:49,5960
47,71,102,220,"431 days, 14:41:41",2013-01-31 02:17:46,2010-02-01 10:32:08,2011-04-09 01:13:49,8073
258,6,1,265,"431 days, 21:07:30",2013-01-31 00:11:08,2010-02-01 10:32:08,2011-04-09 07:39:38,3559
184,4,41,229,"431 days, 23:23:59",2013-01-28 07:39:59,2010-02-01 10:32:08,2011-04-09 09:56:07,2920
375,0,3,378,"431 days, 23:41:30",2013-01-31 03:43:18,2010-02-01 10:32:08,2011-04-09 10:13:38,8859
140,28,123,291,"432 days, 17:47:51",2013-01-28 03:53:28,2010-02-01 10:32:08,2011-04-10 04:19:59,5956
193,1,11,205,"432 days, 21:52:27",2013-02-03 07:07:04,2010-02-01 10:32:08,2011-04-10 08:24:35,2873
430,2,20,452,"432 days, 22:57:07",2013-02-03 07:07:44,2010-02-01 10:32:08,2011-04-10 09:29:15,1730
845,0,0,845,"433 days, 0:48:56",2013-01-29 03:32:10,2010-02-01 10:32:08,2011-04-10 11:21:04,1002
64,5,71,140,"433 days, 23:45:46",2013-01-30 10:28:46,2010-09-10 05:58:52,2011-11-18 05:44:38,9760
19,0,16,35,"434 days, 0:33:02",2013-01-20 02:04:20,2010-02-01 10:32:08,2011-04-11 11:05:10,8289
411,0,17,428,"434 days, 14:29:46",2013-01-30 03:05:51,2010-02-01 10:32:08,2011-04-12 01:01:54,3673
13,7,52,72,"435 days, 20:15:57",2013-01-23 06:14:46,2010-02-01 10:32:08,2011-04-13 06:48:05,1607
4,0,0,4,"435 days, 21:19:31",2013-01-10 04:09:48,2011-04-03 05:07:04,2012-06-12 02:26:35,9807
17,2,66,85,"436 days, 13:45:29",2013-01-31 06:21:11,2010-02-01 10:32:08,2011-04-14 00:17:37,2714
177,33,11,221,"436 days, 17:18:51",2013-02-03 04:41:43,2010-02-01 10:32:08,2011-04-14 03:50:59,5536
195,23,57,275,"436 days, 19:44:38",2013-01-31 00:56:41,2010-02-01 10:32:08,2011-04-14 06:16:46,1215
504,2,38,544,"436 days, 20:35:00",2013-01-29 03:41:39,2010-02-01 10:32:08,2011-04-14 07:07:08,5402
14,0,20,34,"436 days, 21:09:43",2013-02-05 08:19:01,2010-02-01 10:32:08,2011-04-14 07:41:51,9990
657,214,103,974,"438 days, 17:32:52",2013-02-04 06:00:41,2010-02-01 10:32:08,2011-04-16 04:05:00,9184
11,0,11,22,"438 days, 19:26:39",2012-12-22 09:14:50,2010-02-01 10:32:08,2011-04-16 05:58:47,602
15,7,77,99,"438 days, 22:42:03",2013-02-05 03:54:28,2010-02-01 10:32:08,2011-04-16 09:14:11,9712
174,1,84,259,"439 days, 13:28:29",2013-02-05 09:21:10,2010-02-01 10:32:08,2011-04-17 00:00:37,837
183,1,4,188,"439 days, 14:07:04",2012-12-21 10:07:51,2010-02-01 10:32:08,2011-04-17 00:39:12,3671
261,0,5,266,"439 days, 17:39:07",2013-02-03 08:53:32,2010-02-01 10:32:08,2011-04-17 04:11:15,9729
22,2,63,87,"439 days, 18:37:44",2013-02-05 01:17:05,2010-02-01 10:32:08,2011-04-17 05:09:52,9011
147,63,112,322,"439 days, 19:35:42",2013-02-02 06:08:55,2010-02-01 10:32:08,2011-04-17 06:07:50,5964
36,232,303,571,"439 days, 22:14:27",2013-02-04 11:32:24,2010-02-01 10:32:08,2011-04-17 08:46:35,3609
587,15,53,655,"440 days, 3:52:15",2013-02-05 10:59:19,2010-03-31 04:17:55,2011-06-14 08:10:10,5506
441,0,10,451,"441 days, 0:29:05",2013-01-22 08:36:54,2010-02-01 10:32:08,2011-04-18 11:01:13,4674
137,0,35,172,"441 days, 16:08:28",2013-02-03 09:36:33,2010-02-01 10:32:08,2011-04-19 02:40:36,8065
200,0,0,200,"441 days, 20:33:29",2013-01-27 10:04:17,2010-02-01 10:32:08,2011-04-19 07:05:37,5281
208,0,0,208,"441 days, 22:19:51",2013-01-31 07:50:59,2010-02-01 10:32:08,2011-04-19 08:51:59,2694
13,1,0,14,"442 days, 18:21:12",2013-01-20 00:04:12,2010-05-03 11:24:20,2011-07-20 05:45:32,9273
455,109,225,789,"442 days, 23:24:49",2013-01-30 05:51:35,2010-02-01 10:32:08,2011-04-20 09:56:57,6276
462,2,70,534,"443 days, 0:29:08",2013-01-30 08:14:34,2010-02-01 10:32:08,2011-04-20 11:01:16,4861
515,42,202,759,"443 days, 0:42:44",2013-02-03 06:25:02,2010-02-01 10:32:08,2011-04-20 11:14:52,2248
792,0,0,792,"443 days, 13:30:48",2013-01-29 03:57:47,2010-02-01 10:32:08,2011-04-21 00:02:56,5942
24,4,49,77,"443 days, 16:44:47",2013-01-27 09:09:02,2010-02-01 10:32:08,2011-04-21 03:16:55,605
429,0,16,445,"443 days, 19:40:32",2013-01-24 08:39:01,2010-02-01 10:32:08,2011-04-21 06:12:40,2509
649,4,42,695,"444 days, 14:15:51",2013-01-31 06:21:38,2010-02-01 10:32:08,2011-04-22 00:47:59,638
0,0,8,8,"444 days, 18:20:35",2012-12-07 06:54:05,2010-02-01 10:32:08,2011-04-22 04:52:43,6495
150,1,32,183,"445 days, 0:29:18",2013-02-01 07:29:15,2010-02-01 10:32:08,2011-04-22 11:01:26,5884
21,0,179,200,"445 days, 14:06:33",2013-01-28 06:16:38,2010-02-01 10:32:08,2011-04-23 00:38:41,6388
381,0,7,388,"445 days, 15:07:22",2013-01-28 11:29:57,2010-02-01 10:32:08,2011-04-23 01:39:30,1419
49,72,152,273,"445 days, 18:15:29",2013-02-01 09:18:11,2010-02-01 10:32:08,2011-04-23 04:47:37,9439
196,0,11,207,"445 days, 21:39:48",2013-01-30 00:18:50,2010-02-01 10:32:08,2011-04-23 08:11:56,2171
537,1,26,564,"445 days, 23:05:50",2013-01-31 10:15:57,2010-02-01 10:32:08,2011-04-23 09:37:58,4535
28,6,102,136,"446 days, 15:50:48",2013-02-04 09:05:00,2010-02-01 10:32:08,2011-04-24 02:22:56,6755
1,1,44,46,"447 days, 15:52:10",2013-02-01 04:29:14,2010-02-01 10:32:08,2011-04-25 02:24:18,853
16,0,17,33,"449 days, 15:56:56",2013-01-04 10:34:22,2010-02-01 10:32:08,2011-04-27 02:29:04,3690
931,0,2,933,"449 days, 19:07:33",2013-02-02 01:42:10,2010-02-01 10:32:08,2011-04-27 05:39:41,3065
11,61,181,253,"449 days, 23:45:16",2013-02-02 05:06:22,2010-02-01 10:32:08,2011-04-27 10:17:24,2462
306,23,24,353,"449 days, 23:59:26",2013-02-01 07:44:18,2010-03-21 06:35:53,2011-06-14 06:35:19,6982
236,0,10,246,"450 days, 14:23:51",2013-01-15 04:35:48,2010-02-01 10:32:08,2011-04-28 00:55:59,3838
0,1,19,20,"450 days, 18:24:09",2013-01-27 09:57:13,2010-02-01 10:32:08,2011-04-28 04:56:17,4240
631,60,171,862,"450 days, 19:28:16",2013-02-03 06:08:40,2010-02-01 10:32:08,2011-04-28 06:00:24,3046
752,19,17,788,"450 days, 20:32:50",2013-02-06 09:39:04,2010-02-01 10:32:08,2011-04-28 07:04:58,4520
4,17,107,128,"451 days, 1:25:53",2013-02-02 02:31:30,2010-02-01 10:32:08,2011-04-28 11:58:01,9122
322,1,0,323,"451 days, 18:30:16",2013-01-10 01:19:14,2010-06-01 05:30:59,2011-08-27 00:01:15,6380
110,7,5,122,"451 days, 21:19:26",2013-01-29 01:53:50,2011-03-11 09:38:53,2012-06-05 06:58:19,4279
671,2,44,717,"452 days, 17:04:38",2013-01-16 05:36:32,2010-02-01 10:32:08,2011-04-30 03:36:46,6412
857,1,1,859,"452 days, 18:07:23",2013-01-29 05:28:51,2010-02-01 10:32:08,2011-04-30 04:39:31,1533
23,45,121,189,"452 days, 22:29:53",2013-02-03 06:53:58,2010-02-01 10:32:08,2011-04-30 09:02:01,9054
53,3,39,95,"453 days, 0:02:43",2013-01-13 02:11:44,2010-02-01 10:32:08,2011-04-30 10:34:51,2956
521,23,187,731,"453 days, 14:18:27",2013-02-05 08:38:57,2010-02-01 10:32:08,2011-05-01 00:50:35,5954
274,0,44,318,"453 days, 17:19:57",2013-02-01 03:35:01,2010-02-01 10:32:08,2011-05-01 03:52:05,591
3,4,0,7,"454 days, 0:51:33",2012-07-06 04:06:29,2010-02-01 10:32:08,2011-05-01 11:23:41,4666
4,1,70,75,"454 days, 14:24:30",2013-01-08 00:20:34,2010-02-01 10:32:08,2011-05-02 00:56:38,94
15,6,39,60,"454 days, 16:02:37",2013-01-30 02:16:54,2010-02-01 10:32:08,2011-05-02 02:34:45,7325
830,0,17,847,"454 days, 16:03:01",2013-01-25 10:01:46,2010-02-01 10:32:08,2011-05-02 02:35:09,9740
296,0,16,312,"454 days, 16:59:47",2013-01-16 07:31:16,2010-02-01 10:32:08,2011-05-02 03:31:55,1368
257,1,27,285,"454 days, 18:27:53",2013-01-16 05:17:17,2010-02-01 10:32:08,2011-05-02 05:00:01,3092
294,4,57,355,"454 days, 18:54:44",2013-01-29 01:09:48,2010-02-01 10:32:08,2011-05-02 05:26:52,4002
84,1,22,107,"454 days, 23:00:41",2013-01-26 05:10:05,2010-02-01 10:32:08,2011-05-02 09:32:49,9444
6,1,18,25,"454 days, 23:38:26",2012-11-19 02:21:20,2010-02-01 10:32:08,2011-05-02 10:10:34,6947
154,1,22,177,"455 days, 13:37:32",2013-01-27 09:28:59,2010-02-01 10:32:08,2011-05-03 00:09:40,847
383,43,70,496,"455 days, 17:18:37",2013-01-30 07:17:14,2010-02-01 10:32:08,2011-05-03 03:50:45,3665
237,0,19,256,"456 days, 0:57:27",2013-01-15 10:32:22,2010-02-01 10:32:08,2011-05-03 11:29:35,3314
529,43,305,877,"456 days, 14:14:31",2013-02-06 04:22:15,2010-02-01 10:32:08,2011-05-04 00:46:39,8710
223,5,80,308,"456 days, 15:33:38",2013-01-31 02:33:12,2010-02-01 10:32:08,2011-05-04 02:05:46,920
260,2,35,297,"456 days, 18:13:14",2013-01-27 01:41:21,2010-02-01 10:32:08,2011-05-04 04:45:22,577
130,0,8,138,"456 days, 20:50:54",2013-01-29 04:11:20,2010-02-01 10:32:08,2011-05-04 07:23:02,6346
614,0,3,617,"456 days, 21:39:13",2013-01-29 01:36:00,2010-02-01 10:32:08,2011-05-04 08:11:21,3657
4,0,0,4,"456 days, 21:43:11",2013-01-09 07:03:51,2010-02-01 10:32:08,2011-05-04 08:15:19,1572
6,16,3,25,"456 days, 22:55:05",2013-02-04 10:40:04,2010-02-01 10:32:08,2011-05-04 09:27:13,5377
504,13,86,603,"456 days, 23:33:37",2013-01-30 02:40:36,2010-02-01 10:32:08,2011-05-04 10:05:45,3383
47,1,24,72,"457 days, 0:38:11",2013-01-27 00:43:16,2010-02-01 10:32:08,2011-05-04 11:10:19,8027
343,1,60,404,"457 days, 1:09:05",2013-01-29 00:22:28,2010-02-01 10:32:08,2011-05-04 11:41:13,5887
353,0,0,353,"457 days, 14:19:43",2013-01-31 01:14:42,2010-02-01 10:32:08,2011-05-05 00:51:51,7901
393,2,87,482,"457 days, 16:17:21",2013-01-29 09:09:23,2010-02-01 10:32:08,2011-05-05 02:49:29,5785
312,24,188,524,"457 days, 16:54:39",2013-02-03 01:24:11,2010-02-01 10:32:08,2011-05-05 03:26:47,5804
33,0,57,90,"457 days, 18:04:36",2013-01-12 05:06:18,2010-02-01 10:32:08,2011-05-05 04:36:44,3516
222,3,2,227,"457 days, 19:51:06",2013-02-07 09:11:19,2011-02-17 05:58:57,2012-05-20 01:50:03,7554
220,1,13,234,"457 days, 20:30:11",2013-01-23 07:52:51,2010-02-01 10:32:08,2011-05-05 07:02:19,4125
15,2,27,44,"458 days, 14:44:40",2013-02-01 00:34:03,2010-02-01 10:32:08,2011-05-06 01:16:48,2318
705,1,6,712,"458 days, 16:09:18",2013-01-28 11:24:20,2010-02-01 10:32:08,2011-05-06 02:41:26,2295
694,1,20,715,"458 days, 21:42:44",2013-01-30 01:05:13,2010-02-01 10:32:08,2011-05-06 08:14:52,5283
779,1,11,791,"459 days, 0:06:48",2013-01-30 11:41:52,2010-02-01 10:32:08,2011-05-06 10:38:56,8064
11,51,25,87,"459 days, 15:09:18",2013-02-03 06:12:46,2010-02-01 10:32:08,2011-05-07 01:41:26,5233
886,0,0,886,"459 days, 15:10:17",2013-01-27 01:27:50,2010-02-01 10:32:08,2011-05-07 01:42:25,276
8,3,76,87,"460 days, 1:08:02",2013-01-16 00:56:25,2010-02-01 10:32:08,2011-05-07 11:40:10,8071
131,5,87,223,"460 days, 17:23:17",2013-01-29 00:04:26,2010-02-01 10:32:08,2011-05-08 03:55:25,9003
427,7,162,596,"460 days, 19:03:32",2013-02-04 02:42:22,2010-02-01 10:32:08,2011-05-08 05:35:40,4357
155,1,9,165,"460 days, 21:54:33",2013-01-30 00:40:39,2010-02-21 08:50:56,2011-05-28 06:45:29,3925
254,5,20,279,"461 days, 23:27:52",2013-02-04 06:39:02,2010-02-01 10:32:08,2011-05-09 10:00:00,3370
263,5,56,324,"462 days, 13:45:15",2013-02-05 00:30:16,2010-02-01 10:32:08,2011-05-10 00:17:23,8979
5,45,197,247,"462 days, 16:08:50",2013-02-02 11:28:50,2010-02-01 10:32:08,2011-05-10 02:40:58,4706
50,85,201,336,"462 days, 20:50:56",2013-02-03 07:23:04,2010-02-01 10:32:08,2011-05-10 07:23:04,9605
1,1,74,76,"463 days, 16:18:14",2013-01-29 00:33:35,2010-02-01 10:32:08,2011-05-11 02:50:22,6059
16,0,124,140,"463 days, 16:48:31",2013-01-27 09:48:01,2010-02-01 10:32:08,2011-05-11 03:20:39,5982
660,72,209,941,"463 days, 21:34:27",2013-02-02 11:13:58,2010-02-01 10:32:08,2011-05-11 08:06:35,4481
15,22,64,101,"463 days, 23:54:14",2013-02-01 06:38:34,2010-02-01 10:32:08,2011-05-11 10:26:22,9991
46,1,32,79,"464 days, 0:01:29",2013-02-01 05:55:12,2010-02-01 10:32:08,2011-05-11 10:33:37,2573
554,5,140,699,"464 days, 20:53:58",2013-02-03 08:17:47,2010-02-01 10:32:08,2011-05-12 07:26:06,6884
22,40,177,239,"464 days, 22:35:11",2013-01-29 11:21:28,2010-02-01 10:32:08,2011-05-12 09:07:19,9089
94,3,85,182,"465 days, 15:18:58",2013-02-05 01:43:55,2010-02-01 10:32:08,2011-05-13 01:51:06,5471
309,1,26,336,"465 days, 16:04:41",2013-01-28 06:32:23,2010-02-01 10:32:08,2011-05-13 02:36:49,9689
831,9,30,870,"465 days, 20:15:43",2013-01-31 00:22:18,2010-02-01 10:32:08,2011-05-13 06:47:51,7506
138,73,194,405,"466 days, 13:42:32",2013-02-05 03:44:59,2010-02-01 10:32:08,2011-05-14 00:14:40,4941
550,1,7,558,"466 days, 14:28:24",2013-01-31 00:27:57,2010-02-01 10:32:08,2011-05-14 01:00:32,9367
270,19,65,354,"467 days, 16:46:50",2013-02-03 11:03:52,2010-02-01 10:32:08,2011-05-15 03:18:58,7109
339,15,69,423,"468 days, 13:53:16",2013-02-05 09:39:53,2010-02-01 10:32:08,2011-05-16 00:25:24,2389
421,0,0,421,"468 days, 17:28:09",2013-01-08 10:39:26,2010-02-01 10:32:08,2011-05-16 04:00:17,263
2,3,24,29,"468 days, 20:23:18",2013-01-09 00:00:04,2010-02-01 10:32:08,2011-05-16 06:55:26,7973
404,1,28,433,"468 days, 21:32:42",2013-02-03 10:00:13,2010-02-01 10:32:08,2011-05-16 08:04:50,1019
783,1,8,792,"469 days, 1:19:16",2013-01-18 08:06:10,2010-02-01 10:32:08,2011-05-16 11:51:24,1429
350,0,45,395,"469 days, 15:45:29",2013-01-30 01:21:36,2010-02-01 10:32:08,2011-05-17 02:17:37,3616
13,0,24,37,"469 days, 16:03:43",2013-01-29 07:49:24,2010-02-01 10:32:08,2011-05-17 02:35:51,3394
2,70,229,301,"470 days, 0:59:24",2013-02-03 03:43:51,2010-02-01 10:32:08,2011-05-17 11:31:32,7811
10,0,24,34,"470 days, 14:28:51",2013-02-01 08:26:40,2010-02-01 10:32:08,2011-05-18 01:00:59,3429
694,0,0,694,"470 days, 16:46:21",2013-01-28 11:47:06,2010-02-01 10:32:08,2011-05-18 03:18:29,6287
19,5,26,50,"470 days, 22:45:26",2013-02-07 04:41:07,2010-02-01 10:32:08,2011-05-18 09:17:34,9002
597,1,0,598,"471 days, 18:21:36",2013-01-18 08:50:14,2010-02-01 10:32:08,2011-05-19 04:53:44,45
207,4,80,291,"471 days, 21:26:26",2013-02-01 09:18:56,2010-02-01 10:32:08,2011-05-19 07:58:34,3497
218,0,0,218,"472 days, 1:02:31",2012-12-24 05:21:43,2010-02-01 10:32:08,2011-05-19 11:34:39,8535
126,2,13,141,"472 days, 1:19:28",2013-02-04 02:02:03,2010-02-01 10:32:08,2011-05-19 11:51:36,9520
310,2,6,318,"472 days, 2:08:49",2013-01-30 09:00:07,2010-06-14 05:34:19,2011-09-29 07:43:08,8784
249,9,14,272,"472 days, 17:25:16",2013-01-28 10:10:21,2010-02-01 10:32:08,2011-05-20 03:57:24,8213
410,0,19,429,"472 days, 18:29:39",2013-01-26 02:11:36,2010-02-01 10:32:08,2011-05-20 05:01:47,6563
9,68,121,198,"473 days, 1:06:56",2013-01-31 04:36:04,2010-02-01 10:32:08,2011-05-20 11:39:04,4606
64,3,48,115,"473 days, 15:39:43",2013-01-15 10:36:48,2010-02-01 10:32:08,2011-05-21 02:11:51,7083
136,19,39,194,"473 days, 17:49:49",2013-02-05 09:21:02,2010-02-01 10:32:08,2011-05-21 04:21:57,3734
137,1,65,203,"474 days, 13:47:41",2013-01-17 04:33:56,2010-02-01 10:32:08,2011-05-22 00:19:49,4869
142,14,179,335,"474 days, 14:02:36",2013-02-05 09:40:35,2010-02-01 10:32:08,2011-05-22 00:34:44,7492
588,20,104,712,"474 days, 17:08:24",2013-02-05 02:34:09,2010-02-01 10:32:08,2011-05-22 03:40:32,4197
575,2,0,577,"474 days, 17:18:14",2013-01-27 04:27:40,2010-02-01 10:32:08,2011-05-22 03:50:22,5750
2,2,40,44,"474 days, 19:51:35",2013-02-01 09:21:58,2010-02-01 10:32:08,2011-05-22 06:23:43,9657
210,16,55,281,"474 days, 22:48:20",2013-02-02 11:21:16,2010-02-01 10:32:08,2011-05-22 09:20:28,5001
828,0,0,828,"475 days, 14:47:23",2013-01-29 06:18:01,2010-02-01 10:32:08,2011-05-23 01:19:31,9858
120,0,16,136,"475 days, 18:54:38",2013-01-30 10:27:48,2010-02-01 10:32:08,2011-05-23 05:26:46,9178
808,0,14,822,"475 days, 22:00:48",2013-01-29 08:19:18,2010-02-01 10:32:08,2011-05-23 08:32:56,5889
193,0,39,232,"475 days, 23:11:45",2013-01-23 01:53:41,2010-02-01 10:32:08,2011-05-23 09:43:53,1473
378,10,95,483,"476 days, 0:19:21",2013-01-31 03:32:23,2010-02-01 10:32:08,2011-05-23 10:51:29,3163
508,0,0,508,"476 days, 21:30:58",2013-01-27 04:38:30,2010-02-01 10:32:08,2011-05-24 08:03:06,6091
14,0,0,14,"476 days, 21:59:28",2013-01-24 11:30:08,2010-02-01 10:32:08,2011-05-24 08:31:36,3915
655,0,5,660,"476 days, 23:08:08",2013-01-27 06:01:32,2010-02-01 10:32:08,2011-05-24 09:40:16,6693
149,0,65,214,"476 days, 23:14:21",2013-01-30 11:28:47,2010-02-01 10:32:08,2011-05-24 09:46:29,8591
207,2,0,209,"477 days, 13:44:27",2013-01-31 03:45:25,2010-02-01 10:32:08,2011-05-25 00:16:35,2037
510,0,4,514,"477 days, 21:40:31",2013-01-21 02:53:56,2010-02-01 10:32:08,2011-05-25 08:12:39,8611
188,0,27,215,"477 days, 22:14:59",2013-01-31 09:29:06,2010-02-01 10:32:08,2011-05-25 08:47:07,9930
748,0,19,767,"478 days, 0:41:41",2013-01-29 04:10:03,2010-02-01 10:32:08,2011-05-25 11:13:49,5101
385,13,8,406,"478 days, 18:11:58",2013-01-23 05:27:00,2010-02-01 10:32:08,2011-05-26 04:44:06,6072
9,2,29,40,"478 days, 21:45:42",2012-12-30 11:14:07,2010-02-01 10:32:08,2011-05-26 08:17:50,7229
564,17,67,648,"479 days, 0:24:46",2013-01-30 06:59:48,2010-02-01 10:32:08,2011-05-26 10:56:54,1221
581,0,27,608,"479 days, 20:10:28",2013-02-03 01:41:47,2010-02-01 10:32:08,2011-05-27 06:42:36,5171
134,11,175,320,"480 days, 0:34:41",2013-01-31 09:01:17,2010-02-01 10:32:08,2011-05-27 11:06:49,3656
226,3,124,353,"480 days, 20:35:45",2013-01-29 00:52:05,2010-02-01 10:32:08,2011-05-28 07:07:53,8351
422,4,64,490,"482 days, 17:39:42",2013-01-31 07:36:37,2010-02-01 10:32:08,2011-05-30 04:11:50,3849
8,0,0,8,"482 days, 23:23:40",2013-01-30 06:06:07,2010-02-01 10:32:08,2011-05-30 09:55:48,989
360,0,11,371,"483 days, 13:40:20",2013-01-26 00:01:37,2010-02-01 10:32:08,2011-05-31 00:12:28,5151
644,0,3,647,"483 days, 14:28:25",2013-01-31 05:01:25,2010-02-01 10:32:08,2011-05-31 01:00:33,6645
591,60,322,973,"483 days, 18:34:15",2013-02-02 06:51:24,2010-02-01 10:32:08,2011-05-31 05:06:23,9986
194,0,9,203,"483 days, 22:45:28",2013-01-20 10:44:24,2010-02-01 10:32:08,2011-05-31 09:17:36,6088
853,5,43,901,"484 days, 16:30:50",2013-01-27 10:10:12,2010-02-01 10:32:08,2011-06-01 03:02:58,2488
165,1,8,174,"484 days, 18:04:52",2013-01-10 04:02:24,2010-02-01 10:32:08,2011-06-01 04:37:00,5217
17,1,53,71,"484 days, 22:35:33",2013-01-26 04:10:21,2010-02-01 10:32:08,2011-06-01 09:07:41,9271
713,0,0,713,"484 days, 23:17:48",2013-01-23 05:48:35,2010-02-01 10:32:08,2011-06-01 09:49:56,4663
17,267,313,597,"485 days, 17:50:24",2013-02-03 03:19:10,2010-02-01 10:32:08,2011-06-02 04:22:32,7440
434,0,31,465,"485 days, 21:23:20",2013-01-28 11:49:20,2010-02-01 10:32:08,2011-06-02 07:55:28,513
756,0,3,759,"486 days, 15:27:36",2013-01-30 05:25:32,2010-02-01 10:32:08,2011-06-03 01:59:44,6525
418,0,16,434,"486 days, 15:44:20",2013-02-04 02:30:56,2010-02-01 10:32:08,2011-06-03 02:16:28,5746
6,0,0,6,"486 days, 18:44:39",2012-12-25 03:25:55,2010-02-01 10:32:08,2011-06-03 05:16:47,2813
669,0,0,669,"486 days, 22:04:09",2013-01-30 01:21:50,2010-02-01 10:32:08,2011-06-03 08:36:17,2656
443,9,7,459,"487 days, 0:53:48",2013-01-31 10:38:53,2010-02-01 10:32:08,2011-06-03 11:25:56,3642
9,0,59,68,"489 days, 0:38:04",2013-02-03 07:09:08,2010-02-01 10:32:08,2011-06-05 11:10:12,4608
390,0,12,402,"489 days, 20:52:17",2012-12-15 05:59:50,2010-02-01 10:32:08,2011-06-06 07:24:25,2848
631,15,25,671,"489 days, 23:01:11",2013-02-03 08:51:04,2010-02-01 10:32:08,2011-06-06 09:33:19,2435
177,0,23,200,"491 days, 16:31:29",2013-01-24 05:31:20,2010-02-01 10:32:08,2011-06-08 03:03:37,687
401,2,2,405,"492 days, 14:24:51",2013-01-23 05:07:22,2010-02-01 10:32:08,2011-06-09 00:56:59,8504
454,5,85,544,"493 days, 4:04:52",2013-02-01 06:25:28,2010-04-06 00:20:01,2011-08-12 04:24:53,2404
580,186,297,1063,"493 days, 15:14:21",2013-02-04 01:37:48,2010-02-01 10:32:08,2011-06-10 01:46:29,9759
388,0,35,423,"494 days, 0:25:52",2013-01-19 09:17:06,2010-02-01 10:32:08,2011-06-10 10:58:00,7851
725,0,0,725,"494 days, 13:55:48",2013-01-21 06:50:13,2010-02-01 10:32:08,2011-06-11 00:27:56,4805
350,1,22,373,"494 days, 17:12:34",2013-02-03 06:30:51,2010-02-01 10:32:08,2011-06-11 03:44:42,4051
122,60,168,350,"494 days, 20:32:03",2013-02-07 05:37:35,2010-02-01 10:32:08,2011-06-11 07:04:11,4790
769,0,4,773,"494 days, 23:14:56",2013-01-29 08:27:24,2010-02-01 10:32:08,2011-06-11 09:47:04,176
7,1,36,44,"495 days, 17:41:15",2013-01-30 05:33:29,2010-02-01 10:32:08,2011-06-12 04:13:23,214
250,3,12,265,"496 days, 19:58:40",2013-01-06 04:30:54,2010-02-01 10:32:08,2011-06-13 06:30:48,8337
74,2,31,107,"497 days, 16:01:45",2013-01-26 03:29:15,2010-02-01 10:32:08,2011-06-14 02:33:53,616
369,1,4,374,"497 days, 19:11:47",2013-01-27 07:07:13,2010-04-23 09:08:31,2011-09-03 04:20:18,6810
398,0,0,398,"498 days, 14:02:04",2013-01-23 03:22:02,2010-02-01 10:32:08,2011-06-15 00:34:12,4450
178,12,9,199,"498 days, 16:58:51",2013-02-01 09:04:48,2010-02-01 10:32:08,2011-06-15 03:30:59,77
480,0,22,502,"498 days, 22:17:07",2013-02-02 04:20:40,2010-02-01 10:32:08,2011-06-15 08:49:15,6817
632,5,11,648,"498 days, 22:18:44",2013-02-05 02:08:32,2010-02-01 10:32:08,2011-06-15 08:50:52,7120
5,4,11,20,"499 days, 0:11:47",2013-02-04 00:16:05,2010-02-01 10:32:08,2011-06-15 10:43:55,3667
537,0,1,538,"499 days, 1:02:59",2013-01-25 06:17:38,2010-02-01 10:32:08,2011-06-15 11:35:07,9510
46,14,125,185,"499 days, 14:13:50",2013-02-06 09:11:21,2010-02-01 10:32:08,2011-06-16 00:45:58,3835
9,19,123,151,"500 days, 13:33:26",2013-02-02 03:41:23,2010-02-01 10:32:08,2011-06-17 00:05:34,9181
788,0,39,827,"500 days, 18:44:09",2013-01-29 06:32:00,2010-02-01 10:32:08,2011-06-17 05:16:17,4549
328,0,0,328,"500 days, 23:56:41",2013-01-30 06:10:35,2010-02-01 10:32:08,2011-06-17 10:28:49,516
18,0,35,53,"501 days, 0:15:01",2013-01-28 11:09:07,2010-02-01 10:32:08,2011-06-17 10:47:09,6611
362,1,1,364,"501 days, 0:42:21",2013-01-29 06:03:14,2010-02-01 10:32:08,2011-06-17 11:14:29,8456
10,1,41,52,"501 days, 20:38:40",2013-02-02 05:55:13,2010-02-01 10:32:08,2011-06-18 07:10:48,412
30,80,260,370,"502 days, 13:48:08",2013-02-04 03:00:37,2010-02-01 10:32:08,2011-06-19 00:20:16,1947
385,48,187,620,"502 days, 22:50:44",2013-02-04 08:46:45,2010-02-01 10:32:08,2011-06-19 09:22:52,9056
47,8,77,132,"503 days, 17:48:20",2013-01-27 03:17:33,2010-02-01 10:32:08,2011-06-20 04:20:28,1930
608,10,124,742,"503 days, 17:56:48",2013-02-04 09:00:14,2010-02-01 10:32:08,2011-06-20 04:28:56,1415
323,0,16,339,"503 days, 21:28:27",2013-01-18 08:43:06,2010-02-01 10:32:08,2011-06-20 08:00:35,8366
112,143,272,527,"504 days, 0:05:40",2013-02-06 10:02:09,2010-02-01 10:32:08,2011-06-20 10:37:48,6146
200,0,0,200,"504 days, 17:25:38",2013-01-20 03:12:43,2010-02-01 10:32:08,2011-06-21 03:57:46,7732
510,1,0,511,"504 days, 21:45:00",2013-01-28 11:38:51,2010-02-01 10:32:08,2011-06-21 08:17:08,2360
12,0,0,12,"504 days, 23:19:33",2012-12-31 01:29:04,2010-02-01 10:32:08,2011-06-21 09:51:41,9036
179,49,129,357,"506 days, 0:13:08",2013-02-02 08:41:13,2010-02-01 10:32:08,2011-06-22 10:45:16,7551
635,13,28,676,"506 days, 15:09:05",2013-02-02 04:53:29,2010-02-01 10:32:08,2011-06-23 01:41:13,2278
620,30,168,818,"506 days, 16:07:54",2013-01-30 11:53:17,2010-02-01 10:32:08,2011-06-23 02:40:02,5371
167,8,163,338,"506 days, 20:46:51",2013-02-02 00:52:29,2010-02-01 10:32:08,2011-06-23 07:18:59,2829
3,1,24,28,"507 days, 0:35:26",2012-12-12 05:35:58,2010-02-01 10:32:08,2011-06-23 11:07:34,4579
2,0,0,2,"507 days, 17:06:02",2012-07-04 04:33:41,2010-02-01 10:32:08,2011-06-24 03:38:10,8299
7,0,19,26,"507 days, 23:20:31",2013-01-31 00:49:11,2010-02-01 10:32:08,2011-06-24 09:52:39,5725
731,1,4,736,"508 days, 17:57:56",2013-01-24 05:27:46,2010-02-01 10:32:08,2011-06-25 04:30:04,2027
452,4,55,511,"508 days, 20:40:02",2013-02-03 07:53:02,2010-02-01 10:32:08,2011-06-25 07:12:10,4464
243,33,119,395,"509 days, 13:58:05",2013-02-06 03:55:48,2010-02-01 10:32:08,2011-06-26 00:30:13,7562
549,0,16,565,"509 days, 18:27:28",2013-01-31 07:29:00,2010-02-01 10:32:08,2011-06-26 04:59:36,9274
453,8,47,508,"510 days, 0:45:27",2013-01-30 08:43:03,2010-04-09 09:33:18,2011-09-01 10:18:45,7041
5,0,11,16,"510 days, 18:21:24",2013-01-31 06:40:38,2010-02-01 10:32:08,2011-06-27 04:53:32,914
349,0,0,349,"511 days, 14:42:56",2012-12-19 11:50:05,2010-02-01 10:32:08,2011-06-28 01:15:04,1755
13,1,4,18,"511 days, 16:59:45",2013-01-27 01:57:21,2010-02-01 10:32:08,2011-06-28 03:31:53,2753
319,0,16,335,"512 days, 0:09:11",2013-01-17 05:44:46,2010-02-01 10:32:08,2011-06-28 10:41:19,6492
181,16,63,260,"512 days, 20:12:25",2013-01-30 00:05:19,2010-03-06 04:37:20,2011-08-01 00:49:45,4503
36,12,146,194,"512 days, 23:54:55",2013-02-03 11:47:16,2010-02-01 10:32:08,2011-06-29 10:27:03,6166
507,0,7,514,"513 days, 19:18:51",2013-01-21 07:27:54,2010-02-01 10:32:08,2011-06-30 05:50:59,3006
684,0,12,696,"513 days, 21:45:55",2013-01-24 07:34:49,2010-02-01 10:32:08,2011-06-30 08:18:03,1908
401,0,28,429,"514 days, 15:50:21",2013-01-31 08:53:00,2010-02-01 10:32:08,2011-07-01 02:22:29,1223
3,13,112,128,"515 days, 0:06:55",2013-02-02 09:30:47,2010-02-01 10:32:08,2011-07-01 10:39:03,9610
520,1,0,521,"515 days, 15:03:47",2013-01-29 06:09:12,2010-02-01 10:32:08,2011-07-02 01:35:55,874
484,1,10,495,"517 days, 1:09:48",2013-01-19 11:18:07,2010-02-01 10:32:08,2011-07-03 11:41:56,2275
705,1,0,706,"517 days, 15:35:38",2013-01-19 04:40:24,2010-02-01 10:32:08,2011-07-04 02:07:46,2768
333,0,5,338,"518 days, 0:29:40",2013-01-23 01:59:22,2010-02-01 10:32:08,2011-07-04 11:01:48,622
41,75,210,326,"518 days, 13:28:39",2013-02-02 03:54:32,2010-02-01 10:32:08,2011-07-05 00:00:47,6140
1,0,49,50,"518 days, 15:03:03",2013-01-28 00:43:24,2010-02-01 10:32:08,2011-07-05 01:35:11,9471
743,7,14,764,"518 days, 18:40:38",2013-01-28 08:42:14,2010-02-01 10:32:08,2011-07-05 05:12:46,3130
196,3,48,247,"518 days, 21:35:09",2013-01-28 10:59:53,2010-02-01 10:32:08,2011-07-05 08:07:17,3183
611,0,0,611,"519 days, 14:31:45",2013-01-23 06:57:52,2010-02-01 10:32:08,2011-07-06 01:03:53,8987
509,2,34,545,"519 days, 14:53:14",2013-01-29 10:34:13,2010-02-01 10:32:08,2011-07-06 01:25:22,7647
172,0,0,172,"519 days, 16:48:32",2013-01-11 04:00:08,2010-02-01 10:32:08,2011-07-06 03:20:40,3878
0,0,18,18,"519 days, 16:54:35",2013-01-26 00:03:14,2010-02-01 10:32:08,2011-07-06 03:26:43,6582
179,17,224,420,"520 days, 22:22:04",2013-02-03 02:18:27,2010-02-01 10:32:08,2011-07-07 08:54:12,12
10,0,23,33,"521 days, 16:14:37",2013-01-13 11:58:31,2010-02-01 10:32:08,2011-07-08 02:46:45,3213
3,5,12,20,"521 days, 19:57:41",2013-02-07 05:14:22,2010-02-01 10:32:08,2011-07-08 06:29:49,2587
452,197,421,1070,"521 days, 23:39:55",2013-02-05 11:09:41,2010-02-01 10:32:08,2011-07-08 10:12:03,5903
535,26,88,649,"522 days, 1:23:01",2013-01-31 11:40:15,2010-02-01 10:32:08,2011-07-08 11:55:09,4626
202,0,0,202,"522 days, 18:55:00",2013-01-05 11:49:33,2010-02-01 10:32:08,2011-07-09 05:27:08,1520
235,3,54,292,"522 days, 19:48:00",2013-02-02 08:42:29,2010-02-01 10:32:08,2011-07-09 06:20:08,6053
9,0,40,49,"523 days, 16:30:44",2013-01-27 03:01:27,2010-02-01 10:32:08,2011-07-10 03:02:52,175
159,0,12,171,"523 days, 22:46:47",2013-01-23 07:57:35,2010-02-01 10:32:08,2011-07-10 09:18:55,7760
299,0,39,338,"524 days, 0:02:32",2013-01-29 11:44:38,2010-02-01 10:32:08,2011-07-10 10:34:40,2785
9,2,70,81,"525 days, 14:57:42",2013-01-29 04:41:45,2010-02-01 10:32:08,2011-07-12 01:29:50,8509
568,0,0,568,"525 days, 15:34:55",2013-01-29 06:58:35,2010-02-01 10:32:08,2011-07-12 02:07:03,2906
120,98,48,266,"525 days, 18:14:44",2013-02-05 09:25:28,2010-02-01 10:32:08,2011-07-12 04:46:52,7912
197,14,28,239,"525 days, 18:46:25",2013-01-27 09:13:07,2010-02-01 10:32:08,2011-07-12 05:18:33,142
13,0,15,28,"525 days, 19:24:14",2013-01-14 03:20:24,2010-02-01 10:32:08,2011-07-12 05:56:22,6161
439,0,0,439,"526 days, 13:58:49",2013-01-30 01:07:19,2010-02-01 10:32:08,2011-07-13 00:30:57,7615
137,1,20,158,"526 days, 18:50:44",2013-01-26 06:35:41,2010-02-01 10:32:08,2011-07-13 05:22:52,7800
1,0,13,14,"527 days, 15:01:19",2013-01-31 02:12:43,2010-02-01 10:32:08,2011-07-14 01:33:27,268
209,2,0,211,"527 days, 20:21:24",2013-01-30 08:51:51,2010-02-01 10:32:08,2011-07-14 06:53:32,1075
18,12,103,133,"528 days, 13:44:15",2013-01-27 03:15:24,2010-02-01 10:32:08,2011-07-15 00:16:23,6470
66,3,10,79,"528 days, 18:44:32",2013-01-26 06:31:50,2010-02-01 10:32:08,2011-07-15 05:16:40,1329
5,2,32,39,"528 days, 21:06:22",2013-01-26 08:20:34,2010-02-01 10:32:08,2011-07-15 07:38:30,1909
136,17,86,239,"528 days, 21:23:51",2013-01-26 08:20:40,2010-02-01 10:32:08,2011-07-15 07:55:59,9778
6,4,88,98,"528 days, 23:34:48",2013-01-30 11:24:54,2010-02-01 10:32:08,2011-07-15 10:06:56,9684
13,1,82,96,"529 days, 18:30:11",2013-02-04 09:53:56,2010-02-01 10:32:08,2011-07-16 05:02:19,3338
206,36,177,419,"529 days, 22:39:08",2013-02-03 08:40:41,2010-02-01 10:32:08,2011-07-16 09:11:16,8715
184,24,69,277,"530 days, 15:02:21",2013-02-04 03:26:48,2010-02-01 10:32:08,2011-07-17 01:34:29,2448
390,0,0,390,"530 days, 19:27:33",2013-01-26 02:59:06,2010-02-01 10:32:08,2011-07-17 05:59:41,3342
229,56,61,346,"530 days, 23:12:03",2013-01-25 07:02:47,2010-02-01 10:32:08,2011-07-17 09:44:11,4537
2,5,133,140,"532 days, 14:11:50",2013-02-02 04:53:14,2010-02-01 10:32:08,2011-07-19 00:43:58,7092
543,7,30,580,"532 days, 15:46:02",2013-02-04 06:51:30,2010-02-01 10:32:08,2011-07-19 02:18:10,4036
103,10,6,119,"533 days, 16:24:58",2013-02-06 02:40:53,2010-02-01 10:32:08,2011-07-20 02:57:06,981
12,3,12,27,"534 days, 1:23:15",2013-01-08 05:38:35,2010-02-01 10:32:08,2011-07-20 11:55:23,7302
16,2,13,31,"534 days, 14:21:13",2012-12-24 03:36:15,2010-02-01 10:32:08,2011-07-21 00:53:21,5240
298,1,0,299,"534 days, 16:12:53",2013-01-31 06:25:06,2010-02-01 10:32:08,2011-07-21 02:45:01,140
10,0,9,19,"534 days, 18:47:02",2013-02-04 04:31:07,2010-02-01 10:32:08,2011-07-21 05:19:10,601
211,3,23,237,"535 days, 17:47:29",2013-01-08 02:33:44,2010-02-01 10:32:08,2011-07-22 04:19:37,4946
153,0,0,153,"535 days, 19:15:16",2012-12-11 08:17:42,2010-02-01 10:32:08,2011-07-22 05:47:24,9467
357,6,123,486,"537 days, 1:15:17",2013-02-02 08:39:11,2010-02-01 10:32:08,2011-07-23 11:47:25,6050
72,9,129,210,"537 days, 16:52:08",2013-02-02 10:36:52,2010-02-01 10:32:08,2011-07-24 03:24:16,9998
360,0,16,376,"538 days, 18:14:09",2013-01-22 06:46:40,2010-02-01 10:32:08,2011-07-25 04:46:17,2641
240,2,15,257,"539 days, 1:13:34",2013-01-15 08:30:17,2010-02-01 10:32:08,2011-07-25 11:45:42,1835
713,2,4,719,"539 days, 19:01:28",2013-01-29 04:13:44,2010-02-01 10:32:08,2011-07-26 05:33:36,3147
573,1,8,582,"539 days, 20:45:08",2013-01-31 11:00:29,2010-02-01 10:32:08,2011-07-26 07:17:16,2595
140,0,5,145,"540 days, 18:17:41",2013-01-24 01:44:00,2010-02-01 10:32:08,2011-07-27 04:49:49,1534
31,3,29,63,"541 days, 15:20:09",2013-02-02 07:16:28,2010-02-01 10:32:08,2011-07-28 01:52:17,3982
192,0,2,194,"542 days, 0:29:30",2012-12-13 09:31:46,2010-02-01 10:32:08,2011-07-28 11:01:38,9378
20,4,0,24,"542 days, 23:53:31",2013-01-31 02:34:20,2010-02-01 10:32:08,2011-07-29 10:25:39,257
42,3,8,53,"543 days, 18:56:28",2013-02-02 04:11:28,2010-02-01 10:32:08,2011-07-30 05:28:36,5129
0,0,5,5,"543 days, 21:46:21",2012-09-17 06:28:14,2010-02-01 10:32:08,2011-07-30 08:18:29,1974
91,9,50,150,"544 days, 13:48:36",2013-02-03 09:07:33,2010-02-01 10:32:08,2011-07-31 00:20:44,9176
126,2,19,147,"544 days, 15:57:08",2013-01-31 11:40:55,2010-02-01 10:32:08,2011-07-31 02:29:16,6785
687,2,36,725,"544 days, 17:28:14",2013-01-25 05:17:47,2010-02-01 10:32:08,2011-07-31 04:00:22,3639
382,0,37,419,"545 days, 15:30:56",2013-02-01 07:58:24,2010-02-01 10:32:08,2011-08-01 02:03:04,7749
457,1,1,459,"545 days, 19:05:02",2013-01-27 06:47:40,2010-02-01 10:32:08,2011-08-01 05:37:10,7839
186,19,104,309,"546 days, 14:05:04",2013-02-04 10:53:36,2010-02-01 10:32:08,2011-08-02 00:37:12,6725
12,0,31,43,"546 days, 22:19:20",2013-01-28 10:03:24,2010-02-01 10:32:08,2011-08-02 08:51:28,6067
5,1,21,27,"547 days, 20:37:33",2013-01-23 07:54:20,2010-02-01 10:32:08,2011-08-03 07:09:41,5322
70,1,6,77,"547 days, 21:23:55",2013-01-14 03:43:41,2010-02-01 10:32:08,2011-08-03 07:56:03,7285
294,1,21,316,"547 days, 22:39:40",2013-01-31 04:50:42,2010-02-01 10:32:08,2011-08-03 09:11:48,4752
415,11,13,439,"548 days, 6:37:13",2013-01-31 04:54:42,2010-05-18 04:16:51,2011-11-17 10:54:04,204
363,0,22,385,"548 days, 16:19:13",2013-02-02 07:09:05,2010-02-01 10:32:08,2011-08-04 02:51:21,9919
143,1,21,165,"548 days, 23:17:44",2013-01-29 05:07:14,2010-02-01 10:32:08,2011-08-04 09:49:52,2273
536,4,64,604,"549 days, 16:02:48",2013-01-26 04:45:58,2010-02-01 10:32:08,2011-08-05 02:34:56,1791
372,28,13,413,"549 days, 17:11:28",2013-02-04 03:51:00,2010-02-01 10:32:08,2011-08-05 03:43:36,2538
413,1,22,436,"550 days, 0:21:33",2013-02-03 01:34:18,2010-02-01 10:32:08,2011-08-05 10:53:41,5700
13,2,50,65,"550 days, 19:37:00",2013-02-03 09:11:26,2010-02-01 10:32:08,2011-08-06 06:09:08,508
123,2,24,149,"551 days, 14:48:40",2013-01-29 09:26:44,2010-02-01 10:32:08,2011-08-07 01:20:48,9335
575,12,52,639,"551 days, 16:24:26",2013-02-03 05:08:53,2010-02-01 10:32:08,2011-08-07 02:56:34,7353
320,2,38,360,"551 days, 17:08:01",2013-02-05 05:28:15,2010-02-01 10:32:08,2011-08-07 03:40:09,7172
748,8,51,807,"551 days, 23:09:54",2013-02-03 04:08:37,2010-02-01 10:32:08,2011-08-07 09:42:02,8300
202,0,0,202,"552 days, 0:54:50",2013-01-29 07:24:29,2010-02-01 10:32:08,2011-08-07 11:26:58,4856
22,0,19,41,"552 days, 14:42:23",2013-01-18 00:52:14,2010-02-01 10:32:08,2011-08-08 01:14:31,7026
10,54,131,195,"552 days, 15:08:45",2013-01-31 00:11:02,2010-02-01 10:32:08,2011-08-08 01:40:53,3567
191,1,12,204,"552 days, 17:17:17",2013-02-02 00:46:10,2010-02-01 10:32:08,2011-08-08 03:49:25,9815
285,3,62,350,"552 days, 18:05:01",2013-01-31 00:45:35,2010-02-01 10:32:08,2011-08-08 04:37:09,2167
9,2,5,16,"552 days, 20:26:36",2013-01-07 02:26:07,2010-02-01 10:32:08,2011-08-08 06:58:44,4754
772,0,7,779,"552 days, 21:59:27",2013-01-25 08:16:13,2010-02-01 10:32:08,2011-08-08 08:31:35,5204
83,34,101,218,"553 days, 16:16:01",2013-02-05 08:52:01,2010-02-01 10:32:08,2011-08-09 02:48:09,2303
705,2,31,738,"553 days, 19:18:29",2013-01-31 07:37:24,2010-02-01 10:32:08,2011-08-09 05:50:37,9793
13,93,105,211,"553 days, 19:47:27",2013-01-30 11:57:00,2010-02-01 10:32:08,2011-08-09 06:19:35,3045
310,14,39,363,"553 days, 21:06:32",2012-12-31 01:19:27,2010-02-01 10:32:08,2011-08-09 07:38:40,3319
660,0,7,667,"554 days, 18:06:40",2013-01-24 11:09:38,2010-02-01 10:32:08,2011-08-10 04:38:48,2823
1,2,20,23,"554 days, 22:34:23",2013-01-27 11:00:09,2010-02-01 10:32:08,2011-08-10 09:06:31,8061
643,0,0,643,"555 days, 13:55:03",2013-01-25 02:47:34,2010-02-01 10:32:08,2011-08-11 00:27:11,2525
586,12,60,658,"556 days, 19:30:51",2013-01-25 01:34:10,2010-02-01 10:32:08,2011-08-12 06:02:59,5470
104,116,185,405,"556 days, 19:50:13",2013-02-02 08:50:23,2010-02-01 10:32:08,2011-08-12 06:22:21,982
6,4,84,94,"556 days, 22:17:46",2013-01-04 03:06:22,2010-02-01 10:32:08,2011-08-12 08:49:54,2556
7,14,119,140,"557 days, 22:11:15",2013-02-05 10:11:42,2010-02-01 10:32:08,2011-08-13 08:43:23,8253
159,7,44,210,"557 days, 22:40:40",2013-02-01 02:07:16,2010-02-01 10:32:08,2011-08-13 09:12:48,1199
2,1,46,49,"558 days, 17:35:54",2013-02-01 01:58:13,2010-02-01 10:32:08,2011-08-14 04:08:02,7494
0,1,11,12,"559 days, 17:44:11",2013-01-12 05:09:20,2010-02-01 10:32:08,2011-08-15 04:16:19,8990
429,1,5,435,"559 days, 19:59:39",2013-01-22 02:28:38,2010-02-01 10:32:08,2011-08-15 06:31:47,3062
359,0,12,371,"559 days, 20:16:59",2013-01-20 10:35:51,2010-02-01 10:32:08,2011-08-15 06:49:07,4226
119,1,24,144,"560 days, 0:46:17",2013-01-27 11:37:49,2010-02-01 10:32:08,2011-08-15 11:18:25,7888
524,0,2,526,"560 days, 17:06:54",2013-01-29 06:21:32,2010-02-01 10:32:08,2011-08-16 03:39:02,2463
497,0,0,497,"560 days, 21:16:53",2013-01-17 05:35:23,2010-02-01 10:32:08,2011-08-16 07:49:01,6048
2,0,36,38,"560 days, 21:17:05",2013-01-22 07:06:51,2010-02-01 10:32:08,2011-08-16 07:49:13,6575
28,6,419,453,"561 days, 14:45:51",2013-01-28 10:35:24,2010-02-01 10:32:08,2011-08-17 01:17:59,2315
431,0,0,431,"561 days, 16:32:12",2013-01-14 05:14:48,2010-02-01 10:32:08,2011-08-17 03:04:20,5334
5,0,9,14,"561 days, 23:45:58",2013-01-29 05:47:42,2010-02-01 10:32:08,2011-08-17 10:18:06,6721
179,1,15,195,"562 days, 15:58:57",2013-01-29 08:20:07,2010-02-01 10:32:08,2011-08-18 02:31:05,7628
12,3,3,18,"562 days, 19:18:10",2013-01-31 01:31:08,2010-02-01 10:32:08,2011-08-18 05:50:18,9651
140,17,172,329,"562 days, 19:56:04",2013-02-02 02:39:48,2010-02-01 10:32:08,2011-08-18 06:28:12,9018
655,0,20,675,"562 days, 23:02:17",2013-01-22 06:15:39,2010-02-01 10:32:08,2011-08-18 09:34:25,330
3,0,4,7,"563 days, 5:06:59",2013-01-30 08:53:05,2011-03-04 03:32:10,2012-09-17 08:39:09,1665
11,1,44,56,"564 days, 17:14:22",2013-02-06 09:36:38,2010-02-01 10:32:08,2011-08-20 03:46:30,6224
323,0,33,356,"565 days, 0:29:53",2013-01-31 10:51:56,2010-02-01 10:32:08,2011-08-20 11:02:01,9680
194,0,0,194,"565 days, 18:29:18",2013-01-08 10:12:38,2010-02-01 10:32:08,2011-08-21 05:01:26,1092
6,13,47,66,"565 days, 23:44:37",2013-01-31 07:59:16,2010-02-01 10:32:08,2011-08-21 10:16:45,4228
10,8,26,44,"566 days, 17:24:33",2013-02-03 06:41:09,2010-02-01 10:32:08,2011-08-22 03:56:41,373
167,7,1,175,"566 days, 17:28:55",2013-02-05 00:59:47,2010-02-01 10:32:08,2011-08-22 04:01:03,9326
58,1,51,110,"566 days, 20:19:20",2013-02-03 08:03:35,2010-02-01 10:32:08,2011-08-22 06:51:28,4040
320,0,0,320,"568 days, 0:42:20",2013-01-29 06:42:02,2010-02-01 10:32:08,2011-08-23 11:14:28,8225
371,1,4,376,"568 days, 18:32:18",2013-01-25 10:39:30,2010-02-01 10:32:08,2011-08-24 05:04:26,6182
158,0,1,159,"568 days, 23:12:06",2013-02-01 00:12:25,2010-02-01 10:32:08,2011-08-24 09:44:14,6911
357,2,6,365,"569 days, 17:15:46",2013-01-25 02:55:23,2010-02-01 10:32:08,2011-08-25 03:47:54,747
59,99,112,270,"570 days, 22:21:54",2013-02-04 02:53:03,2010-02-01 10:32:08,2011-08-26 08:54:02,2320
13,2,11,26,"571 days, 0:28:48",2013-01-29 03:51:57,2010-02-01 10:32:08,2011-08-26 11:00:56,528
587,0,3,590,"571 days, 16:20:33",2013-01-27 05:36:53,2010-02-01 10:32:08,2011-08-27 02:52:41,3201
301,0,0,301,"571 days, 18:51:24",2013-01-05 06:18:58,2010-02-01 10:32:08,2011-08-27 05:23:32,3341
359,1,18,378,"571 days, 22:25:57",2013-02-01 06:01:20,2010-02-01 10:32:08,2011-08-27 08:58:05,9927
360,0,7,367,"572 days, 14:45:13",2013-02-01 09:12:23,2010-02-01 10:32:08,2011-08-28 01:17:21,537
611,0,12,623,"572 days, 20:03:50",2013-01-27 03:26:06,2010-02-01 10:32:08,2011-08-28 06:35:58,113
34,7,87,128,"572 days, 20:47:46",2013-01-31 07:05:05,2010-02-01 10:32:08,2011-08-28 07:19:54,6329
472,0,4,476,"572 days, 22:36:33",2013-01-15 03:29:42,2010-02-01 10:32:08,2011-08-28 09:08:41,6917
119,1,23,143,"572 days, 22:56:47",2013-01-29 11:27:25,2010-02-01 10:32:08,2011-08-28 09:28:55,8122
346,13,70,429,"573 days, 2:07:01",2013-02-07 07:40:53,2010-03-10 07:24:22,2011-10-04 09:31:23,5523
295,1,78,374,"573 days, 14:53:15",2013-01-12 02:30:54,2010-02-01 10:32:08,2011-08-29 01:25:23,5895
3,0,20,23,"573 days, 19:54:46",2013-01-03 08:04:27,2010-02-01 10:32:08,2011-08-29 06:26:54,1810
239,7,77,323,"573 days, 23:47:39",2013-01-31 00:49:05,2010-02-01 10:32:08,2011-08-29 10:19:47,4253
499,4,6,509,"574 days, 16:36:30",2013-02-02 01:50:31,2010-02-01 10:32:08,2011-08-30 03:08:38,8955
401,2,10,413,"574 days, 17:04:11",2013-02-01 02:40:57,2010-02-01 10:32:08,2011-08-30 03:36:19,6633
135,1,23,159,"574 days, 20:50:13",2013-01-30 10:04:40,2010-02-01 10:32:08,2011-08-30 07:22:21,9889
1,0,0,1,"575 days, 0:09:01",2011-08-30 10:41:09,2010-02-01 10:32:08,2011-08-30 10:41:09,7582
17,0,7,24,"575 days, 21:11:19",2013-01-08 03:32:34,2010-02-01 10:32:08,2011-08-31 07:43:27,5995
7,0,80,87,"575 days, 23:24:54",2013-01-30 06:08:44,2010-02-01 10:32:08,2011-08-31 09:57:02,210
2,0,31,33,"576 days, 0:55:46",2013-01-29 01:52:38,2010-02-01 10:32:08,2011-08-31 11:27:54,7015
26,28,22,76,"577 days, 13:46:53",2013-02-06 01:29:06,2010-02-01 10:32:08,2011-09-02 00:19:01,1283
501,2,0,503,"577 days, 17:21:18",2013-01-31 09:45:50,2010-06-05 08:49:21,2012-01-04 02:10:39,7884
553,0,71,624,"578 days, 14:10:09",2013-01-28 00:35:41,2010-02-01 10:32:08,2011-09-03 00:42:17,17
725,3,98,826,"578 days, 15:47:37",2013-01-25 06:52:29,2010-02-01 10:32:08,2011-09-03 02:19:45,2054
306,1,0,307,"578 days, 19:05:35",2013-01-29 11:25:15,2010-02-01 10:32:08,2011-09-03 05:37:43,4590
0,0,32,32,"578 days, 22:38:27",2013-01-22 02:02:21,2010-02-01 10:32:08,2011-09-03 09:10:35,5104
11,0,2,13,"579 days, 14:20:03",2012-12-16 11:11:16,2010-02-01 10:32:08,2011-09-04 00:52:11,7650
662,0,57,719,"579 days, 14:52:59",2013-01-31 07:00:15,2010-02-01 10:32:08,2011-09-04 01:25:07,5742
342,1,21,364,"579 days, 19:42:22",2012-12-26 04:57:22,2010-02-01 10:32:08,2011-09-04 06:14:30,5119
16,5,33,54,"579 days, 21:45:48",2013-02-05 02:57:20,2010-02-01 10:32:08,2011-09-04 08:17:56,381
182,2,53,237,"580 days, 19:42:20",2013-01-31 10:18:04,2010-02-01 10:32:08,2011-09-05 06:14:28,8565
1,0,43,44,"580 days, 22:23:30",2013-01-26 06:55:53,2010-02-01 10:32:08,2011-09-05 08:55:38,9559
168,0,24,192,"580 days, 23:37:32",2013-01-27 00:16:55,2010-02-01 10:32:08,2011-09-05 10:09:40,3952
167,0,216,383,"581 days, 20:02:01",2013-01-27 06:49:11,2010-02-01 10:32:08,2011-09-06 06:34:09,2250
259,0,35,294,"582 days, 1:19:20",2013-01-31 00:58:44,2010-02-01 10:32:08,2011-09-06 11:51:28,1849
638,30,22,690,"583 days, 13:51:49",2013-01-31 09:35:59,2010-02-01 10:32:08,2011-09-08 00:23:57,7194
715,0,1,716,"583 days, 17:25:23",2013-01-19 10:59:10,2010-02-01 10:32:08,2011-09-08 03:57:31,3655
110,0,13,123,"583 days, 22:23:17",2013-01-30 00:51:40,2010-02-01 10:32:08,2011-09-08 08:55:25,977
22,0,6,28,"584 days, 17:10:36",2013-01-31 06:31:40,2010-02-01 10:32:08,2011-09-09 03:42:44,4953
375,0,0,375,"584 days, 21:54:14",2013-01-27 11:00:13,2010-02-01 10:32:08,2011-09-09 08:26:22,7796
3,4,106,113,"585 days, 0:31:23",2013-02-03 01:27:05,2010-02-01 10:32:08,2011-09-09 11:03:31,2530
74,0,180,254,"585 days, 17:40:31",2012-12-07 02:55:29,2010-02-01 10:32:08,2011-09-10 04:12:39,106
332,1,3,336,"585 days, 18:29:56",2013-01-31 08:49:56,2010-02-01 10:32:08,2011-09-10 05:02:04,3093
507,0,35,542,"585 days, 22:43:26",2013-01-29 05:51:37,2010-02-01 10:32:08,2011-09-10 09:15:34,9747
5,4,17,26,"586 days, 13:39:35",2013-02-06 01:40:43,2010-02-01 10:32:08,2011-09-11 00:11:43,2257
13,3,5,21,"586 days, 15:28:50",2013-02-01 01:40:30,2010-02-01 10:32:08,2011-09-11 02:00:58,6195
5,28,21,54,"586 days, 18:24:08",2013-02-02 06:36:50,2010-02-01 10:32:08,2011-09-11 04:56:16,8724
8,1,0,9,"586 days, 19:03:51",2013-01-30 02:22:47,2010-02-01 10:32:08,2011-09-11 05:35:59,6257
16,1,33,50,"587 days, 0:25:53",2013-01-25 10:42:54,2010-02-01 10:32:08,2011-09-11 10:58:01,8553
67,2,15,84,"587 days, 14:34:37",2013-02-06 11:23:07,2010-02-01 10:32:08,2011-09-12 01:06:45,7462
197,0,13,210,"587 days, 16:35:54",2013-01-28 09:06:01,2010-02-01 10:32:08,2011-09-12 03:08:02,1134
189,1,32,222,"587 days, 20:50:52",2013-01-28 07:54:03,2010-02-01 10:32:08,2011-09-12 07:23:00,671
7,0,2,9,"587 days, 21:52:07",2012-09-18 03:56:09,2010-02-01 10:32:08,2011-09-12 08:24:15,9841
14,2,0,16,"588 days, 7:58:39",2012-12-31 09:00:37,2010-05-06 01:20:04,2011-12-15 09:18:43,4458
223,1,2,226,"589 days, 0:07:37",2013-01-05 01:34:30,2010-02-01 10:32:08,2011-09-13 10:39:45,4898
465,0,22,487,"589 days, 13:27:57",2013-01-20 11:11:04,2010-02-01 10:32:08,2011-09-14 00:00:05,5389
576,0,37,613,"589 days, 16:24:05",2013-01-30 01:31:01,2010-02-01 10:32:08,2011-09-14 02:56:13,7674
590,1,0,591,"590 days, 1:02:06",2013-01-29 09:26:09,2010-02-01 10:32:08,2011-09-14 11:34:14,7038
591,33,45,669,"590 days, 14:36:40",2013-01-26 08:47:56,2010-02-01 10:32:08,2011-09-15 01:08:48,428
157,0,1,158,"590 days, 16:38:09",2013-01-24 01:45:20,2010-02-01 10:32:08,2011-09-15 03:10:17,2796
485,1,29,515,"590 days, 20:19:05",2013-02-04 08:32:30,2010-02-01 10:32:08,2011-09-15 06:51:13,3593
20,0,12,32,"593 days, 16:41:58",2013-01-16 10:59:33,2010-02-01 10:32:08,2011-09-18 03:14:06,7246
339,0,0,339,"593 days, 22:09:08",2013-01-26 00:39:00,2010-02-01 10:32:08,2011-09-18 08:41:16,5526
218,14,91,323,"594 days, 15:09:19",2013-01-28 03:30:46,2010-02-01 10:32:08,2011-09-19 01:41:27,6001
162,11,69,242,"594 days, 17:53:03",2013-02-05 05:31:06,2010-02-01 10:32:08,2011-09-19 04:25:11,2300
548,0,22,570,"594 days, 18:32:02",2013-01-30 04:41:11,2010-02-01 10:32:08,2011-09-19 05:04:10,2215
434,3,7,444,"595 days, 14:03:38",2013-02-01 05:21:24,2010-02-01 10:32:08,2011-09-20 00:35:46,8952
349,0,43,392,"595 days, 22:16:42",2013-01-26 09:51:26,2010-02-01 10:32:08,2011-09-20 08:48:50,3032
5,1,10,16,"595 days, 22:20:45",2012-11-27 03:28:25,2010-02-01 10:32:08,2011-09-20 08:52:53,1102
182,22,7,211,"596 days, 13:53:10",2013-01-23 01:46:56,2010-02-01 10:32:08,2011-09-21 00:25:18,1790
154,2,0,156,"598 days, 2:10:41",2013-01-02 05:38:21,2010-02-25 09:19:57,2011-10-16 11:30:38,9974
312,1,24,337,"598 days, 15:20:45",2013-02-01 10:23:55,2010-02-01 10:32:08,2011-09-23 01:52:53,1302
670,4,33,707,"599 days, 16:03:02",2013-01-17 07:23:49,2010-02-01 10:32:08,2011-09-24 02:35:10,6341
447,4,127,578,"599 days, 17:45:38",2013-02-07 05:08:54,2010-02-01 10:32:08,2011-09-24 04:17:46,8137
539,0,21,560,"599 days, 17:49:53",2013-02-01 02:20:49,2010-02-01 10:32:08,2011-09-24 04:22:01,8334
52,6,9,67,"599 days, 19:14:01",2013-01-27 11:07:01,2010-02-01 10:32:08,2011-09-24 05:46:09,1727
2,0,3,5,"599 days, 20:43:47",2012-09-09 07:58:55,2010-02-01 10:32:08,2011-09-24 07:15:55,4386
60,4,52,116,"601 days, 13:48:27",2013-02-03 08:41:58,2010-02-01 10:32:08,2011-09-26 00:20:35,3463
147,1,62,210,"601 days, 18:31:23",2013-01-29 03:25:37,2010-02-01 10:32:08,2011-09-26 05:03:31,1815
300,0,0,300,"602 days, 0:49:33",2013-01-16 03:48:05,2010-02-01 10:32:08,2011-09-26 11:21:41,3175
148,0,27,175,"602 days, 19:00:46",2013-02-06 05:58:42,2010-02-01 10:32:08,2011-09-27 05:32:54,4221
9,0,11,20,"603 days, 22:37:37",2012-12-23 08:04:40,2010-02-01 10:32:08,2011-09-28 09:09:45,9305
161,2,66,229,"604 days, 1:20:50",2013-02-03 07:08:15,2010-02-01 10:32:08,2011-09-28 11:52:58,8963
382,3,31,416,"604 days, 18:01:34",2013-02-02 06:10:07,2010-02-01 10:32:08,2011-09-29 04:33:42,1699
585,0,0,585,"604 days, 23:11:02",2013-01-31 09:35:52,2010-02-01 10:32:08,2011-09-29 09:43:10,5580
6,4,12,22,"605 days, 16:52:30",2013-02-05 11:08:11,2010-02-01 10:32:08,2011-09-30 03:24:38,1759
5,0,9,14,"606 days, 0:07:00",2012-11-16 11:02:15,2010-02-01 10:32:08,2011-09-30 10:39:08,1820
10,4,42,56,"606 days, 15:55:59",2013-02-08 08:36:47,2010-02-01 10:32:08,2011-10-01 02:28:07,1483
12,0,0,12,"606 days, 16:43:02",2012-09-22 03:20:42,2010-02-01 10:32:08,2011-10-01 03:15:10,7657
134,1,5,140,"606 days, 22:18:03",2013-02-01 07:02:46,2010-02-01 10:32:08,2011-10-01 08:50:11,4169
162,2,0,164,"607 days, 10:56:04",2013-01-30 05:29:32,2010-10-23 00:06:19,2012-06-21 11:02:23,4582
174,0,6,180,"607 days, 14:52:17",2013-01-24 05:08:21,2010-02-01 10:32:08,2011-10-02 01:24:25,1333
71,1,17,89,"607 days, 15:15:26",2013-02-03 07:22:30,2010-02-01 10:32:08,2011-10-02 01:47:34,2420
329,5,11,345,"607 days, 18:23:35",2013-02-02 07:14:05,2010-02-01 10:32:08,2011-10-02 04:55:43,4160
447,1,21,469,"607 days, 21:53:39",2013-01-23 03:41:17,2010-02-01 10:32:08,2011-10-02 08:25:47,391
480,3,0,483,"607 days, 23:10:09",2013-01-25 03:24:41,2010-02-01 10:32:08,2011-10-02 09:42:17,2440
1,0,6,7,"608 days, 5:15:06",2013-01-09 07:12:06,2010-12-17 03:53:10,2012-08-16 09:08:16,2727
355,2,4,361,"608 days, 17:16:00",2013-01-25 00:45:25,2010-02-01 10:32:08,2011-10-03 03:48:08,1
347,0,22,369,"608 days, 23:07:42",2013-02-04 10:14:47,2010-02-01 10:32:08,2011-10-03 09:39:50,4825
468,3,2,473,"609 days, 22:43:55",2013-02-01 08:52:54,2010-02-01 10:32:08,2011-10-04 09:16:03,3730
151,20,157,328,"610 days, 0:22:36",2013-02-04 01:17:32,2010-02-01 10:32:08,2011-10-04 10:54:44,2137
214,0,1,215,"613 days, 21:12:08",2013-01-11 01:20:06,2010-02-01 10:32:08,2011-10-08 07:44:16,7574
323,11,94,428,"613 days, 21:53:43",2013-02-05 07:08:12,2010-02-01 10:32:08,2011-10-08 08:25:51,2464
147,0,11,158,"614 days, 14:15:32",2013-02-01 10:16:35,2010-02-01 10:32:08,2011-10-09 00:47:40,1523
72,1,76,149,"614 days, 19:40:04",2013-01-31 00:58:37,2010-02-01 10:32:08,2011-10-09 06:12:12,1229
319,0,0,319,"614 days, 21:50:07",2013-01-31 00:09:35,2010-02-01 10:32:08,2011-10-09 08:22:15,2308
198,14,5,217,"614 days, 22:59:46",2013-01-23 03:36:53,2010-02-01 10:32:08,2011-10-09 09:31:54,2715
5,2,27,34,"614 days, 23:33:27",2013-02-03 04:58:03,2010-02-01 10:32:08,2011-10-09 10:05:35,7871
15,0,11,26,"616 days, 0:52:37",2013-02-03 09:23:09,2010-02-01 10:32:08,2011-10-10 11:24:45,4886
114,0,18,132,"616 days, 20:30:09",2013-01-28 04:47:22,2010-02-01 10:32:08,2011-10-11 07:02:17,8826
1,0,11,12,"617 days, 21:11:49",2013-01-30 09:32:24,2010-02-01 10:32:08,2011-10-12 07:43:57,8615
6,2,47,55,"618 days, 0:38:17",2013-02-04 10:43:57,2010-02-01 10:32:08,2011-10-12 11:10:25,8558
11,1,2,14,"618 days, 18:59:52",2013-02-05 01:58:29,2010-02-01 10:32:08,2011-10-13 05:32:00,9350
410,0,7,417,"619 days, 16:25:25",2013-01-31 03:14:49,2010-02-01 10:32:08,2011-10-14 02:57:33,7386
5,1,0,6,"619 days, 16:51:22",2012-09-11 08:56:31,2010-02-01 10:32:08,2011-10-14 03:23:30,8094
5,0,4,9,"619 days, 20:03:11",2012-12-19 10:14:36,2010-02-01 10:32:08,2011-10-14 06:35:19,6852
141,0,11,152,"619 days, 20:36:01",2013-01-19 10:14:33,2010-02-01 10:32:08,2011-10-14 07:08:09,2931
149,0,13,162,"619 days, 21:19:53",2013-01-19 04:15:24,2010-02-01 10:32:08,2011-10-14 07:52:01,2199
9,0,0,9,"619 days, 21:48:15",2013-01-11 07:01:48,2010-02-01 10:32:08,2011-10-14 08:20:23,4806
123,1,9,133,"620 days, 14:16:38",2013-01-17 09:00:07,2010-02-01 10:32:08,2011-10-15 00:48:46,4929
129,0,22,151,"620 days, 15:47:04",2013-02-03 08:52:43,2010-02-01 10:32:08,2011-10-15 02:19:12,6481
81,2,6,89,"620 days, 18:12:52",2013-01-01 09:50:15,2010-02-01 10:32:08,2011-10-15 04:45:00,3707
649,0,15,664,"620 days, 21:59:33",2013-01-15 09:52:47,2010-02-01 10:32:08,2011-10-15 08:31:41,2374
13,0,6,19,"620 days, 23:08:29",2013-02-03 07:15:55,2010-02-01 10:32:08,2011-10-15 09:40:37,8192
582,5,41,628,"622 days, 15:09:55",2013-01-30 08:03:13,2010-02-01 10:32:08,2011-10-17 01:42:03,8480
150,0,4,154,"622 days, 17:09:51",2013-01-21 00:01:23,2010-02-01 10:32:08,2011-10-17 03:41:59,7191
131,0,4,135,"622 days, 21:58:28",2013-01-15 02:51:55,2010-02-01 10:32:08,2011-10-17 08:30:36,6406
94,0,8,102,"622 days, 23:12:21",2013-01-28 09:23:56,2010-02-01 10:32:08,2011-10-17 09:44:29,4642
483,1,11,495,"623 days, 20:36:19",2013-01-30 00:56:15,2010-02-01 10:32:08,2011-10-18 07:08:27,3022
509,0,2,511,"623 days, 20:44:35",2013-01-25 07:06:22,2010-02-01 10:32:08,2011-10-18 07:16:43,6887
6,0,18,24,"624 days, 0:02:59",2013-01-28 02:42:58,2010-02-01 10:32:08,2011-10-18 10:35:07,4854
354,2,56,412,"624 days, 20:04:11",2013-01-31 09:45:09,2010-02-01 10:32:08,2011-10-19 06:36:19,2769
12,1,3,16,"625 days, 18:50:49",2013-02-04 10:42:11,2010-02-01 10:32:08,2011-10-20 05:22:57,9833
132,1,39,172,"625 days, 20:15:08",2013-01-26 08:58:05,2010-02-01 10:32:08,2011-10-20 06:47:16,9459
9,1,154,164,"626 days, 14:34:42",2013-01-20 01:40:30,2010-02-01 10:32:08,2011-10-21 01:06:50,7567
156,0,15,171,"626 days, 16:50:52",2013-02-05 00:18:54,2010-02-01 10:32:08,2011-10-21 03:23:00,963
1,0,17,18,"626 days, 19:48:39",2013-01-15 01:08:11,2010-02-01 10:32:08,2011-10-21 06:20:47,6819
116,0,2,118,"626 days, 23:04:44",2012-11-21 00:32:48,2010-02-01 10:32:08,2011-10-21 09:36:52,5401
6,1,15,22,"627 days, 1:08:33",2013-02-03 11:34:32,2010-02-01 10:32:08,2011-10-21 11:40:41,6061
424,1,22,447,"627 days, 21:07:03",2013-01-27 02:48:05,2010-02-01 10:32:08,2011-10-22 07:39:11,854
23,0,18,41,"627 days, 23:37:18",2013-01-31 07:24:10,2010-02-01 10:32:08,2011-10-22 10:09:26,3217
6,5,25,36,"628 days, 18:08:55",2013-02-04 10:28:36,2010-02-01 10:32:08,2011-10-23 04:41:03,1114
244,1,29,274,"629 days, 16:57:15",2013-01-21 07:44:44,2010-02-01 10:32:08,2011-10-24 03:29:23,4885
186,23,56,265,"630 days, 15:50:05",2013-01-25 10:22:56,2010-02-01 10:32:08,2011-10-25 02:22:13,4889
16,5,36,57,"632 days, 1:19:11",2013-01-31 02:46:21,2010-02-01 10:32:08,2011-10-26 11:51:19,7497
370,120,123,613,"633 days, 0:25:21",2013-02-04 08:42:44,2010-02-01 10:32:08,2011-10-27 10:57:29,9067
112,1,0,113,"633 days, 17:04:06",2013-01-19 11:26:34,2010-02-01 10:32:08,2011-10-28 03:36:14,3652
586,1,0,587,"633 days, 17:15:42",2013-01-17 03:37:18,2010-02-01 10:32:08,2011-10-28 03:47:50,9838
259,0,9,268,"633 days, 23:56:06",2013-01-29 09:39:03,2010-02-01 10:32:08,2011-10-28 10:28:14,242
4,2,22,28,"635 days, 18:08:00",2013-02-02 05:17:57,2010-02-01 10:32:08,2011-10-30 04:40:08,9050
426,0,0,426,"635 days, 19:29:09",2013-01-27 02:45:10,2010-02-01 10:32:08,2011-10-30 06:01:17,4391
72,5,60,137,"635 days, 23:57:56",2013-02-04 05:11:02,2010-02-01 10:32:08,2011-10-30 10:30:04,1760
251,0,13,264,"636 days, 14:21:08",2013-01-26 00:55:42,2010-02-01 10:32:08,2011-10-31 00:53:16,5405
6,1,17,24,"636 days, 19:10:28",2013-02-05 03:31:50,2010-02-01 10:32:08,2011-10-31 05:42:36,3531
277,0,21,298,"636 days, 23:23:26",2013-01-16 10:32:03,2010-02-01 10:32:08,2011-10-31 09:55:34,7992
5,3,0,8,"637 days, 8:49:14",2012-12-03 10:25:38,2010-10-03 02:17:54,2012-07-01 11:07:08,8624
338,2,18,358,"637 days, 20:38:55",2013-02-01 07:39:53,2010-02-01 10:32:08,2011-11-01 07:11:03,5122
143,0,7,150,"637 days, 23:12:01",2013-01-24 03:16:59,2010-02-01 10:32:08,2011-11-01 09:44:09,2288
8,88,143,239,"638 days, 19:30:19",2013-02-05 10:21:56,2010-02-01 10:32:08,2011-11-02 06:02:27,8440
531,3,0,534,"639 days, 16:44:52",2013-01-27 02:03:15,2010-03-14 08:51:46,2011-12-14 01:36:38,1389
142,38,320,500,"640 days, 13:56:31",2013-02-05 09:00:57,2010-02-01 10:32:08,2011-11-04 00:28:39,3353
450,4,15,469,"640 days, 20:41:16",2013-02-05 09:19:56,2010-02-01 10:32:08,2011-11-04 07:13:24,9084
32,14,45,91,"640 days, 22:29:57",2013-02-02 07:14:46,2010-10-09 04:40:08,2012-07-11 03:10:05,8678
2,1,7,10,"641 days, 2:43:13",2013-02-02 07:05:19,2010-11-18 07:38:26,2012-08-20 10:21:39,8625
2,27,85,114,"641 days, 14:51:43",2013-01-31 02:46:07,2010-02-01 10:32:08,2011-11-05 01:23:51,5252
133,4,27,164,"641 days, 17:34:20",2013-01-24 08:49:35,2010-02-01 10:32:08,2011-11-05 04:06:28,8036
301,1,9,311,"641 days, 20:48:51",2013-02-05 05:16:58,2010-02-01 10:32:08,2011-11-05 07:20:59,3837
142,1,2,145,"641 days, 23:29:47",2013-01-18 07:42:45,2010-04-24 02:09:11,2012-01-26 01:38:58,6791
147,5,18,170,"642 days, 15:26:24",2013-02-06 00:26:35,2010-02-01 10:32:08,2011-11-06 01:58:32,2382
333,0,17,350,"642 days, 22:40:38",2013-02-01 02:21:32,2010-02-01 10:32:08,2011-11-06 09:12:46,7719
562,4,0,566,"643 days, 22:01:19",2013-01-24 01:32:16,2010-02-01 10:32:08,2011-11-07 08:33:27,9410
90,0,11,101,"644 days, 1:20:13",2013-01-24 01:00:59,2010-02-01 10:32:08,2011-11-07 11:52:21,6666
134,0,11,145,"644 days, 19:14:48",2013-01-31 03:53:43,2010-02-01 10:32:08,2011-11-08 05:46:56,5213
290,0,7,297,"645 days, 21:55:51",2013-02-03 00:14:20,2010-02-01 10:32:08,2011-11-09 08:27:59,4788
161,3,17,181,"645 days, 22:00:41",2013-02-02 00:26:45,2010-02-01 10:32:08,2011-11-09 08:32:49,3011
475,0,7,482,"649 days, 19:01:45",2013-02-04 00:37:57,2010-02-01 10:32:08,2011-11-13 05:33:53,9088
166,0,10,176,"650 days, 0:58:46",2013-01-25 03:10:57,2010-02-01 10:32:08,2011-11-13 11:30:54,2693
1,0,10,11,"650 days, 19:25:19",2012-12-15 02:04:48,2010-02-01 10:32:08,2011-11-14 05:57:27,2598
293,0,0,293,"651 days, 19:27:15",2013-01-22 06:43:35,2010-02-01 10:32:08,2011-11-15 05:59:23,5127
130,7,45,182,"651 days, 19:38:46",2013-01-18 03:01:53,2010-02-01 10:32:08,2011-11-15 06:10:54,2557
600,0,7,607,"651 days, 23:12:39",2013-01-24 01:00:36,2010-02-01 10:32:08,2011-11-15 09:44:47,3940
385,27,21,433,"652 days, 17:12:33",2013-01-30 04:28:19,2010-02-01 10:32:08,2011-11-16 03:44:41,9598
3,1,30,34,"653 days, 15:27:22",2013-01-16 07:36:02,2010-02-01 10:32:08,2011-11-17 01:59:30,4841
3,4,73,80,"654 days, 0:32:10",2013-02-04 02:15:19,2010-02-01 10:32:08,2011-11-17 11:04:18,3920
4,0,14,18,"654 days, 18:04:32",2012-12-11 08:14:53,2010-02-01 10:32:08,2011-11-18 04:36:40,5257
0,1,7,8,"654 days, 18:42:20",2012-12-04 08:16:26,2010-02-01 10:32:08,2011-11-18 05:14:28,6778
248,2,57,307,"654 days, 23:12:51",2013-01-31 01:54:43,2010-02-01 10:32:08,2011-11-18 09:44:59,9252
168,0,16,184,"655 days, 14:33:22",2013-01-21 09:46:35,2010-02-01 10:32:08,2011-11-19 01:05:30,7049
275,1,6,282,"655 days, 22:02:32",2013-01-21 06:12:41,2010-02-01 10:32:08,2011-11-19 08:34:40,4551
524,0,6,530,"655 days, 23:50:56",2013-01-19 09:03:05,2010-02-01 10:32:08,2011-11-19 10:23:04,2270
537,0,10,547,"657 days, 0:23:16",2013-01-28 07:39:17,2010-02-01 10:32:08,2011-11-20 10:55:24,1679
540,0,0,540,"657 days, 13:48:39",2013-01-30 07:13:02,2010-02-01 10:32:08,2011-11-21 00:20:47,7698
51,3,30,84,"659 days, 13:51:38",2013-01-25 00:48:57,2010-02-01 10:32:08,2011-11-23 00:23:46,4811
287,0,0,287,"659 days, 15:08:28",2013-01-20 10:12:22,2010-02-01 10:32:08,2011-11-23 01:40:36,7971
4,0,0,4,"660 days, 0:21:49",2013-01-15 06:21:56,2010-02-01 10:32:08,2011-11-23 10:53:57,4305
591,0,4,595,"660 days, 19:10:23",2013-01-31 07:45:03,2010-02-01 10:32:08,2011-11-24 05:42:31,5126
499,0,0,499,"661 days, 13:39:56",2013-01-27 00:58:55,2010-02-01 10:32:08,2011-11-25 00:12:04,6950
99,1,20,120,"661 days, 15:36:00",2013-01-30 00:44:54,2010-02-01 10:32:08,2011-11-25 02:08:08,8795
4,0,12,16,"661 days, 17:48:23",2013-01-07 00:54:17,2010-02-01 10:32:08,2011-11-25 04:20:31,25
453,0,0,453,"662 days, 0:55:04",2013-01-31 01:24:38,2010-02-01 10:32:08,2011-11-25 11:27:12,235
233,1,0,234,"662 days, 15:11:22",2013-01-27 11:23:59,2010-02-01 10:32:08,2011-11-26 01:43:30,7908
59,5,79,143,"662 days, 16:32:18",2013-01-30 01:48:50,2010-02-01 10:32:08,2011-11-26 03:04:26,9517
289,1,38,328,"663 days, 18:01:07",2013-02-05 02:24:02,2010-02-01 10:32:08,2011-11-27 04:33:15,9971
493,3,12,508,"663 days, 20:53:49",2013-01-28 09:17:16,2010-02-01 10:32:08,2011-11-27 07:25:57,3485
410,0,0,410,"665 days, 0:33:05",2013-01-27 02:18:43,2010-02-01 10:32:08,2011-11-28 11:05:13,4297
288,0,0,288,"665 days, 21:30:15",2013-01-07 06:47:24,2010-02-01 10:32:08,2011-11-29 08:02:23,3884
167,2,83,252,"665 days, 22:05:30",2013-01-30 09:46:27,2010-02-01 10:32:08,2011-11-29 08:37:38,8143
227,1,0,228,"665 days, 23:27:56",2013-01-20 11:22:03,2010-02-01 10:32:08,2011-11-29 10:00:04,2514
186,0,8,194,"666 days, 23:56:46",2013-01-12 06:29:41,2010-02-01 10:32:08,2011-11-30 10:28:54,2416
109,0,24,133,"667 days, 19:01:48",2013-02-06 04:01:15,2010-02-01 10:32:08,2011-12-01 05:33:56,267
152,0,3,155,"668 days, 13:52:19",2013-01-31 02:14:46,2010-02-01 10:32:08,2011-12-02 00:24:27,7774
174,0,6,180,"668 days, 16:35:49",2013-01-20 06:10:24,2010-02-01 10:32:08,2011-12-02 03:07:57,2272
284,9,57,350,"669 days, 15:35:44",2013-01-28 02:09:11,2010-02-01 10:32:08,2011-12-03 02:07:52,9234
234,0,0,234,"670 days, 15:12:36",2012-12-24 00:47:22,2010-02-01 10:32:08,2011-12-04 01:44:44,201
192,1,23,216,"670 days, 18:34:11",2013-01-26 08:25:06,2010-02-01 10:32:08,2011-12-04 05:06:19,3180
5,2,9,16,"670 days, 18:38:04",2013-02-07 06:07:13,2010-02-01 10:32:08,2011-12-04 05:10:12,1044
522,6,23,551,"671 days, 13:40:28",2013-02-03 02:18:31,2010-02-01 10:32:08,2011-12-05 00:12:36,4377
143,7,11,161,"671 days, 14:28:22",2013-01-30 08:36:30,2010-02-01 10:32:08,2011-12-05 01:00:30,486
2,4,15,21,"673 days, 15:59:17",2013-01-30 05:43:41,2010-02-01 10:32:08,2011-12-07 02:31:25,3293
299,0,4,303,"673 days, 17:39:31",2013-01-30 04:24:17,2010-02-01 10:32:08,2011-12-07 04:11:39,1029
36,0,3,39,"673 days, 18:22:21",2013-01-27 08:18:31,2010-02-01 10:32:08,2011-12-07 04:54:29,1828
380,0,10,390,"673 days, 20:31:45",2013-01-29 04:22:12,2010-02-01 10:32:08,2011-12-07 07:03:53,400
20,1,0,21,"673 days, 22:22:35",2013-01-23 01:17:53,2010-02-01 10:32:08,2011-12-07 08:54:43,5585
5,0,8,13,"675 days, 16:56:24",2013-01-30 01:04:36,2010-02-01 10:32:08,2011-12-09 03:28:32,1020
528,0,15,543,"675 days, 22:50:59",2013-01-09 10:03:58,2010-02-01 10:32:08,2011-12-09 09:23:07,7644
146,0,0,146,"676 days, 0:48:25",2012-12-17 10:59:51,2010-02-01 10:32:08,2011-12-09 11:20:33,3176
462,0,3,465,"676 days, 14:40:23",2013-02-01 05:43:54,2010-02-01 10:32:08,2011-12-10 01:12:31,9308
371,1,0,372,"676 days, 23:07:45",2013-01-28 07:47:38,2010-02-01 10:32:08,2011-12-10 09:39:53,764
417,6,36,459,"678 days, 14:08:58",2013-02-04 03:09:59,2010-02-01 10:32:08,2011-12-12 00:41:06,9352
167,0,0,167,"678 days, 19:09:57",2013-01-01 00:38:05,2010-02-01 10:32:08,2011-12-12 05:42:05,6283
6,3,36,45,"681 days, 20:53:37",2013-02-06 04:34:47,2010-02-01 10:32:08,2011-12-15 07:25:45,7426
152,1,9,162,"681 days, 23:45:01",2013-01-13 01:28:16,2010-02-01 10:32:08,2011-12-15 10:17:09,5978
136,1,0,137,"683 days, 0:34:41",2013-01-11 05:58:34,2010-02-01 10:32:08,2011-12-16 11:06:49,8606
504,0,1,505,"683 days, 18:51:58",2013-01-31 09:32:21,2010-02-01 10:32:08,2011-12-17 05:24:06,3871
281,7,63,351,"683 days, 19:31:57",2013-02-04 01:29:04,2010-02-01 10:32:08,2011-12-17 06:04:05,1658
237,0,3,240,"684 days, 21:00:28",2013-02-02 05:40:47,2010-02-01 10:32:08,2011-12-18 07:32:36,7186
602,2,12,616,"685 days, 0:58:18",2013-01-29 02:33:16,2010-02-01 10:32:08,2011-12-18 11:30:26,8019
132,11,79,222,"685 days, 17:00:37",2013-01-25 02:45:01,2010-02-01 10:32:08,2011-12-19 03:32:45,9165
186,0,17,203,"685 days, 19:56:02",2013-01-30 02:42:36,2010-02-01 10:32:08,2011-12-19 06:28:10,2580
244,5,25,274,"686 days, 19:33:43",2013-02-02 06:34:45,2010-02-01 10:32:08,2011-12-20 06:05:51,2456
2,0,35,37,"686 days, 22:55:05",2013-02-01 09:14:19,2010-02-01 10:32:08,2011-12-20 09:27:13,5214
401,7,12,420,"687 days, 13:58:02",2013-01-31 06:18:09,2010-02-01 10:32:08,2011-12-21 00:30:10,6660
26,0,6,32,"687 days, 22:45:08",2013-01-30 10:47:28,2010-02-01 10:32:08,2011-12-21 09:17:16,730
412,1,9,422,"689 days, 0:18:19",2013-01-12 08:11:45,2010-02-01 10:32:08,2011-12-22 10:50:27,1888
215,1,0,216,"689 days, 16:17:55",2013-01-29 09:09:23,2010-02-01 10:32:08,2011-12-23 02:50:03,6417
496,0,0,496,"691 days, 15:31:45",2013-01-23 11:37:04,2010-02-01 10:32:08,2011-12-25 02:03:53,4615
494,0,0,494,"691 days, 17:26:23",2013-01-28 09:21:10,2010-02-01 10:32:08,2011-12-25 03:58:31,2169
491,0,5,496,"691 days, 18:51:15",2013-01-29 04:26:16,2010-02-01 10:32:08,2011-12-25 05:23:23,5616
77,4,38,119,"691 days, 23:08:54",2013-01-29 02:35:10,2010-02-01 10:32:08,2011-12-25 09:41:02,5947
415,0,13,428,"692 days, 14:58:05",2013-02-02 10:38:32,2010-02-01 10:32:08,2011-12-26 01:30:13,1346
11,0,10,21,"692 days, 23:18:20",2013-01-11 09:36:10,2010-02-01 10:32:08,2011-12-26 09:50:28,8454
402,1,31,434,"693 days, 18:22:53",2013-02-01 09:17:38,2010-02-01 10:32:08,2011-12-27 04:55:01,7461
1,0,20,21,"693 days, 20:06:13",2013-01-31 09:33:08,2010-02-01 10:32:08,2011-12-27 06:38:21,8984
7,0,0,7,"694 days, 1:13:09",2013-01-13 04:43:02,2010-02-01 10:32:08,2011-12-27 11:45:17,6888
481,3,95,579,"694 days, 15:46:57",2013-01-31 03:02:27,2010-02-01 10:32:08,2011-12-28 02:19:05,9496
87,5,39,131,"694 days, 18:30:31",2013-01-24 05:13:41,2010-02-01 10:32:08,2011-12-28 05:02:39,4151
220,0,0,220,"694 days, 20:40:26",2013-01-13 06:53:47,2010-02-01 10:32:08,2011-12-28 07:12:34,5243
2,0,6,8,"694 days, 21:37:39",2013-01-15 06:56:13,2010-02-01 10:32:08,2011-12-28 08:09:47,4539
259,0,3,262,"695 days, 19:43:51",2013-01-31 07:45:57,2010-02-01 10:32:08,2011-12-29 06:15:59,536
10,0,18,28,"695 days, 19:46:55",2013-01-08 03:34:46,2010-02-01 10:32:08,2011-12-29 06:19:03,3579
429,1,21,451,"696 days, 23:41:47",2013-01-24 01:30:42,2010-02-01 10:32:08,2011-12-30 10:13:55,2907
233,0,0,233,"698 days, 23:54:12",2013-01-30 05:56:56,2010-02-01 10:32:08,2012-01-01 10:26:20,6226
22,0,25,47,"699 days, 1:27:08",2013-01-12 00:48:47,2010-02-01 10:32:08,2012-01-01 11:59:16,1882
0,1,0,1,"699 days, 22:12:50",2012-01-02 08:44:58,2010-02-01 10:32:08,2012-01-02 08:44:58,9325
476,0,4,480,"700 days, 19:15:04",2013-01-21 01:35:50,2010-02-01 10:32:08,2012-01-03 05:47:12,7137
0,2,17,19,"700 days, 20:23:10",2012-11-05 07:49:35,2010-02-01 10:32:08,2012-01-03 06:55:18,7338
215,3,1,219,"701 days, 20:15:12",2013-01-28 01:03:19,2010-05-04 05:26:31,2012-04-05 01:41:43,7837
9,1,6,16,"702 days, 19:27:51",2013-02-05 03:15:57,2010-02-01 10:32:08,2012-01-05 05:59:59,313
28,25,224,277,"703 days, 1:18:37",2013-01-31 02:55:50,2010-02-01 10:32:08,2012-01-05 11:50:45,1583
113,1,16,130,"703 days, 15:05:17",2013-01-31 01:50:06,2010-02-01 10:32:08,2012-01-06 01:37:25,5098
74,4,0,78,"704 days, 6:03:13",2013-01-22 06:43:26,2010-12-18 04:43:17,2012-11-21 10:46:30,3396
164,0,10,174,"704 days, 19:22:26",2013-01-14 10:30:01,2010-02-01 10:32:08,2012-01-07 05:54:34,4213
266,12,176,454,"705 days, 15:14:09",2013-02-14 11:30:46,2010-02-01 10:32:08,2012-01-08 01:46:17,6259
277,0,0,277,"705 days, 22:29:38",2013-01-24 05:09:03,2010-02-01 10:32:08,2012-01-08 09:01:46,7240
242,17,8,267,"706 days, 0:20:06",2013-02-05 11:47:12,2010-02-01 10:32:08,2012-01-08 10:52:14,8165
460,1,9,470,"706 days, 1:15:44",2013-01-31 01:39:08,2010-02-01 10:32:08,2012-01-08 11:47:52,2949
124,0,9,133,"706 days, 17:36:03",2013-02-04 07:17:30,2010-02-01 10:32:08,2012-01-09 04:08:11,6058
240,0,0,240,"706 days, 19:08:14",2013-01-12 08:34:01,2010-02-01 10:32:08,2012-01-09 05:40:22,8131
4,0,14,18,"706 days, 23:18:54",2013-01-12 07:06:14,2010-02-01 10:32:08,2012-01-09 09:51:02,8989
83,8,0,91,"707 days, 0:23:00",2013-01-09 11:59:08,2010-03-14 10:40:51,2012-02-19 11:03:51,5367
494,0,4,498,"707 days, 14:39:15",2013-01-23 08:30:54,2010-02-01 10:32:08,2012-01-10 01:11:23,5900
117,4,9,130,"707 days, 22:21:22",2013-02-06 04:21:44,2010-02-01 10:32:08,2012-01-10 08:53:30,8331
4,1,39,44,"707 days, 22:52:55",2013-02-03 11:14:08,2010-02-01 10:32:08,2012-01-10 09:25:03,999
62,34,65,161,"709 days, 20:29:09",2013-02-02 07:01:09,2010-02-01 10:32:08,2012-01-12 07:01:17,7772
1,1,32,34,"709 days, 20:38:54",2013-01-27 01:33:10,2010-02-01 10:32:08,2012-01-12 07:11:02,8739
437,0,0,437,"709 days, 23:13:29",2013-01-07 06:16:51,2010-02-01 10:32:08,2012-01-12 09:45:37,9399
264,0,0,264,"710 days, 23:46:24",2012-12-21 10:11:19,2010-02-01 10:32:08,2012-01-13 10:18:32,4368
241,1,4,246,"711 days, 22:51:52",2013-01-26 02:14:24,2010-02-01 10:32:08,2012-01-14 09:24:00,1008
20,0,24,44,"712 days, 15:53:25",2013-01-25 05:30:34,2010-02-01 10:32:08,2012-01-15 02:25:33,1845
77,2,31,110,"713 days, 21:17:35",2013-02-06 09:08:28,2010-02-01 10:32:08,2012-01-16 07:49:43,3845
503,1,12,516,"714 days, 22:16:04",2013-01-31 08:01:31,2010-02-01 10:32:08,2012-01-17 08:48:12,3358
66,5,9,80,"715 days, 18:32:15",2013-01-31 04:08:53,2010-02-01 10:32:08,2012-01-18 05:04:23,3822
477,0,2,479,"716 days, 18:06:31",2013-01-30 07:16:32,2010-02-01 10:32:08,2012-01-19 04:38:39,7127
37,1,31,69,"716 days, 20:06:07",2013-02-01 01:23:26,2010-02-01 10:32:08,2012-01-19 06:38:15,6076
205,0,6,211,"716 days, 23:00:59",2013-01-27 02:39:06,2010-02-01 10:32:08,2012-01-19 09:33:07,5594
499,0,2,501,"716 days, 23:49:15",2013-01-11 07:47:21,2010-02-01 10:32:08,2012-01-19 10:21:23,2837
3,4,130,137,"717 days, 15:11:36",2013-02-02 02:05:43,2010-02-01 10:32:08,2012-01-20 01:43:44,5400
228,0,8,236,"717 days, 20:11:55",2013-01-08 10:20:38,2010-02-01 10:32:08,2012-01-20 06:44:03,8934
260,3,0,263,"717 days, 20:30:39",2013-01-20 07:52:05,2010-02-01 10:32:08,2012-01-20 07:02:47,7617
83,1,0,84,"718 days, 20:30:05",2013-01-25 03:26:24,2010-02-01 10:32:08,2012-01-21 07:02:13,7776
171,2,25,198,"719 days, 1:06:53",2013-01-25 11:46:35,2010-02-01 10:32:08,2012-01-21 11:39:01,7632
437,0,5,442,"719 days, 13:59:03",2013-01-28 07:32:28,2010-02-01 10:32:08,2012-01-22 00:31:11,5186
420,1,12,433,"719 days, 16:24:04",2013-01-23 01:10:09,2010-02-01 10:32:08,2012-01-22 02:56:12,2543
14,12,13,39,"721 days, 17:14:06",2013-02-01 00:15:34,2010-02-01 10:32:08,2012-01-24 03:46:14,8713
108,0,3,111,"722 days, 0:27:40",2013-01-20 07:31:03,2010-02-01 10:32:08,2012-01-24 10:59:48,7420
1,2,0,3,"722 days, 20:13:57",2013-01-31 06:14:38,2011-02-08 10:00:41,2013-01-31 06:14:38,1166
42,2,20,64,"722 days, 20:42:30",2013-02-01 01:45:21,2010-02-01 10:32:08,2012-01-25 07:14:38,4164
250,0,0,250,"723 days, 22:51:44",2013-01-30 00:53:49,2010-02-01 10:32:08,2012-01-26 09:23:52,5462
3,0,12,15,"724 days, 18:46:21",2013-02-04 10:06:12,2010-02-01 10:32:08,2012-01-27 05:18:29,7315
350,0,0,350,"724 days, 19:19:39",2013-01-28 00:54:50,2010-02-01 10:32:08,2012-01-27 05:51:47,6899
418,0,4,422,"724 days, 21:52:09",2013-01-08 07:17:01,2010-02-01 10:32:08,2012-01-27 08:24:17,6821
7,0,10,17,"724 days, 21:56:56",2013-01-19 11:45:34,2010-02-01 10:32:08,2012-01-27 08:29:04,769
28,2,25,55,"724 days, 22:05:22",2013-01-23 10:58:00,2010-02-01 10:32:08,2012-01-27 08:37:30,1823
161,0,0,161,"724 days, 23:56:05",2013-01-21 06:44:50,2010-02-01 10:32:08,2012-01-27 10:28:13,5424
97,0,9,106,"726 days, 15:22:44",2013-01-31 11:12:30,2010-02-01 10:32:08,2012-01-29 01:54:52,2184
82,6,65,153,"726 days, 16:57:48",2013-01-26 03:11:49,2010-02-01 10:32:08,2012-01-29 03:29:56,936
161,1,13,175,"727 days, 15:54:05",2013-02-07 06:15:09,2010-02-01 10:32:08,2012-01-30 02:26:13,5850
36,0,12,48,"727 days, 16:04:41",2013-02-03 09:35:00,2010-02-01 10:32:08,2012-01-30 02:36:49,2224
122,0,1,123,"729 days, 0:41:30",2013-02-02 04:16:30,2010-02-01 10:32:08,2012-01-31 11:13:38,6003
164,3,0,167,"729 days, 17:01:57",2013-01-26 10:09:38,2010-08-18 09:21:27,2012-08-17 02:23:24,2455
1,0,10,11,"729 days, 18:02:56",2013-01-12 10:33:36,2010-02-01 10:32:08,2012-02-01 04:35:04,3288
303,0,0,303,"729 days, 20:22:00",2012-12-25 06:24:19,2010-02-01 10:32:08,2012-02-01 06:54:08,3047
265,1,6,272,"730 days, 23:59:21",2013-01-31 01:29:02,2010-02-01 10:32:08,2012-02-02 10:31:29,5992
6,0,4,10,"731 days, 17:28:22",2012-12-02 10:59:36,2010-02-01 10:32:08,2012-02-03 04:00:30,898
39,74,24,137,"731 days, 18:33:42",2013-02-01 09:20:49,2010-02-01 10:32:08,2012-02-03 05:05:50,9188
429,1,7,437,"732 days, 17:19:12",2013-02-03 06:20:10,2010-02-01 10:32:08,2012-02-04 03:51:20,5736
129,10,15,154,"733 days, 14:16:52",2013-01-28 06:37:03,2010-02-01 10:32:08,2012-02-05 00:49:00,3267
241,1,12,254,"733 days, 15:36:21",2013-01-29 04:43:53,2010-02-01 10:32:08,2012-02-05 02:08:29,1859
216,0,15,231,"733 days, 21:31:07",2013-01-25 07:21:05,2010-02-01 10:32:08,2012-02-05 08:03:15,3888
220,1,13,234,"734 days, 14:51:41",2013-01-13 03:42:48,2010-02-01 10:32:08,2012-02-06 01:23:49,8238
360,0,0,360,"734 days, 17:21:29",2013-01-22 08:42:26,2010-02-01 10:32:08,2012-02-06 03:53:37,7623
136,0,0,136,"734 days, 22:20:55",2013-01-22 03:09:21,2010-02-01 10:32:08,2012-02-06 08:53:03,7002
4,1,0,5,"735 days, 23:50:43",2012-11-04 01:20:41,2010-02-01 10:32:08,2012-02-07 10:22:51,3563
439,0,9,448,"736 days, 15:02:52",2013-01-27 06:57:42,2010-02-01 10:32:08,2012-02-08 01:35:00,8231
170,1,6,177,"736 days, 18:19:08",2013-01-31 09:58:49,2010-02-01 10:32:08,2012-02-08 04:51:16,9120
316,1,4,321,"737 days, 19:17:12",2013-01-29 07:52:13,2010-02-01 10:32:08,2012-02-09 05:49:20,4314
20,4,104,128,"737 days, 19:29:48",2013-02-04 05:01:19,2010-02-01 10:32:08,2012-02-09 06:01:56,5869
464,0,2,466,"737 days, 21:58:08",2013-02-06 08:58:48,2010-02-01 10:32:08,2012-02-09 08:30:16,5686
7,0,4,11,"738 days, 20:44:39",2013-02-05 02:23:32,2010-02-01 10:32:08,2012-02-10 07:16:47,8471
347,0,0,347,"738 days, 21:17:11",2013-01-30 08:20:02,2010-02-01 10:32:08,2012-02-10 07:49:19,9066
5,0,17,22,"739 days, 0:30:30",2013-01-04 02:21:08,2010-02-01 10:32:08,2012-02-10 11:02:38,4939
82,1,11,94,"739 days, 18:29:13",2013-01-22 10:50:05,2010-02-01 10:32:08,2012-02-11 05:01:21,9309
147,13,18,178,"739 days, 19:42:06",2013-01-25 11:12:14,2010-02-01 10:32:08,2012-02-11 06:14:14,3549
245,0,3,248,"739 days, 21:45:36",2013-01-27 07:08:14,2010-02-01 10:32:08,2012-02-11 08:17:44,137
346,1,4,351,"740 days, 13:53:44",2013-01-24 06:19:21,2010-02-01 10:32:08,2012-02-12 00:25:52,3725
317,0,24,341,"740 days, 17:47:13",2013-02-06 02:29:47,2010-02-01 10:32:08,2012-02-12 04:19:21,9364
0,0,6,6,"741 days, 18:50:56",2013-01-15 10:01:37,2010-02-01 10:32:08,2012-02-13 05:23:04,6475
132,1,0,133,"742 days, 0:10:53",2013-01-19 07:29:07,2010-02-01 10:32:08,2012-02-13 10:43:01,9624
13,2,55,70,"742 days, 0:52:38",2013-01-29 11:40:09,2010-02-01 10:32:08,2012-02-13 11:24:46,2779
453,0,0,453,"742 days, 14:16:54",2013-01-24 07:04:21,2010-02-01 10:32:08,2012-02-14 00:49:02,87
151,0,15,166,"742 days, 19:35:52",2013-01-30 00:07:00,2010-02-01 10:32:08,2012-02-14 06:08:00,9544
169,1,32,202,"742 days, 21:29:57",2013-01-31 00:21:53,2010-02-01 10:32:08,2012-02-14 08:02:05,6018
205,0,6,211,"742 days, 21:38:27",2013-01-23 05:50:57,2010-02-01 10:32:08,2012-02-14 08:10:35,6539
137,4,15,156,"744 days, 22:23:56",2013-01-31 10:07:38,2010-02-01 10:32:08,2012-02-16 08:56:04,4222
225,1,8,234,"747 days, 13:35:31",2013-01-29 05:32:46,2010-02-01 10:32:08,2012-02-19 00:07:39,7996
310,0,0,310,"748 days, 16:03:51",2013-01-31 05:10:13,2010-02-01 10:32:08,2012-02-20 02:35:59,7976
117,1,0,118,"748 days, 20:42:17",2013-01-24 05:11:24,2010-02-01 10:32:08,2012-02-20 07:14:25,4945
160,5,3,168,"748 days, 22:40:26",2013-02-02 00:36:00,2010-02-01 10:32:08,2012-02-20 09:12:34,4448
2,0,0,2,"749 days, 16:19:52",2013-01-07 04:56:34,2010-02-01 10:32:08,2012-02-21 02:52:00,561
401,0,0,401,"749 days, 17:27:06",2013-01-29 10:59:30,2010-02-01 10:32:08,2012-02-21 03:59:14,5605
124,2,18,144,"749 days, 23:56:22",2013-02-02 09:06:18,2010-02-01 10:32:08,2012-02-21 10:28:30,887
135,0,0,135,"750 days, 13:39:12",2012-12-28 03:58:06,2010-02-01 10:32:08,2012-02-22 00:11:20,7241
187,0,10,197,"750 days, 19:23:36",2013-01-02 05:12:21,2010-02-01 10:32:08,2012-02-22 05:55:44,8773
3,1,1,5,"750 days, 20:02:10",2013-01-26 07:06:12,2010-02-01 10:32:08,2012-02-22 06:34:18,3698
154,0,4,158,"750 days, 22:59:43",2013-01-04 09:50:17,2010-02-01 10:32:08,2012-02-22 09:31:51,8669
97,3,0,100,"751 days, 1:32:03",2012-12-26 04:42:02,2010-03-08 08:22:36,2012-03-28 09:54:39,8407
92,3,10,105,"751 days, 16:00:02",2013-01-27 00:55:00,2010-02-01 10:32:08,2012-02-23 02:32:10,7734
82,1,11,94,"752 days, 18:16:32",2013-01-28 07:30:26,2010-02-01 10:32:08,2012-02-24 04:48:40,9201
139,1,7,147,"752 days, 23:22:52",2013-01-31 10:11:15,2010-02-01 10:32:08,2012-02-24 09:55:00,4064
91,2,0,93,"753 days, 22:53:08",2012-12-21 01:25:26,2010-02-01 10:32:08,2012-02-25 09:25:16,9041
1,0,30,31,"754 days, 18:01:16",2013-02-03 08:23:19,2010-02-01 10:32:08,2012-02-26 04:33:24,2349
382,4,40,426,"755 days, 17:52:27",2013-01-31 07:53:01,2010-02-01 10:32:08,2012-02-27 04:24:35,6187
303,0,5,308,"755 days, 20:43:56",2013-01-24 03:56:07,2010-02-01 10:32:08,2012-02-27 07:16:04,2627
35,1,44,80,"757 days, 16:26:11",2013-02-02 10:53:04,2010-02-01 10:32:08,2012-02-29 02:58:19,5192
395,34,4,433,"759 days, 13:52:26",2013-01-26 00:14:30,2010-02-01 10:32:08,2012-03-02 00:24:34,3981
219,0,3,222,"759 days, 23:07:46",2013-02-02 03:20:36,2010-02-01 10:32:08,2012-03-02 09:39:54,32
360,3,13,376,"760 days, 15:43:00",2013-01-26 10:19:44,2010-02-01 10:32:08,2012-03-03 02:15:08,3414
1,0,20,21,"762 days, 17:26:11",2013-01-10 07:00:22,2010-02-01 10:32:08,2012-03-05 03:58:19,6296
0,1,53,54,"762 days, 19:43:11",2013-01-28 04:06:19,2010-02-01 10:32:08,2012-03-05 06:15:19,8753
189,2,5,196,"762 days, 22:20:33",2013-01-20 07:59:06,2010-05-31 09:08:52,2012-07-02 07:29:25,6022
1,1,3,5,"763 days, 18:44:21",2013-01-11 08:23:06,2010-02-01 10:32:08,2012-03-06 05:16:29,5113
210,0,3,213,"763 days, 20:26:08",2013-02-02 09:35:48,2010-02-01 10:32:08,2012-03-06 06:58:16,7620
12,21,34,67,"764 days, 17:21:34",2013-01-31 02:19:09,2010-02-01 10:32:08,2012-03-07 03:53:42,6967
3,0,5,8,"766 days, 13:31:36",2013-01-25 06:53:05,2010-02-01 10:32:08,2012-03-09 00:03:44,6293
56,0,16,72,"766 days, 15:28:46",2013-02-02 11:27:08,2010-02-01 10:32:08,2012-03-09 02:00:54,2179
119,0,5,124,"766 days, 21:03:14",2013-01-22 09:38:46,2010-02-01 10:32:08,2012-03-09 07:35:22,2447
104,2,8,114,"768 days, 13:32:33",2013-01-27 09:12:36,2010-02-01 10:32:08,2012-03-11 00:04:41,4137
4,0,10,14,"768 days, 18:50:10",2013-01-30 09:40:54,2010-02-01 10:32:08,2012-03-11 05:22:18,6853
23,3,5,31,"769 days, 15:13:58",2013-01-25 07:20:05,2010-02-01 10:32:08,2012-03-12 01:46:06,2329
6,0,6,12,"769 days, 21:39:20",2013-01-21 07:52:29,2010-02-01 10:32:08,2012-03-12 08:11:28,1979
1,1,13,15,"770 days, 1:14:52",2013-01-25 05:47:10,2010-02-01 10:32:08,2012-03-12 11:47:00,7304
18,7,9,34,"771 days, 17:39:07",2013-02-04 07:01:43,2010-02-01 10:32:08,2012-03-14 04:11:15,9053
437,0,0,437,"771 days, 19:45:47",2013-01-21 05:34:28,2010-02-01 10:32:08,2012-03-14 06:17:55,5684
179,0,5,184,"773 days, 15:03:42",2013-01-16 05:11:13,2010-02-01 10:32:08,2012-03-16 01:35:50,433
212,0,6,218,"774 days, 17:34:20",2013-01-17 09:36:31,2010-02-01 10:32:08,2012-03-17 04:06:28,1702
380,9,18,407,"775 days, 0:33:31",2013-01-31 07:29:11,2010-02-01 10:32:08,2012-03-17 11:05:39,2325
207,1,1,209,"776 days, 21:59:11",2013-01-19 11:04:16,2010-02-01 10:32:08,2012-03-19 08:31:19,2612
238,0,0,238,"779 days, 14:41:42",2013-01-22 00:30:22,2010-02-01 10:32:08,2012-03-22 01:13:50,478
4,0,0,4,"779 days, 17:06:12",2012-12-31 08:20:08,2010-02-01 10:32:08,2012-03-22 03:38:20,5552
213,0,0,213,"779 days, 19:48:32",2013-01-23 07:37:10,2010-02-01 10:32:08,2012-03-22 06:20:40,9454
9,0,0,9,"780 days, 0:52:32",2013-01-30 09:35:11,2010-02-01 10:32:08,2012-03-22 11:24:40,1105
1,0,17,18,"780 days, 15:21:38",2013-01-31 11:54:42,2010-02-01 10:32:08,2012-03-23 01:53:46,9381
9,0,0,9,"780 days, 21:42:10",2012-12-17 11:09:46,2010-02-01 10:32:08,2012-03-23 08:14:18,8397
4,6,24,34,"781 days, 16:50:22",2013-01-29 03:38:00,2010-02-01 10:32:08,2012-03-24 03:22:30,4265
259,1,10,270,"782 days, 13:59:58",2013-02-03 10:54:30,2010-02-01 10:32:08,2012-03-25 00:32:06,2059
110,1,22,133,"782 days, 15:19:16",2013-02-18 00:12:32,2010-02-01 10:32:08,2012-03-25 01:51:24,2070
60,31,14,105,"782 days, 22:03:57",2013-02-04 09:26:28,2010-02-01 10:32:08,2012-03-25 08:36:05,9720
109,0,6,115,"783 days, 14:19:13",2013-01-29 03:15:20,2010-02-01 10:32:08,2012-03-26 00:51:21,2024
171,0,2,173,"784 days, 16:39:08",2013-01-26 06:41:11,2010-02-01 10:32:08,2012-03-27 03:11:16,3612
23,3,13,39,"784 days, 21:11:16",2013-01-06 08:10:27,2010-02-01 10:32:08,2012-03-27 07:43:24,2610
210,3,11,224,"785 days, 0:54:24",2013-01-29 03:26:52,2010-02-01 10:32:08,2012-03-27 11:26:32,8024
0,1,41,42,"785 days, 20:21:37",2013-01-31 01:43:50,2010-02-01 10:32:08,2012-03-28 06:53:45,4298
0,2,0,2,"788 days, 1:54:29",2011-01-04 03:31:11,2011-01-04 03:31:11,2013-03-02 05:25:40,1651
270,0,63,333,"789 days, 16:12:13",2013-01-25 07:53:11,2010-02-01 10:32:08,2012-04-01 02:44:21,392
34,2,32,68,"790 days, 18:36:18",2013-01-29 07:07:57,2010-02-01 10:32:08,2012-04-02 05:08:26,2164
140,0,2,142,"790 days, 21:50:50",2013-01-16 05:14:56,2010-02-01 10:32:08,2012-04-02 08:22:58,7956
2,0,1,3,"792 days, 20:33:58",2012-11-25 00:48:32,2010-02-01 10:32:08,2012-04-04 07:06:06,1622
6,0,15,21,"793 days, 14:52:06",2013-01-26 11:11:11,2010-02-01 10:32:08,2012-04-05 01:24:14,1585
0,0,14,14,"795 days, 18:00:31",2013-01-10 01:57:00,2010-02-01 10:32:08,2012-04-07 04:32:39,5730
62,6,1,69,"796 days, 18:50:09",2013-01-30 03:41:36,2010-02-18 07:11:06,2012-04-25 02:01:15,431
7,0,0,7,"797 days, 14:05:41",2012-12-03 02:45:46,2010-02-01 10:32:08,2012-04-09 00:37:49,7329
151,2,28,181,"798 days, 22:58:30",2013-01-30 02:45:45,2010-02-01 10:32:08,2012-04-10 09:30:38,4140
1,1,2,4,"799 days, 16:07:32",2012-12-04 01:14:12,2010-02-01 10:32:08,2012-04-11 02:39:40,807
465,1,2,468,"799 days, 19:02:08",2013-01-31 01:31:57,2010-02-01 10:32:08,2012-04-11 05:34:16,7272
147,5,4,156,"800 days, 4:14:33",2013-01-19 11:35:06,2010-06-28 06:22:08,2012-09-05 10:36:41,8500
293,0,3,296,"800 days, 19:22:49",2013-01-30 04:01:27,2010-02-01 10:32:08,2012-04-12 05:54:57,5973
275,0,0,275,"800 days, 22:31:04",2013-01-24 07:50:42,2010-02-01 10:32:08,2012-04-12 09:03:12,4008
309,1,31,341,"801 days, 18:05:31",2013-02-02 01:25:52,2010-02-01 10:32:08,2012-04-13 04:37:39,6473
177,1,23,201,"801 days, 19:26:17",2013-01-23 08:36:53,2010-02-01 10:32:08,2012-04-13 05:58:25,774
389,0,0,389,"801 days, 22:30:52",2013-01-23 02:44:57,2010-02-01 10:32:08,2012-04-13 09:03:00,7519
26,2,18,46,"803 days, 20:20:14",2013-01-29 04:14:21,2010-02-01 10:32:08,2012-04-15 06:52:22,6108
391,5,39,435,"803 days, 22:48:50",2013-01-24 00:01:04,2010-02-01 10:32:08,2012-04-15 09:20:58,1227
201,30,7,238,"803 days, 23:57:25",2013-01-24 01:38:59,2010-02-01 10:32:08,2012-04-15 10:29:33,1509
263,13,28,304,"805 days, 20:28:08",2013-01-28 09:30:16,2010-02-01 10:32:08,2012-04-17 07:00:16,5317
323,0,2,325,"807 days, 19:05:32",2013-01-26 10:54:13,2010-02-01 10:32:08,2012-04-19 05:37:40,1834
129,3,12,144,"808 days, 1:09:29",2013-02-12 11:01:37,2010-02-01 10:32:08,2012-04-19 11:41:37,1295
303,1,0,304,"809 days, 13:35:51",2013-01-25 07:36:26,2010-02-01 10:32:08,2012-04-21 00:07:59,4897
32,23,13,68,"809 days, 16:08:57",2013-01-29 03:05:01,2010-02-01 10:32:08,2012-04-21 02:41:05,1071
367,1,5,373,"811 days, 20:01:00",2013-01-26 06:13:10,2010-02-01 10:32:08,2012-04-23 06:33:08,8177
1,1,3,5,"812 days, 22:52:50",2013-01-23 10:20:18,2010-02-01 10:32:08,2012-04-24 09:24:58,4356
5,0,0,5,"813 days, 0:34:44",2012-12-20 04:47:22,2010-02-01 10:32:08,2012-04-24 11:06:52,4925
294,0,5,299,"816 days, 14:03:02",2013-01-31 11:55:34,2010-02-01 10:32:08,2012-04-28 00:35:10,8394
60,6,59,125,"817 days, 1:08:10",2013-02-02 05:31:43,2010-02-01 10:32:08,2012-04-28 11:40:18,9481
223,0,5,228,"820 days, 16:05:39",2013-01-17 03:51:12,2010-02-01 10:32:08,2012-05-02 02:37:47,1477
291,1,0,292,"820 days, 18:46:21",2013-01-25 03:43:13,2010-02-01 10:32:08,2012-05-02 05:18:29,9804
32,0,4,36,"820 days, 20:48:36",2013-01-31 04:55:14,2010-02-01 10:32:08,2012-05-02 07:20:44,4223
14,0,7,21,"821 days, 13:47:57",2013-02-03 02:50:05,2010-02-01 10:32:08,2012-05-03 00:20:05,7685
342,0,6,348,"821 days, 16:20:09",2013-01-11 00:20:26,2010-02-01 10:32:08,2012-05-03 02:52:17,8894
37,3,25,65,"821 days, 20:56:56",2013-02-07 09:11:38,2010-02-01 10:32:08,2012-05-03 07:29:04,1398
66,0,2,68,"821 days, 22:47:49",2013-01-24 06:10:00,2010-02-01 10:32:08,2012-05-03 09:19:57,1100
68,0,4,72,"822 days, 13:47:49",2013-01-26 11:43:50,2010-02-01 10:32:08,2012-05-04 00:19:57,6408
162,0,0,162,"822 days, 18:31:24",2013-01-23 01:08:07,2010-02-01 10:32:08,2012-05-04 05:03:32,9514
111,0,4,115,"822 days, 21:08:37",2013-01-28 05:09:03,2010-02-01 10:32:08,2012-05-04 07:40:45,374
357,0,0,357,"823 days, 0:34:23",2013-01-30 09:03:48,2010-02-01 10:32:08,2012-05-04 11:06:31,6999
163,0,17,180,"825 days, 18:39:44",2013-01-26 09:55:33,2010-02-01 10:32:08,2012-05-07 05:11:52,4244
239,0,0,239,"826 days, 21:03:27",2013-01-23 08:44:43,2010-02-01 10:32:08,2012-05-08 07:35:35,1781
164,1,10,175,"827 days, 15:57:21",2013-01-29 03:13:26,2010-02-01 10:32:08,2012-05-09 02:29:29,6491
346,0,1,347,"828 days, 16:21:01",2013-02-03 09:44:12,2010-02-01 10:32:08,2012-05-10 02:53:09,3908
3,49,13,65,"829 days, 21:23:45",2013-02-04 01:15:20,2010-02-01 10:32:08,2012-05-11 07:55:53,6651
92,0,2,94,"831 days, 16:56:19",2013-01-30 03:39:51,2010-02-01 10:32:08,2012-05-13 03:28:27,3921
82,0,0,82,"832 days, 20:02:50",2013-01-18 00:51:55,2010-02-01 10:32:08,2012-05-14 06:34:58,3240
368,0,0,368,"833 days, 22:36:49",2013-01-20 11:29:37,2010-02-01 10:32:08,2012-05-15 09:08:57,3586
346,0,0,346,"834 days, 19:27:00",2013-01-30 05:43:06,2010-02-01 10:32:08,2012-05-16 05:59:08,2107
243,0,2,245,"835 days, 18:46:07",2013-01-25 04:16:27,2010-02-01 10:32:08,2012-05-17 05:18:15,8512
27,0,5,32,"835 days, 19:47:32",2013-01-27 09:12:00,2010-02-01 10:32:08,2012-05-17 06:19:40,9441
2,10,29,41,"836 days, 19:46:23",2013-02-06 00:34:07,2010-02-01 10:32:08,2012-05-18 06:18:31,8208
102,2,3,107,"837 days, 19:42:47",2013-01-28 11:39:45,2010-02-01 10:32:08,2012-05-19 06:14:55,4958
81,1,3,85,"840 days, 14:31:10",2013-01-17 07:25:58,2010-02-01 10:32:08,2012-05-22 01:03:18,6581
5,0,1,6,"840 days, 15:45:47",2012-12-09 11:18:49,2010-02-01 10:32:08,2012-05-22 02:17:55,4672
54,1,5,60,"840 days, 15:56:08",2013-01-21 04:29:48,2010-02-01 10:32:08,2012-05-22 02:28:16,4230
17,2,15,34,"840 days, 20:56:46",2013-01-31 04:35:36,2010-02-01 10:32:08,2012-05-22 07:28:54,2516
128,0,0,128,"840 days, 22:57:03",2013-01-30 11:36:42,2010-02-01 10:32:08,2012-05-22 09:29:11,3533
132,0,12,144,"841 days, 17:32:01",2013-02-02 07:17:03,2010-02-01 10:32:08,2012-05-23 04:04:09,3992
4,2,8,14,"841 days, 18:06:13",2013-01-20 00:37:12,2010-02-01 10:32:08,2012-05-23 04:38:21,7336
247,0,3,250,"841 days, 19:23:33",2013-02-01 02:36:13,2010-02-01 10:32:08,2012-05-23 05:55:41,3697
3,1,0,4,"843 days, 22:51:49",2012-10-02 08:36:49,2010-02-01 10:32:08,2012-05-25 09:23:57,7831
6,0,10,16,"844 days, 21:15:39",2013-01-31 02:45:48,2010-02-01 10:32:08,2012-05-26 07:47:47,215
196,0,3,199,"845 days, 0:20:50",2013-01-27 11:03:54,2010-02-01 10:32:08,2012-05-26 10:52:58,4421
7,2,16,25,"847 days, 0:37:21",2013-01-26 00:59:45,2010-02-01 10:32:08,2012-05-28 11:09:29,8570
1,1,2,4,"847 days, 19:04:32",2013-01-14 11:46:48,2010-02-01 10:32:08,2012-05-29 05:36:40,8431
304,0,0,304,"848 days, 15:53:40",2013-01-31 07:51:18,2010-02-01 10:32:08,2012-05-30 02:25:48,6027
362,0,10,372,"848 days, 16:31:18",2013-01-28 05:42:02,2010-02-01 10:32:08,2012-05-30 03:03:26,2668
96,0,0,96,"851 days, 0:33:13",2012-12-19 02:07:02,2010-02-01 10:32:08,2012-06-01 11:05:21,7362
84,3,69,156,"852 days, 14:49:55",2013-01-28 02:47:47,2010-02-01 10:32:08,2012-06-03 01:22:03,4022
81,0,2,83,"854 days, 22:33:11",2013-02-03 10:16:54,2010-02-01 10:32:08,2012-06-05 09:05:19,8429
2,1,5,8,"856 days, 23:13:22",2013-01-07 06:35:25,2010-06-17 02:21:18,2012-10-21 01:34:40,6838
94,79,9,182,"857 days, 17:23:29",2013-02-14 10:56:32,2010-02-01 10:32:08,2012-06-08 03:55:37,5483
250,0,9,259,"857 days, 23:43:57",2013-01-27 01:53:25,2010-02-01 10:32:08,2012-06-08 10:16:05,961
184,0,1,185,"859 days, 23:02:19",2013-01-31 11:54:23,2010-02-01 10:32:08,2012-06-10 09:34:27,2952
58,1,8,67,"859 days, 23:24:55",2013-01-30 07:58:57,2010-02-01 10:32:08,2012-06-10 09:57:03,1573
149,0,0,149,"860 days, 20:34:33",2013-01-31 06:23:35,2010-02-01 10:32:08,2012-06-11 07:06:41,9663
175,0,15,190,"861 days, 20:51:41",2013-01-27 11:56:01,2010-02-01 10:32:08,2012-06-12 07:23:49,6095
211,0,1,212,"863 days, 14:11:42",2013-01-22 00:24:04,2010-02-01 10:32:08,2012-06-14 00:43:50,3279
286,0,0,286,"863 days, 21:00:49",2013-01-31 03:57:35,2010-02-01 10:32:08,2012-06-14 07:32:57,2935
155,1,9,165,"865 days, 14:18:17",2013-02-04 09:20:20,2010-02-01 10:32:08,2012-06-16 00:50:25,6416
5,0,43,48,"865 days, 20:12:37",2013-01-29 07:58:43,2010-02-01 10:32:08,2012-06-16 06:44:45,3249
108,0,0,108,"865 days, 21:14:00",2013-01-31 05:15:08,2010-02-01 10:32:08,2012-06-16 07:46:08,1065
33,1,5,39,"866 days, 15:07:26",2013-01-27 05:33:20,2010-02-01 10:32:08,2012-06-17 01:39:34,2577
89,0,0,89,"866 days, 21:27:34",2012-12-29 09:28:51,2010-02-01 10:32:08,2012-06-17 07:59:42,7979
54,17,12,83,"866 days, 23:45:51",2013-02-01 04:29:58,2010-02-01 10:32:08,2012-06-17 10:17:59,952
233,0,9,242,"867 days, 0:42:05",2013-01-24 11:52:32,2010-02-01 10:32:08,2012-06-17 11:14:13,7094
120,0,0,120,"868 days, 15:51:45",2013-01-05 04:38:08,2010-02-01 10:32:08,2012-06-19 02:23:53,2341
54,0,8,62,"869 days, 0:05:31",2013-01-28 00:31:08,2010-02-01 10:32:08,2012-06-19 10:37:39,3300
179,0,0,179,"869 days, 22:53:11",2013-01-23 10:43:12,2010-02-01 10:32:08,2012-06-20 09:25:19,6348
4,3,3,10,"871 days, 20:33:46",2013-01-22 04:44:49,2010-02-01 10:32:08,2012-06-22 07:05:54,9977
132,0,1,133,"872 days, 14:42:52",2013-01-29 05:13:15,2010-02-01 10:32:08,2012-06-23 01:15:00,1157
3,0,6,9,"872 days, 16:05:37",2013-01-19 08:48:10,2010-02-01 10:32:08,2012-06-23 02:37:45,4621
224,3,6,233,"873 days, 15:30:32",2013-01-27 02:12:22,2010-02-01 10:32:08,2012-06-24 02:02:40,6589
35,5,22,62,"873 days, 23:51:36",2013-02-05 10:50:37,2010-02-01 10:32:08,2012-06-24 10:23:44,7448
177,0,4,181,"874 days, 18:05:35",2013-01-29 02:00:03,2010-02-01 10:32:08,2012-06-25 04:37:43,3716
183,0,45,228,"876 days, 15:00:41",2013-02-03 07:33:51,2010-02-01 10:32:08,2012-06-27 01:32:49,3879
345,0,0,345,"877 days, 0:17:32",2013-01-31 10:52:39,2010-02-01 10:32:08,2012-06-27 10:49:40,2331
158,11,1,170,"879 days, 22:37:41",2013-01-29 03:59:50,2010-02-01 10:32:08,2012-06-30 09:09:49,8812
4,0,0,4,"881 days, 16:57:04",2013-01-28 04:37:32,2010-02-01 10:32:08,2012-07-02 03:29:12,4478
3,0,0,3,"882 days, 21:53:26",2012-11-19 00:55:08,2010-02-01 10:32:08,2012-07-03 08:25:34,6627
300,0,0,300,"883 days, 0:05:40",2013-01-30 06:48:53,2010-02-01 10:32:08,2012-07-03 10:37:48,9831
25,1,16,42,"885 days, 21:52:12",2013-01-30 08:31:50,2010-02-01 10:32:08,2012-07-06 08:24:20,6800
303,0,0,303,"886 days, 19:41:46",2013-01-27 00:40:50,2010-02-01 10:32:08,2012-07-07 06:13:54,2402
90,10,73,173,"887 days, 1:09:57",2013-02-06 06:01:32,2010-02-01 10:32:08,2012-07-07 11:42:05,8138
278,0,0,278,"888 days, 19:15:56",2013-01-28 11:17:08,2010-02-01 10:32:08,2012-07-09 05:48:04,9443
2,3,13,18,"890 days, 19:16:40",2013-01-26 10:15:39,2010-06-06 09:44:35,2012-11-13 05:01:15,371
5,1,3,9,"890 days, 21:26:18",2013-02-02 02:25:24,2010-02-01 10:32:08,2012-07-11 07:58:26,1103
68,1,0,69,"890 days, 23:52:11",2013-01-21 08:42:47,2010-02-01 10:32:08,2012-07-11 10:24:19,2793
160,0,2,162,"891 days, 16:23:02",2013-01-16 10:47:35,2010-02-01 10:32:08,2012-07-12 02:55:10,912
259,0,0,259,"893 days, 1:00:36",2013-01-30 07:59:47,2010-02-01 10:32:08,2012-07-13 11:32:44,7789
4,2,0,6,"893 days, 23:08:53",2012-12-21 03:44:57,2010-02-01 10:32:08,2012-07-14 09:41:01,3836
168,0,0,168,"895 days, 20:35:28",2013-01-29 00:12:26,2010-02-01 10:32:08,2012-07-16 07:07:36,2632
33,0,5,38,"897 days, 14:55:48",2013-01-22 03:28:35,2010-02-01 10:32:08,2012-07-18 01:27:56,1379
234,0,0,234,"898 days, 15:07:18",2013-01-25 09:30:12,2010-02-01 10:32:08,2012-07-19 01:39:26,8958
109,0,1,110,"898 days, 19:35:37",2013-01-24 09:59:52,2010-02-01 10:32:08,2012-07-19 06:07:45,4362
120,0,0,120,"902 days, 15:52:52",2012-12-16 03:58:15,2010-02-01 10:32:08,2012-07-23 02:25:00,5902
21,2,28,51,"904 days, 17:39:24",2013-02-04 03:58:19,2010-02-01 10:32:08,2012-07-25 04:11:32,4410
104,13,19,136,"904 days, 23:08:51",2013-02-05 02:20:35,2010-02-01 10:32:08,2012-07-25 09:40:59,3654
257,0,0,257,"905 days, 0:35:18",2013-01-26 09:02:35,2010-02-01 10:32:08,2012-07-25 11:07:26,5234
11,10,7,28,"905 days, 20:11:50",2013-02-06 06:01:32,2010-02-01 10:32:08,2012-07-26 06:43:58,9737
263,1,0,264,"906 days, 17:37:07",2013-01-29 02:33:44,2010-02-01 10:32:08,2012-07-27 04:09:15,1430
99,0,0,99,"907 days, 22:58:33",2013-01-27 07:25:40,2010-02-01 10:32:08,2012-07-28 09:30:41,909
139,16,25,180,"908 days, 17:56:52",2013-02-03 04:51:42,2010-02-01 10:32:08,2012-07-29 04:29:00,1079
186,1,5,192,"908 days, 19:35:26",2013-01-21 00:25:47,2010-02-01 10:32:08,2012-07-29 06:07:34,5996
11,0,16,27,"910 days, 21:01:38",2013-01-14 11:47:58,2010-02-01 10:32:08,2012-07-31 07:33:46,6320
233,0,0,233,"911 days, 19:18:50",2013-01-14 05:59:22,2010-02-01 10:32:08,2012-08-01 05:50:58,6335
89,0,3,92,"911 days, 19:36:44",2013-01-14 01:21:51,2010-02-01 10:32:08,2012-08-01 06:08:52,5803
183,0,0,183,"911 days, 23:42:50",2013-01-09 05:44:02,2010-02-01 10:32:08,2012-08-01 10:14:58,5590
71,0,3,74,"912 days, 0:02:28",2013-02-03 11:39:46,2010-02-01 10:32:08,2012-08-01 10:34:36,4225
0,1,4,5,"912 days, 21:11:58",2013-01-28 11:44:16,2010-02-01 10:32:08,2012-08-02 07:44:06,4732
86,0,0,86,"914 days, 13:32:06",2012-09-27 09:37:29,2010-02-01 10:32:08,2012-08-04 00:04:14,3603
76,0,0,76,"914 days, 19:46:25",2013-01-22 05:53:49,2010-02-01 10:32:08,2012-08-04 06:18:33,9960
213,0,0,213,"914 days, 20:17:34",2013-01-29 07:11:35,2010-02-01 10:32:08,2012-08-04 06:49:42,1737
153,0,2,155,"915 days, 0:37:21",2013-01-29 07:13:02,2010-02-01 10:32:08,2012-08-04 11:09:29,3631
84,2,0,86,"915 days, 22:47:39",2013-01-08 01:37:29,2010-02-01 10:32:08,2012-08-05 09:19:47,6199
2,0,0,2,"916 days, 22:51:03",2012-08-18 11:11:29,2010-02-01 10:32:08,2012-08-06 09:23:11,628
1,0,2,3,"916 days, 23:30:31",2012-11-03 05:35:00,2010-02-01 10:32:08,2012-08-06 10:02:39,1272
151,1,2,154,"917 days, 23:56:22",2013-01-28 10:49:41,2010-02-01 10:32:08,2012-08-07 10:28:30,6324
153,0,0,153,"919 days, 0:34:05",2013-01-27 05:40:47,2010-02-01 10:32:08,2012-08-08 11:06:13,3861
200,0,0,200,"920 days, 21:50:59",2013-01-18 07:16:49,2010-02-01 10:32:08,2012-08-10 08:23:07,6121
15,0,12,27,"921 days, 18:09:39",2013-02-02 01:50:33,2010-02-01 10:32:08,2012-08-11 04:41:47,2307
211,0,0,211,"923 days, 13:48:40",2013-01-27 05:01:22,2010-02-01 10:32:08,2012-08-13 00:20:48,470
158,0,0,158,"923 days, 17:19:59",2013-01-28 08:13:26,2010-02-01 10:32:08,2012-08-13 03:52:07,8550
0,0,6,6,"923 days, 17:39:58",2013-01-17 06:36:05,2010-02-01 10:32:08,2012-08-13 04:12:06,1124
7,0,2,9,"924 days, 21:25:56",2013-01-06 00:47:07,2010-02-01 10:32:08,2012-08-14 07:58:04,5813
211,3,0,214,"925 days, 15:44:32",2013-01-22 09:19:24,2010-02-21 08:51:32,2012-09-04 00:36:04,1268
2,0,0,2,"925 days, 20:40:06",2012-09-01 09:34:04,2010-02-01 10:32:08,2012-08-15 07:12:14,5697
39,0,6,45,"926 days, 15:15:54",2013-01-15 05:17:29,2010-02-01 10:32:08,2012-08-16 01:48:02,7991
112,0,0,112,"927 days, 0:57:47",2013-01-21 09:00:42,2010-02-01 10:32:08,2012-08-16 11:29:55,2692
62,0,1,63,"927 days, 19:02:56",2012-12-12 06:15:40,2010-02-01 10:32:08,2012-08-17 05:35:04,6397
171,1,3,175,"927 days, 22:53:26",2013-01-28 02:20:37,2010-02-01 10:32:08,2012-08-17 09:25:34,8598
26,6,12,44,"928 days, 18:23:27",2013-02-02 10:24:06,2010-02-01 10:32:08,2012-08-18 04:55:35,1334
31,0,9,40,"934 days, 1:12:32",2013-02-01 04:27:08,2010-02-01 10:32:08,2012-08-23 11:44:40,4550
187,0,0,187,"934 days, 13:41:28",2013-01-28 07:00:49,2010-02-01 10:32:08,2012-08-24 00:13:36,2297
3,0,7,10,"934 days, 17:35:30",2012-12-29 11:14:59,2010-02-01 10:32:08,2012-08-24 04:07:38,5923
193,0,1,194,"935 days, 16:38:33",2013-01-15 06:50:46,2010-02-01 10:32:08,2012-08-25 03:10:41,1423
105,0,0,105,"936 days, 14:12:40",2013-01-08 08:19:17,2010-02-01 10:32:08,2012-08-26 00:44:48,4181
5,2,5,12,"944 days, 13:42:49",2013-02-06 03:56:49,2010-02-01 10:32:08,2012-09-03 00:14:57,8088
1,2,0,3,"946 days, 5:42:43",2012-12-04 06:15:24,2010-05-03 00:32:41,2012-12-04 06:15:24,3829
6,0,9,15,"948 days, 23:45:43",2013-01-16 04:12:41,2010-02-01 10:32:08,2012-09-07 10:17:51,3212
2,0,5,7,"950 days, 20:10:03",2012-12-21 07:10:27,2010-02-01 10:32:08,2012-09-09 06:42:11,4545
28,1,0,29,"954 days, 6:18:18",2013-01-13 07:30:42,2010-04-12 04:23:03,2012-11-21 10:41:21,3505
13,0,13,26,"954 days, 20:45:41",2013-01-28 05:17:51,2010-02-01 10:32:08,2012-09-13 07:17:49,2337
2,0,0,2,"956 days, 1:22:43",2012-10-21 00:53:56,2010-02-01 10:32:08,2012-09-14 11:54:51,3000
46,0,4,50,"957 days, 14:19:09",2013-01-27 03:52:30,2010-02-01 10:32:08,2012-09-16 00:51:17,8191
103,0,0,103,"957 days, 20:35:08",2013-01-22 03:08:03,2010-02-01 10:32:08,2012-09-16 07:07:16,3417
176,0,0,176,"957 days, 21:49:39",2013-01-29 01:51:38,2010-02-01 10:32:08,2012-09-16 08:21:47,2709
136,0,0,136,"959 days, 0:28:39",2013-01-30 09:52:04,2010-02-01 10:32:08,2012-09-17 11:00:47,75
49,0,0,49,"959 days, 18:33:25",2013-01-29 01:43:10,2010-02-01 10:32:08,2012-09-18 05:05:33,8883
2,0,0,2,"960 days, 1:07:47",2012-10-17 06:58:51,2010-02-01 10:32:08,2012-09-18 11:39:55,3703
34,10,5,49,"962 days, 15:34:35",2013-01-19 08:30:09,2010-02-01 10:32:08,2012-09-21 02:06:43,5461
15,0,2,17,"962 days, 16:28:24",2013-01-27 06:51:56,2010-02-01 10:32:08,2012-09-21 03:00:32,8029
57,0,0,57,"962 days, 23:50:44",2012-12-24 00:53:17,2010-02-01 10:32:08,2012-09-21 10:22:52,5672
102,1,0,103,"963 days, 16:16:10",2013-01-31 08:40:25,2010-02-01 10:32:08,2012-09-22 02:48:18,5755
149,0,0,149,"965 days, 21:24:55",2013-01-26 05:44:55,2010-02-01 10:32:08,2012-09-24 07:57:03,5721
130,0,0,130,"966 days, 15:25:42",2013-01-21 04:02:07,2010-02-01 10:32:08,2012-09-25 01:57:50,4981
118,0,0,118,"967 days, 21:53:09",2013-01-20 02:48:05,2010-02-01 10:32:08,2012-09-26 08:25:17,7286
185,0,4,189,"968 days, 0:42:41",2013-01-23 06:11:08,2010-02-01 10:32:08,2012-09-26 11:14:49,148
2,0,3,5,"968 days, 14:17:07",2013-01-05 02:37:01,2010-02-01 10:32:08,2012-09-27 00:49:15,3007
82,0,0,82,"972 days, 0:46:19",2013-01-31 07:43:13,2010-02-01 10:32:08,2012-09-30 11:18:27,5459
122,0,0,122,"972 days, 15:30:48",2013-01-28 11:49:50,2010-02-01 10:32:08,2012-10-01 02:02:56,7202
1,1,3,5,"972 days, 21:47:16",2013-01-31 03:40:16,2010-02-01 10:32:08,2012-10-01 08:19:24,8959
3,0,10,13,"973 days, 21:48:47",2013-02-03 11:15:38,2010-02-01 10:32:08,2012-10-02 08:20:55,3946
14,5,7,26,"975 days, 0:59:07",2013-01-26 10:41:03,2010-02-01 10:32:08,2012-10-03 11:31:15,5967
49,0,5,54,"976 days, 20:22:34",2013-01-27 00:26:01,2010-02-01 10:32:08,2012-10-05 06:54:42,2722
22,1,11,34,"977 days, 23:30:44",2013-01-27 09:46:34,2010-02-01 10:32:08,2012-10-06 10:02:52,7223
146,0,3,149,"980 days, 21:00:52",2013-01-28 03:26:11,2010-02-01 10:32:08,2012-10-09 07:33:00,4616
5,1,8,14,"981 days, 22:36:24",2013-01-07 11:50:44,2010-02-01 10:32:08,2012-10-10 09:08:32,4927
131,2,8,141,"982 days, 19:38:04",2013-02-02 08:27:01,2010-02-01 10:32:08,2012-10-11 06:10:12,757
164,0,0,164,"983 days, 13:52:42",2013-01-30 05:07:24,2010-02-01 10:32:08,2012-10-12 00:24:50,6171
0,2,3,5,"984 days, 17:38:38",2013-02-04 05:57:47,2010-02-01 10:32:08,2012-10-13 04:10:46,190
37,0,0,37,"986 days, 15:18:17",2013-01-31 04:49:19,2010-02-01 10:32:08,2012-10-15 01:50:25,3994
188,5,3,196,"992 days, 1:10:29",2013-01-17 10:04:31,2010-02-01 10:32:08,2012-10-20 11:42:37,9436
18,0,7,25,"992 days, 20:32:22",2013-01-31 01:26:42,2010-02-01 10:32:08,2012-10-21 07:04:30,9832
12,1,0,13,"993 days, 18:03:45",2013-01-27 02:46:45,2010-05-09 08:42:49,2013-01-27 02:46:34,1363
2,1,2,5,"993 days, 18:26:47",2013-02-03 02:32:52,2010-02-01 10:32:08,2012-10-22 04:58:55,6724
18,0,0,18,"996 days, 18:46:41",2013-01-15 06:01:01,2010-02-01 10:32:08,2012-10-25 05:18:49,9587
70,0,0,70,"1000 days, 0:48:46",2013-01-22 02:28:34,2010-02-01 10:32:08,2012-10-28 11:20:54,2291
1,1,0,2,"1000 days, 18:09:33",2013-01-22 06:25:59,2010-02-01 10:32:08,2012-10-29 04:41:41,7394
2,0,0,2,"1000 days, 18:44:08",2012-11-02 00:09:16,2010-02-01 10:32:08,2012-10-29 05:16:16,9941
22,1,2,25,"1000 days, 21:22:07",2013-01-08 04:56:49,2010-02-01 10:32:08,2012-10-29 07:54:15,2937
46,0,4,50,"1000 days, 23:06:10",2013-02-02 11:34:20,2010-02-01 10:32:08,2012-10-29 09:38:18,289
127,0,0,127,"1002 days, 18:10:10",2013-01-10 03:01:14,2010-02-01 10:32:08,2012-10-31 04:42:18,5541
1,0,1,2,"1003 days, 19:16:26",2012-11-21 04:58:15,2010-02-01 10:32:08,2012-11-01 05:48:34,3686
52,1,0,53,"1004 days, 15:45:15",2012-12-30 03:45:30,2010-02-01 10:32:08,2012-11-02 02:17:23,247
24,1,0,25,"1005 days, 17:11:05",2013-01-26 08:59:52,2010-02-01 10:32:08,2012-11-03 03:43:13,6213
105,0,0,105,"1005 days, 22:24:09",2013-01-31 00:40:07,2010-02-01 10:32:08,2012-11-03 08:56:17,4023
2,0,0,2,"1008 days, 14:07:11",2012-12-03 10:25:12,2010-02-01 10:32:08,2012-11-06 00:39:19,3720
2,0,4,6,"1018 days, 14:54:58",2013-02-01 09:55:05,2010-02-01 10:32:08,2012-11-16 01:27:06,5882
74,0,0,74,"1018 days, 17:05:04",2012-12-26 03:48:00,2010-02-01 10:32:08,2012-11-16 03:37:12,3040
38,0,0,38,"1024 days, 18:45:07",2013-01-13 04:14:22,2010-02-01 10:32:08,2012-11-22 05:17:15,1433
0,0,11,11,"1025 days, 1:25:39",2013-01-29 10:08:29,2010-02-01 10:32:08,2012-11-22 11:57:47,2531
37,0,8,45,"1025 days, 17:56:28",2013-01-31 00:18:02,2010-02-01 10:32:08,2012-11-23 04:28:36,4263
61,0,0,61,"1027 days, 23:56:48",2013-01-31 05:36:08,2010-02-01 10:32:08,2012-11-25 10:28:56,2189
59,0,0,59,"1029 days, 15:03:16",2013-01-31 02:08:20,2010-02-01 10:32:08,2012-11-27 01:35:24,3432
18,1,3,22,"1033 days, 16:03:39",2013-02-03 09:11:48,2010-02-01 10:32:08,2012-12-01 02:35:47,9182
33,0,0,33,"1039 days, 17:35:11",2013-01-10 11:49:12,2010-02-01 10:32:08,2012-12-07 04:07:19,5707
36,0,3,39,"1043 days, 14:37:55",2013-01-30 05:48:18,2010-02-01 10:32:08,2012-12-11 01:10:03,1149
22,0,1,23,"1043 days, 17:52:32",2013-01-22 05:03:05,2010-02-01 10:32:08,2012-12-11 04:24:40,7672
19,2,6,27,"1045 days, 13:32:17",2013-01-31 11:50:45,2010-02-01 10:32:08,2012-12-13 00:04:25,7584
15,0,0,15,"1055 days, 21:08:34",2012-12-23 07:40:56,2010-02-01 10:32:08,2012-12-23 07:40:42,1698
54,0,0,54,"1058 days, 18:12:41",2013-01-20 03:45:32,2010-02-01 10:32:08,2012-12-26 04:44:49,2393
38,0,0,38,"1061 days, 20:51:58",2013-01-21 00:43:36,2010-02-01 10:32:08,2012-12-29 07:24:06,3359
1,1,1,3,"1062 days, 13:46:52",2013-01-27 09:22:37,2010-02-01 10:32:08,2012-12-30 00:19:00,6924
38,0,0,38,"1062 days, 16:13:07",2013-01-09 08:32:45,2010-02-01 10:32:08,2012-12-30 02:45:15,4717
24,0,0,24,"1063 days, 15:16:27",2013-01-08 09:16:45,2010-02-01 10:32:08,2012-12-31 01:48:35,5276
18,2,1,21,"1064 days, 22:55:34",2013-02-04 01:20:59,2010-02-01 10:32:08,2013-01-01 09:27:42,2093
12,0,0,12,"1066 days, 23:34:13",2013-01-30 02:27:58,2010-02-01 10:32:08,2013-01-03 10:06:21,1218
8,0,0,8,"1069 days, 15:02:12",2013-01-06 01:34:27,2010-02-01 10:32:08,2013-01-06 01:34:20,4687
32,0,0,32,"1071 days, 14:42:51",2013-01-19 08:58:14,2010-02-01 10:32:08,2013-01-08 01:14:59,8493
48,0,0,48,"1073 days, 1:14:02",2013-01-26 01:20:50,2010-02-01 10:32:08,2013-01-09 11:46:10,9114
16,0,0,16,"1075 days, 23:31:55",2013-01-12 10:04:18,2010-02-01 10:32:08,2013-01-12 10:04:03,2089
37,0,0,37,"1076 days, 21:02:10",2013-01-17 11:14:06,2010-02-01 10:32:08,2013-01-13 07:34:18,5790
12,0,0,12,"1081 days, 18:07:27",2013-01-18 04:39:46,2010-02-01 10:32:08,2013-01-18 04:39:35,9757
37,0,2,39,"1084 days, 19:52:27",2013-02-02 06:17:43,2010-02-01 10:32:08,2013-01-21 06:24:35,1396
28,0,0,28,"1085 days, 20:05:07",2013-01-31 10:11:33,2010-02-01 10:32:08,2013-01-22 06:37:15,1478
1,0,0,1,"1088 days, 21:18:36",2013-01-25 07:50:44,2010-02-01 10:32:08,2013-01-25 07:50:44,8693
21,0,0,21,"1089 days, 14:05:34",2013-01-31 06:35:16,2010-02-01 10:32:08,2013-01-26 00:37:42,178
1,0,0,1,"1090 days, 16:40:35",2013-01-27 03:12:43,2010-02-01 10:32:08,2013-01-27 03:12:43,5039
19,0,0,19,"1092 days, 14:49:46",2013-01-29 01:22:12,2010-02-01 10:32:08,2013-01-29 01:21:54,1935
1,0,0,1,"1093 days, 0:36:16",2013-01-29 11:08:24,2010-02-01 10:32:08,2013-01-29 11:08:24,2805
23,0,0,23,"1093 days, 0:42:17",2013-01-31 02:28:21,2010-02-01 10:32:08,2013-01-29 11:14:25,3387
0,10,2,12,"1095 days, 23:12:32",2013-02-06 09:04:34,2010-02-01 10:32:08,2013-02-01 09:44:40,4647
0,0,1,1,"1096 days, 20:29:58",2013-02-02 07:02:06,2010-02-01 10:32:08,2013-02-02 07:02:06,7573
