post,comment,like,total_count,max_delta,last_person_event,max_delta_period_start,max_delta_period_end,id
323,1948,1867,4138,"7 days, 4:25:08",2013-02-12 10:53:46,2012-02-07 06:52:45,2012-02-14 11:17:53,294
53,894,876,1823,"7 days, 6:22:59",2013-02-12 04:50:53,2012-02-08 01:20:47,2012-02-15 07:43:46,166
486,1667,1724,3877,"7 days, 7:37:14",2013-02-12 04:33:46,2012-02-02 02:46:56,2012-02-09 10:24:10,344
22,307,480,809,"7 days, 21:20:44",2013-02-11 09:11:33,2013-02-11 09:11:33,2013-02-19 06:32:17,740
376,872,1215,2463,"7 days, 23:11:49",2013-02-15 08:01:35,2012-02-02 02:46:56,2012-02-10 01:58:45,724
79,1847,2193,4119,"8 days, 2:40:15",2013-02-11 03:52:02,2013-02-11 03:52:02,2013-02-19 06:32:17,722
171,459,577,1207,"8 days, 2:40:36",2013-02-16 00:04:29,2012-02-08 07:36:03,2012-02-16 10:16:39,273
11,685,1126,1822,"8 days, 3:42:46",2013-02-11 02:49:31,2013-02-11 02:49:31,2013-02-19 06:32:17,345
490,1001,1190,2681,"8 days, 6:59:53",2013-02-15 09:24:01,2013-02-07 02:24:08,2013-02-15 09:24:01,658
388,2357,2362,5107,"9 days, 1:38:58",2013-02-10 04:53:19,2013-02-10 04:53:19,2013-02-19 06:32:17,225
113,489,527,1129,"9 days, 3:30:17",2013-02-11 10:04:49,2012-02-02 02:46:56,2012-02-11 06:17:13,547
31,1034,1022,2087,"9 days, 19:10:55",2013-02-09 11:21:22,2013-02-09 11:21:22,2013-02-19 06:32:17,855
5,287,264,556,"9 days, 21:49:02",2013-02-17 11:50:23,2012-03-18 09:24:20,2012-03-28 07:13:22,968
423,1735,1680,3838,"10 days, 4:27:12",2013-02-09 02:05:05,2013-02-09 02:05:05,2013-02-19 06:32:17,367
438,1415,1592,3445,"10 days, 5:37:28",2013-02-09 00:54:49,2013-02-09 00:54:49,2013-02-19 06:32:17,895
96,1431,1532,3059,"10 days, 6:39:48",2013-02-18 07:27:57,2013-02-08 00:48:09,2013-02-18 07:27:57,941
148,552,935,1635,"10 days, 18:35:47",2013-02-08 11:56:30,2013-02-08 11:56:30,2013-02-19 06:32:17,357
21,631,894,1546,"10 days, 19:16:26",2013-02-08 11:15:51,2013-02-08 11:15:51,2013-02-19 06:32:17,654
306,1665,1750,3721,"10 days, 22:05:15",2013-02-08 08:27:02,2013-02-08 08:27:02,2013-02-19 06:32:17,987
224,1527,1196,2947,"10 days, 22:47:20",2013-02-08 07:44:57,2013-02-08 07:44:57,2013-02-19 06:32:17,119
344,2169,2159,4672,"11 days, 0:59:32",2013-02-08 05:32:45,2013-02-08 05:32:45,2013-02-19 06:32:17,842
43,1780,1889,3712,"11 days, 1:19:58",2013-02-08 05:12:19,2013-02-08 05:12:19,2013-02-19 06:32:17,63
133,1163,1605,2901,"11 days, 2:42:10",2013-02-19 06:32:17,2013-02-08 03:50:07,2013-02-19 06:32:17,699
32,1599,2281,3912,"11 days, 3:19:55",2013-02-08 03:12:22,2013-02-08 03:12:22,2013-02-19 06:32:17,723
246,1429,1810,3485,"11 days, 18:33:40",2013-02-07 11:58:37,2013-02-07 11:58:37,2013-02-19 06:32:17,219
143,1298,1126,2567,"11 days, 18:42:01",2013-02-07 11:50:16,2013-02-07 11:50:16,2013-02-19 06:32:17,915
406,2428,2082,4916,"11 days, 18:54:23",2013-02-07 11:37:54,2013-02-07 11:37:54,2013-02-19 06:32:17,336
300,2403,2064,4767,"11 days, 18:56:25",2013-02-07 11:35:52,2013-02-07 11:35:52,2013-02-19 06:32:17,448
42,2599,2125,4766,"11 days, 19:09:50",2013-02-07 11:22:27,2013-02-07 11:22:27,2013-02-19 06:32:17,492
306,1928,2345,4579,"11 days, 19:10:53",2013-02-07 11:21:24,2013-02-07 11:21:24,2013-02-19 06:32:17,265
978,2883,2224,6085,"11 days, 19:13:53",2013-02-07 11:18:24,2013-02-07 11:18:24,2013-02-19 06:32:17,918
374,1557,1510,3441,"11 days, 19:17:12",2013-02-07 11:15:05,2013-02-07 11:15:05,2013-02-19 06:32:17,481
131,2037,2193,4361,"11 days, 19:22:31",2013-02-07 11:09:46,2013-02-07 11:09:46,2013-02-19 06:32:17,395
170,485,875,1530,"11 days, 19:25:12",2013-02-07 11:07:05,2013-02-07 11:07:05,2013-02-19 06:32:17,650
672,1877,1796,4345,"11 days, 19:27:43",2013-02-07 11:04:34,2013-02-07 11:04:34,2013-02-19 06:32:17,844
725,1868,2065,4658,"11 days, 19:27:56",2013-02-07 11:04:21,2013-02-07 11:04:21,2013-02-19 06:32:17,385
35,797,1616,2448,"11 days, 19:30:38",2013-02-07 11:01:39,2013-02-07 11:01:39,2013-02-19 06:32:17,797
897,1523,1768,4188,"11 days, 19:33:24",2013-02-07 10:58:53,2013-02-07 10:58:53,2013-02-19 06:32:17,998
231,2329,2146,4706,"11 days, 19:36:40",2013-02-07 10:55:37,2013-02-07 10:55:37,2013-02-19 06:32:17,24
544,689,668,1901,"11 days, 19:37:51",2013-02-07 10:54:26,2013-02-07 10:54:26,2013-02-19 06:32:17,929
400,2015,1938,4353,"11 days, 19:43:11",2013-02-07 10:49:06,2013-02-07 10:49:06,2013-02-19 06:32:17,316
486,2255,2414,5155,"11 days, 19:49:48",2013-02-07 10:42:29,2013-02-07 10:42:29,2013-02-19 06:32:17,38
30,2281,2721,5032,"11 days, 19:52:33",2013-02-07 10:39:44,2013-02-07 10:39:44,2013-02-19 06:32:17,471
125,1112,1628,2865,"11 days, 20:17:55",2013-02-07 10:14:22,2013-02-07 10:14:22,2013-02-19 06:32:17,996
312,1971,1783,4066,"11 days, 20:24:37",2013-02-07 10:07:40,2013-02-07 10:07:40,2013-02-19 06:32:17,424
465,2933,2602,6000,"11 days, 20:37:29",2013-02-07 09:54:48,2013-02-07 09:54:48,2013-02-19 06:32:17,40
292,563,744,1599,"11 days, 20:38:11",2013-02-07 09:54:06,2013-02-07 09:54:06,2013-02-19 06:32:17,138
34,1173,968,2175,"11 days, 20:48:43",2013-02-07 09:43:34,2013-02-07 09:43:34,2013-02-19 06:32:17,965
643,676,2280,3599,"11 days, 20:56:41",2013-02-07 09:35:36,2013-02-07 09:35:36,2013-02-19 06:32:17,434
74,2054,1955,4083,"11 days, 20:59:13",2013-02-07 09:33:04,2013-02-07 09:33:04,2013-02-19 06:32:17,819
120,1184,1256,2560,"11 days, 21:00:02",2013-02-07 09:32:15,2013-02-07 09:32:15,2013-02-19 06:32:17,905
429,1307,1647,3383,"11 days, 21:38:02",2013-02-07 08:54:15,2013-02-07 08:54:15,2013-02-19 06:32:17,8
581,2457,1659,4697,"11 days, 21:53:30",2013-02-07 08:38:47,2013-02-07 08:38:47,2013-02-19 06:32:17,812
84,954,1019,2057,"11 days, 21:53:39",2013-02-07 08:38:38,2013-02-07 08:38:38,2013-02-19 06:32:17,146
214,2213,2399,4826,"11 days, 21:59:54",2013-02-07 08:32:23,2013-02-07 08:32:23,2013-02-19 06:32:17,162
75,2092,1788,3955,"11 days, 22:01:25",2013-02-07 08:30:52,2013-02-07 08:30:52,2013-02-19 06:32:17,131
131,1131,1018,2280,"11 days, 22:02:40",2013-02-07 08:29:37,2013-02-07 08:29:37,2013-02-19 06:32:17,479
56,2297,2057,4410,"11 days, 22:15:19",2013-02-07 08:16:58,2013-02-07 08:16:58,2013-02-19 06:32:17,808
175,2439,2082,4696,"11 days, 22:23:46",2013-02-07 08:08:31,2013-02-07 08:08:31,2013-02-19 06:32:17,107
316,1602,1527,3445,"11 days, 22:24:28",2013-02-07 08:07:49,2013-02-07 08:07:49,2013-02-19 06:32:17,875
269,594,602,1465,"11 days, 22:39:58",2013-02-07 07:52:19,2013-02-07 07:52:19,2013-02-19 06:32:17,979
283,2586,2408,5277,"11 days, 22:42:22",2013-02-07 07:49:55,2013-02-07 07:49:55,2013-02-19 06:32:17,141
208,1274,1617,3099,"11 days, 22:43:19",2013-02-07 07:48:58,2013-02-07 07:48:58,2013-02-19 06:32:17,417
193,399,694,1286,"11 days, 22:44:02",2013-02-07 07:48:15,2013-02-07 07:48:15,2013-02-19 06:32:17,69
133,1094,1406,2633,"11 days, 22:49:01",2013-02-07 07:43:16,2013-02-07 07:43:16,2013-02-19 06:32:17,409
160,1416,1621,3197,"11 days, 22:53:41",2013-02-07 07:38:36,2013-02-07 07:38:36,2013-02-19 06:32:17,60
209,1923,1271,3403,"11 days, 22:55:20",2013-02-07 07:36:57,2013-02-07 07:36:57,2013-02-19 06:32:17,870
58,1065,1618,2741,"11 days, 23:02:44",2013-02-07 07:29:33,2013-02-07 07:29:33,2013-02-19 06:32:17,627
15,595,636,1246,"11 days, 23:11:15",2013-02-07 07:21:02,2013-02-07 07:21:02,2013-02-19 06:32:17,370
86,1971,2008,4065,"11 days, 23:15:05",2013-02-07 07:17:12,2013-02-07 07:17:12,2013-02-19 06:32:17,404
4,2387,2642,5033,"11 days, 23:27:26",2013-02-07 07:04:51,2013-02-07 07:04:51,2013-02-19 06:32:17,327
568,2133,1787,4488,"11 days, 23:29:43",2013-02-07 07:02:34,2013-02-07 07:02:34,2013-02-19 06:32:17,465
847,1455,2282,4584,"11 days, 23:34:17",2013-02-07 06:58:00,2013-02-07 06:58:00,2013-02-19 06:32:17,938
101,495,1148,1744,"11 days, 23:43:54",2013-02-07 06:48:23,2013-02-07 06:48:23,2013-02-19 06:32:17,780
130,1503,1543,3176,"11 days, 23:47:49",2013-02-07 06:44:28,2013-02-07 06:44:28,2013-02-19 06:32:17,365
240,1835,3091,5166,"11 days, 23:54:18",2013-02-07 08:58:59,2012-02-02 02:46:56,2012-02-14 02:41:14,562
462,1744,1523,3729,"12 days, 0:01:52",2013-02-07 06:30:25,2013-02-07 06:30:25,2013-02-19 06:32:17,538
271,767,822,1860,"12 days, 0:31:47",2013-02-07 06:00:30,2013-02-07 06:00:30,2013-02-19 06:32:17,122
211,2170,2033,4414,"12 days, 0:33:26",2013-02-07 05:58:51,2013-02-07 05:58:51,2013-02-19 06:32:17,721
316,2123,2781,5220,"12 days, 0:39:48",2013-02-07 05:52:29,2013-02-07 05:52:29,2013-02-19 06:32:17,789
49,1726,1727,3502,"12 days, 0:46:14",2013-02-07 05:46:03,2013-02-07 05:46:03,2013-02-19 06:32:17,415
76,1232,2230,3538,"12 days, 0:47:13",2013-02-07 05:45:04,2013-02-07 05:45:04,2013-02-19 06:32:17,625
368,1282,1508,3158,"12 days, 0:51:10",2013-02-07 05:41:07,2013-02-07 05:41:07,2013-02-19 06:32:17,712
211,1690,1909,3810,"12 days, 0:52:37",2013-02-07 05:39:40,2013-02-07 05:39:40,2013-02-19 06:32:17,325
340,2028,1916,4284,"12 days, 1:11:56",2013-02-07 05:20:21,2013-02-07 05:20:21,2013-02-19 06:32:17,310
543,1222,1193,2958,"12 days, 1:16:39",2013-02-07 05:15:38,2013-02-07 05:15:38,2013-02-19 06:32:17,635
142,804,2129,3075,"12 days, 1:22:33",2013-02-07 05:09:44,2013-02-07 05:09:44,2013-02-19 06:32:17,984
43,277,440,760,"12 days, 1:40:38",2013-02-07 04:51:39,2013-02-07 04:51:39,2013-02-19 06:32:17,99
357,1482,1958,3797,"12 days, 1:50:45",2013-02-07 04:41:32,2013-02-07 04:41:32,2013-02-19 06:32:17,752
33,2420,1849,4302,"12 days, 1:54:51",2013-02-07 04:37:26,2013-02-07 04:37:26,2013-02-19 06:32:17,31
114,1152,1109,2375,"12 days, 2:04:13",2013-02-07 04:28:04,2013-02-07 04:28:04,2013-02-19 06:32:17,919
742,2441,2404,5587,"12 days, 2:07:38",2013-02-07 04:24:39,2013-02-07 04:24:39,2013-02-19 06:32:17,165
335,557,929,1821,"12 days, 2:15:22",2013-02-07 04:16:55,2013-02-07 04:16:55,2013-02-19 06:32:17,292
352,903,968,2223,"12 days, 2:16:14",2013-02-07 04:16:03,2013-02-07 04:16:03,2013-02-19 06:32:17,102
159,875,2011,3045,"12 days, 2:17:02",2013-02-07 10:25:46,2012-02-02 02:46:56,2012-02-14 05:03:58,773
62,277,718,1057,"12 days, 2:42:35",2013-02-07 03:49:42,2013-02-07 03:49:42,2013-02-19 06:32:17,795
55,1229,1982,3266,"12 days, 3:03:51",2013-02-07 03:28:26,2013-02-07 03:28:26,2013-02-19 06:32:17,878
711,1176,1002,2889,"12 days, 3:28:38",2013-02-07 03:03:39,2013-02-07 03:03:39,2013-02-19 06:32:17,43
7,1465,1858,3330,"12 days, 3:33:29",2013-02-07 02:58:48,2013-02-07 02:58:48,2013-02-19 06:32:17,271
313,1577,1398,3288,"12 days, 3:41:25",2013-02-07 02:50:52,2013-02-07 02:50:52,2013-02-19 06:32:17,930
118,1882,1972,3972,"12 days, 3:44:48",2013-02-07 02:47:29,2013-02-07 02:47:29,2013-02-19 06:32:17,227
10,562,1130,1702,"12 days, 3:45:01",2013-02-07 02:47:16,2013-02-07 02:47:16,2013-02-19 06:32:17,798
239,1472,1455,3166,"12 days, 3:46:08",2013-02-07 02:46:09,2013-02-07 02:46:09,2013-02-19 06:32:17,456
54,271,513,838,"12 days, 3:55:44",2013-02-18 09:51:50,2013-02-06 05:56:06,2013-02-18 09:51:50,278
518,2189,2869,5576,"12 days, 3:56:43",2013-02-07 02:35:34,2013-02-07 02:35:34,2013-02-19 06:32:17,326
399,3033,2420,5852,"12 days, 4:03:14",2013-02-07 02:29:03,2013-02-07 02:29:03,2013-02-19 06:32:17,959
20,1432,1610,3062,"12 days, 4:03:35",2013-02-07 02:28:42,2013-02-07 02:28:42,2013-02-19 06:32:17,338
15,2353,2200,4568,"12 days, 4:40:47",2013-02-07 01:51:30,2013-02-07 01:51:30,2013-02-19 06:32:17,913
45,844,949,1838,"12 days, 4:41:44",2013-02-07 01:50:33,2013-02-07 01:50:33,2013-02-19 06:32:17,501
798,1299,1332,3429,"12 days, 4:42:14",2013-02-07 01:50:03,2013-02-07 01:50:03,2013-02-19 06:32:17,583
34,2506,1818,4358,"12 days, 4:45:22",2013-02-07 09:25:46,2012-02-02 02:46:56,2012-02-14 07:32:18,793
96,653,1022,1771,"12 days, 4:53:30",2013-02-07 01:38:47,2013-02-07 01:38:47,2013-02-19 06:32:17,581
264,849,2403,3516,"12 days, 5:04:18",2013-02-07 03:00:38,2012-02-02 02:46:56,2012-02-14 07:51:14,427
189,152,548,889,"12 days, 5:05:27",2013-02-07 01:26:50,2013-02-07 01:26:50,2013-02-19 06:32:17,432
225,1739,1709,3673,"12 days, 5:07:25",2013-02-07 01:24:52,2013-02-07 01:24:52,2013-02-19 06:32:17,610
9,1660,1492,3161,"12 days, 5:10:49",2013-02-07 01:21:28,2013-02-07 01:21:28,2013-02-19 06:32:17,398
499,816,1251,2566,"12 days, 5:14:29",2013-02-07 01:17:48,2013-02-07 01:17:48,2013-02-19 06:32:17,359
643,796,1013,2452,"12 days, 5:17:30",2013-02-07 01:14:47,2013-02-07 01:14:47,2013-02-19 06:32:17,451
66,374,700,1140,"12 days, 5:22:33",2013-02-07 01:09:44,2013-02-07 01:09:44,2013-02-19 06:32:17,556
140,1973,1138,3251,"12 days, 5:28:24",2013-02-07 01:03:53,2013-02-07 01:03:53,2013-02-19 06:32:17,962
492,1570,1343,3405,"12 days, 5:40:26",2013-02-07 00:51:51,2013-02-07 00:51:51,2013-02-19 06:32:17,834
46,1187,1804,3037,"12 days, 5:40:54",2013-02-07 04:41:17,2012-02-02 02:46:56,2012-02-14 08:27:50,541
433,1476,2062,3971,"12 days, 5:45:57",2013-02-07 00:46:20,2013-02-07 00:46:20,2013-02-19 06:32:17,692
503,1973,1731,4207,"12 days, 5:49:09",2013-02-07 00:43:08,2013-02-07 00:43:08,2013-02-19 06:32:17,305
96,1826,2048,3970,"12 days, 5:55:15",2013-02-07 00:37:02,2013-02-07 00:37:02,2013-02-19 06:32:17,194
339,903,1104,2346,"12 days, 5:55:45",2013-02-07 00:36:32,2013-02-07 00:36:32,2013-02-19 06:32:17,833
808,2132,2095,5035,"12 days, 6:02:28",2013-02-07 00:29:49,2013-02-07 00:29:49,2013-02-19 06:32:17,810
919,2303,2639,5861,"12 days, 6:04:59",2013-02-07 00:27:18,2013-02-07 00:27:18,2013-02-19 06:32:17,557
705,1440,1191,3336,"12 days, 6:05:30",2013-02-07 00:26:47,2013-02-07 00:26:47,2013-02-19 06:32:17,507
2,1091,1941,3034,"12 days, 6:08:52",2013-02-07 00:23:25,2013-02-07 00:23:25,2013-02-19 06:32:17,726
257,2557,2195,5009,"12 days, 6:09:26",2013-02-08 08:53:31,2012-02-02 02:46:56,2012-02-14 08:56:22,0
473,2051,2394,4918,"12 days, 6:16:43",2013-02-07 00:15:34,2013-02-07 00:15:34,2013-02-19 06:32:17,240
192,766,949,1907,"12 days, 6:28:04",2013-02-07 00:04:13,2013-02-07 00:04:13,2013-02-19 06:32:17,786
386,1514,1303,3203,"12 days, 6:29:10",2013-02-07 00:03:07,2013-02-07 00:03:07,2013-02-19 06:32:17,942
512,2554,2254,5320,"12 days, 6:57:01",2013-02-07 03:14:31,2012-02-02 02:46:56,2012-02-14 09:43:57,811
151,1715,1432,3298,"12 days, 9:01:52",2013-02-07 07:42:37,2012-02-02 02:46:56,2012-02-14 11:48:48,169
225,2182,1720,4127,"12 days, 9:02:35",2013-02-07 08:36:09,2012-02-02 02:46:56,2012-02-14 11:49:31,866
632,1483,2066,4181,"12 days, 15:37:17",2013-02-07 04:37:08,2012-02-02 11:30:20,2012-02-15 03:07:37,568
27,2387,1986,4400,"12 days, 18:39:56",2013-02-06 11:52:21,2013-02-06 11:52:21,2013-02-19 06:32:17,100
337,329,489,1155,"12 days, 18:40:39",2013-02-06 11:51:38,2013-02-06 11:51:38,2013-02-19 06:32:17,438
68,348,409,825,"12 days, 18:40:43",2013-02-06 11:51:34,2013-02-06 11:51:34,2013-02-19 06:32:17,924
27,2714,2932,5673,"12 days, 18:53:03",2013-02-06 11:39:14,2013-02-06 11:39:14,2013-02-19 06:32:17,296
5,474,477,956,"12 days, 18:58:29",2013-02-06 11:33:48,2013-02-06 11:33:48,2013-02-19 06:32:17,200
110,339,484,933,"12 days, 18:59:18",2013-02-06 11:32:59,2013-02-06 11:32:59,2013-02-19 06:32:17,799
479,2848,2454,5781,"12 days, 19:02:00",2013-02-06 11:30:17,2013-02-06 11:30:17,2013-02-19 06:32:17,838
359,1061,1840,3260,"12 days, 19:04:50",2013-02-06 11:27:27,2013-02-06 11:27:27,2013-02-19 06:32:17,618
861,2777,1975,5613,"12 days, 19:05:57",2013-02-06 11:26:20,2013-02-06 11:26:20,2013-02-19 06:32:17,458
562,1015,1608,3185,"12 days, 19:09:30",2013-02-06 11:22:47,2013-02-06 11:22:47,2013-02-19 06:32:17,407
349,1230,1651,3230,"12 days, 19:18:32",2013-02-06 11:13:45,2013-02-06 11:13:45,2013-02-19 06:32:17,910
86,1238,2683,4007,"12 days, 19:18:47",2013-02-06 11:13:30,2013-02-06 11:13:30,2013-02-19 06:32:17,702
163,606,725,1494,"12 days, 19:22:43",2013-02-06 11:09:34,2013-02-06 11:09:34,2013-02-19 06:32:17,208
342,870,1007,2219,"12 days, 19:23:21",2013-02-07 03:22:43,2012-02-16 11:48:56,2012-02-29 07:12:17,488
89,662,1145,1896,"12 days, 19:27:08",2013-02-06 11:05:09,2013-02-06 11:05:09,2013-02-19 06:32:17,353
178,1272,1236,2686,"12 days, 19:35:44",2013-02-06 10:56:33,2013-02-06 10:56:33,2013-02-19 06:32:17,410
332,1756,1376,3464,"12 days, 19:42:31",2013-02-06 10:49:46,2013-02-06 10:49:46,2013-02-19 06:32:17,512
108,1607,1986,3701,"12 days, 19:43:51",2013-02-06 10:48:26,2013-02-06 10:48:26,2013-02-19 06:32:17,304
552,729,1533,2814,"12 days, 19:46:08",2013-02-06 10:46:09,2013-02-06 10:46:09,2013-02-19 06:32:17,900
171,822,905,1898,"12 days, 19:54:24",2013-02-06 10:37:53,2013-02-06 10:37:53,2013-02-19 06:32:17,36
349,614,1912,2875,"12 days, 19:54:58",2013-02-06 10:37:19,2013-02-06 10:37:19,2013-02-19 06:32:17,782
239,3136,1535,4910,"12 days, 19:55:47",2013-02-06 10:36:30,2013-02-06 10:36:30,2013-02-19 06:32:17,953
99,748,1175,2022,"12 days, 20:21:54",2013-02-06 10:10:23,2013-02-06 10:10:23,2013-02-19 06:32:17,64
764,838,648,2250,"12 days, 20:25:26",2013-02-06 10:06:51,2013-02-06 10:06:51,2013-02-19 06:32:17,576
226,1649,1416,3291,"12 days, 20:42:13",2013-02-06 09:50:04,2013-02-06 09:50:04,2013-02-19 06:32:17,46
93,1231,1037,2361,"12 days, 20:56:13",2013-02-06 09:36:04,2013-02-06 09:36:04,2013-02-19 06:32:17,945
86,927,838,1851,"12 days, 20:57:34",2013-02-06 09:34:43,2013-02-06 09:34:43,2013-02-19 06:32:17,157
55,1481,1392,2928,"12 days, 21:24:46",2013-02-06 09:07:31,2013-02-06 09:07:31,2013-02-19 06:32:17,41
17,1874,1856,3747,"12 days, 21:26:35",2013-02-06 09:05:42,2013-02-06 09:05:42,2013-02-19 06:32:17,377
118,2238,1849,4205,"12 days, 21:28:43",2013-02-06 09:03:34,2013-02-06 09:03:34,2013-02-19 06:32:17,973
114,473,622,1209,"12 days, 21:30:47",2013-02-06 09:01:30,2013-02-06 09:01:30,2013-02-19 06:32:17,295
185,2078,2478,4741,"12 days, 21:36:58",2013-02-06 08:55:19,2013-02-06 08:55:19,2013-02-19 06:32:17,983
344,369,627,1340,"12 days, 21:43:04",2013-02-06 08:49:13,2013-02-06 08:49:13,2013-02-19 06:32:17,836
497,661,674,1832,"12 days, 21:50:56",2013-02-06 08:41:21,2013-02-06 08:41:21,2013-02-19 06:32:17,389
93,762,869,1724,"12 days, 21:55:47",2013-02-06 08:36:30,2013-02-06 08:36:30,2013-02-19 06:32:17,48
684,1425,1492,3601,"12 days, 21:56:06",2013-02-06 08:36:11,2013-02-06 08:36:11,2013-02-19 06:32:17,896
478,1452,1147,3077,"12 days, 22:10:48",2013-02-06 08:21:29,2013-02-06 08:21:29,2013-02-19 06:32:17,73
255,702,888,1845,"12 days, 22:18:54",2013-02-06 08:13:23,2013-02-06 08:13:23,2013-02-19 06:32:17,696
245,3266,2090,5601,"12 days, 22:19:09",2013-02-06 08:13:08,2013-02-06 08:13:08,2013-02-19 06:32:17,135
867,1010,1053,2930,"12 days, 22:33:38",2013-02-06 07:58:39,2013-02-06 07:58:39,2013-02-19 06:32:17,880
54,356,579,989,"12 days, 22:35:55",2013-02-06 08:29:54,2012-02-02 02:46:56,2012-02-15 01:22:51,4
946,1899,1971,4816,"12 days, 22:40:34",2013-02-06 07:51:43,2013-02-06 07:51:43,2013-02-19 06:32:17,101
753,1058,1253,3064,"12 days, 22:44:52",2013-02-06 07:47:25,2013-02-06 07:47:25,2013-02-19 06:32:17,876
550,436,596,1582,"12 days, 22:44:53",2013-02-06 07:47:24,2013-02-06 07:47:24,2013-02-19 06:32:17,197
129,1622,1922,3673,"12 days, 22:47:13",2013-02-07 09:35:58,2012-02-02 02:46:56,2012-02-15 01:34:09,859
325,514,702,1541,"12 days, 23:01:47",2013-02-06 07:30:30,2013-02-06 07:30:30,2013-02-19 06:32:17,921
261,1327,1301,2889,"12 days, 23:09:04",2013-02-06 07:23:13,2013-02-06 07:23:13,2013-02-19 06:32:17,28
199,3113,2402,5714,"12 days, 23:19:41",2013-02-06 07:12:36,2013-02-06 07:12:36,2013-02-19 06:32:17,922
556,2637,2694,5887,"12 days, 23:21:51",2013-02-06 07:10:26,2013-02-06 07:10:26,2013-02-19 06:32:17,23
140,2472,2048,4660,"12 days, 23:22:20",2013-02-06 07:09:57,2013-02-06 07:09:57,2013-02-19 06:32:17,246
18,319,434,771,"12 days, 23:23:10",2013-02-06 07:09:07,2013-02-06 07:09:07,2013-02-19 06:32:17,868
359,2485,1981,4825,"12 days, 23:24:03",2013-02-06 07:08:14,2013-02-06 07:08:14,2013-02-19 06:32:17,522
16,369,586,971,"12 days, 23:41:33",2013-02-06 06:50:44,2013-02-06 06:50:44,2013-02-19 06:32:17,129
75,1610,1442,3127,"12 days, 23:42:25",2013-02-06 06:49:52,2013-02-06 06:49:52,2013-02-19 06:32:17,728
259,762,1418,2439,"12 days, 23:55:08",2013-02-06 06:37:09,2013-02-06 06:37:09,2013-02-19 06:32:17,778
282,94,320,696,"13 days, 0:04:08",2013-02-06 06:28:09,2013-02-06 06:28:09,2013-02-19 06:32:17,401
88,862,1068,2018,"13 days, 0:06:06",2013-02-06 06:26:11,2013-02-06 06:26:11,2013-02-19 06:32:17,587
59,329,603,991,"13 days, 0:10:17",2013-02-06 06:22:00,2013-02-06 06:22:00,2013-02-19 06:32:17,943
567,1600,1258,3425,"13 days, 0:40:01",2013-02-06 05:52:16,2013-02-06 05:52:16,2013-02-19 06:32:17,29
465,2244,1724,4433,"13 days, 0:53:40",2013-02-06 05:38:37,2013-02-06 05:38:37,2013-02-19 06:32:17,156
169,548,984,1701,"13 days, 1:08:15",2013-02-06 05:24:02,2013-02-06 05:24:02,2013-02-19 06:32:17,236
54,1002,886,1942,"13 days, 1:20:40",2013-02-06 05:11:37,2013-02-06 05:11:37,2013-02-19 06:32:17,950
8,339,639,986,"13 days, 1:23:10",2013-02-06 05:09:07,2013-02-06 05:09:07,2013-02-19 06:32:17,738
106,1738,2331,4175,"13 days, 1:25:50",2013-02-07 10:28:39,2012-02-02 02:46:56,2012-02-15 04:12:46,262
139,1351,1800,3290,"13 days, 1:31:49",2013-02-07 02:33:19,2012-02-02 02:46:56,2012-02-15 04:18:45,590
43,705,854,1602,"13 days, 1:37:20",2013-02-06 04:54:57,2013-02-06 04:54:57,2013-02-19 06:32:17,750
64,106,207,377,"13 days, 1:37:51",2013-02-06 04:54:26,2013-02-06 04:54:26,2013-02-19 06:32:17,558
43,850,1157,2050,"13 days, 1:43:09",2013-02-06 04:49:08,2013-02-06 04:49:08,2013-02-19 06:32:17,848
87,334,409,830,"13 days, 1:49:37",2013-02-06 04:42:40,2013-02-06 04:42:40,2013-02-19 06:32:17,861
23,1457,1573,3053,"13 days, 2:08:41",2013-02-06 04:23:36,2013-02-06 04:23:36,2013-02-19 06:32:17,70
52,766,1213,2031,"13 days, 2:14:43",2013-02-06 04:17:34,2013-02-06 04:17:34,2013-02-19 06:32:17,422
396,814,1048,2258,"13 days, 2:17:21",2013-02-06 04:14:56,2013-02-06 04:14:56,2013-02-19 06:32:17,944
518,553,641,1712,"13 days, 2:19:43",2013-02-06 04:12:34,2013-02-06 04:12:34,2013-02-19 06:32:17,586
5,153,177,335,"13 days, 2:21:03",2013-02-06 06:14:46,2012-02-02 02:46:56,2012-02-15 05:07:59,901
83,1065,1827,2975,"13 days, 2:21:25",2013-02-06 04:10:52,2013-02-06 04:10:52,2013-02-19 06:32:17,347
619,2192,2079,4890,"13 days, 2:21:38",2013-02-06 04:10:39,2013-02-06 04:10:39,2013-02-19 06:32:17,530
249,326,678,1253,"13 days, 2:27:57",2013-02-06 04:04:20,2013-02-06 04:04:20,2013-02-19 06:32:17,199
81,1279,1517,2877,"13 days, 2:37:24",2013-02-06 03:54:53,2013-02-06 03:54:53,2013-02-19 06:32:17,480
435,2592,2782,5809,"13 days, 2:39:41",2013-02-06 03:52:36,2013-02-06 03:52:36,2013-02-19 06:32:17,280
69,422,490,981,"13 days, 2:40:12",2013-02-06 03:52:05,2013-02-06 03:52:05,2013-02-19 06:32:17,614
49,572,808,1429,"13 days, 3:09:37",2013-02-06 07:38:34,2012-02-02 02:46:56,2012-02-15 05:56:33,324
29,733,1048,1810,"13 days, 3:13:36",2013-02-06 03:18:41,2013-02-06 03:18:41,2013-02-19 06:32:17,886
330,962,1152,2444,"13 days, 3:24:55",2013-02-06 03:07:22,2013-02-06 03:07:22,2013-02-19 06:32:17,237
289,275,460,1024,"13 days, 3:47:55",2013-02-06 02:44:22,2013-02-06 02:44:22,2013-02-19 06:32:17,732
65,2031,1814,3910,"13 days, 3:52:51",2013-02-06 02:39:26,2013-02-06 02:39:26,2013-02-19 06:32:17,405
108,927,1068,2103,"13 days, 4:02:10",2013-02-06 02:30:07,2013-02-06 02:30:07,2013-02-19 06:32:17,297
18,279,585,882,"13 days, 4:09:30",2013-02-06 05:06:52,2012-02-02 02:46:56,2012-02-15 06:56:26,290
62,359,673,1094,"13 days, 4:11:44",2013-02-06 02:20:33,2013-02-06 02:20:33,2013-02-19 06:32:17,189
554,480,656,1690,"13 days, 4:15:55",2013-02-07 04:39:17,2012-02-02 02:46:56,2012-02-15 07:02:51,629
146,136,238,520,"13 days, 4:17:03",2013-02-06 02:15:14,2013-02-06 02:15:14,2013-02-19 06:32:17,517
106,71,201,378,"13 days, 4:18:49",2013-02-06 06:23:14,2012-02-12 04:29:40,2012-02-25 08:48:29,620
238,1282,1461,2981,"13 days, 4:21:05",2013-02-06 02:11:12,2013-02-06 02:11:12,2013-02-19 06:32:17,862
269,716,926,1911,"13 days, 4:22:35",2013-02-06 02:09:42,2013-02-06 02:09:42,2013-02-19 06:32:17,266
36,1322,1279,2637,"13 days, 4:30:07",2013-02-06 02:02:10,2013-02-06 02:02:10,2013-02-19 06:32:17,670
388,1246,1834,3468,"13 days, 4:37:38",2013-02-06 01:54:39,2013-02-06 01:54:39,2013-02-19 06:32:17,186
82,500,1229,1811,"13 days, 4:38:04",2013-02-06 01:54:13,2013-02-06 01:54:13,2013-02-19 06:32:17,648
70,376,447,893,"13 days, 4:58:05",2013-02-07 10:25:12,2012-02-02 02:46:56,2012-02-15 07:45:01,514
74,224,388,686,"13 days, 4:58:52",2013-02-06 01:33:25,2013-02-06 01:33:25,2013-02-19 06:32:17,993
605,1172,1347,3124,"13 days, 4:59:31",2013-02-06 01:32:46,2013-02-06 01:32:46,2013-02-19 06:32:17,396
111,1861,1492,3464,"13 days, 5:11:48",2013-02-06 01:20:29,2013-02-06 01:20:29,2013-02-19 06:32:17,951
80,1260,1706,3046,"13 days, 5:12:09",2013-02-07 01:01:08,2012-02-02 02:46:56,2012-02-15 07:59:05,548
173,1711,1657,3541,"13 days, 5:17:54",2013-02-06 01:14:23,2013-02-06 01:14:23,2013-02-19 06:32:17,839
48,1272,1598,2918,"13 days, 5:19:26",2013-02-06 01:12:51,2013-02-06 01:12:51,2013-02-19 06:32:17,406
379,642,974,1995,"13 days, 5:24:15",2013-02-06 01:08:02,2013-02-06 01:08:02,2013-02-19 06:32:17,801
77,750,962,1789,"13 days, 5:59:08",2013-02-06 00:33:09,2013-02-06 00:33:09,2013-02-19 06:32:17,272
143,231,465,839,"13 days, 6:04:55",2013-02-06 00:27:22,2013-02-06 00:27:22,2013-02-19 06:32:17,450
45,949,1126,2120,"13 days, 6:16:18",2013-02-06 00:15:59,2013-02-06 00:15:59,2013-02-19 06:32:17,500
244,1854,1487,3585,"13 days, 6:20:41",2013-02-06 00:11:36,2013-02-06 00:11:36,2013-02-19 06:32:17,104
71,681,679,1431,"13 days, 6:24:22",2013-02-06 00:07:55,2013-02-06 00:07:55,2013-02-19 06:32:17,762
51,1306,2111,3468,"13 days, 7:44:54",2013-02-07 06:51:24,2012-02-02 02:46:56,2012-02-15 10:31:50,716
189,319,604,1112,"13 days, 9:12:46",2013-02-10 06:04:21,2012-02-02 02:46:56,2012-02-15 11:59:42,991
388,932,839,2159,"13 days, 19:12:07",2013-02-05 11:20:10,2013-02-05 11:20:10,2013-02-19 06:32:17,136
331,222,357,910,"13 days, 19:17:12",2013-02-05 11:15:05,2013-02-05 11:15:05,2013-02-19 06:32:17,546
286,393,676,1355,"13 days, 19:33:03",2013-02-05 10:59:14,2013-02-05 10:59:14,2013-02-19 06:32:17,683
42,1106,1404,2552,"13 days, 19:49:04",2013-02-05 10:43:13,2013-02-05 10:43:13,2013-02-19 06:32:17,676
257,1297,1212,2766,"13 days, 19:59:59",2013-02-05 10:32:18,2013-02-05 10:32:18,2013-02-19 06:32:17,754
115,363,495,973,"13 days, 20:17:53",2013-02-05 10:14:24,2013-02-05 10:14:24,2013-02-19 06:32:17,840
156,526,737,1419,"13 days, 20:23:53",2013-02-05 10:08:24,2013-02-05 10:08:24,2013-02-19 06:32:17,93
33,640,645,1318,"13 days, 20:24:38",2013-02-05 10:07:39,2013-02-05 10:07:39,2013-02-19 06:32:17,89
0,557,624,1181,"13 days, 21:23:33",2013-02-05 09:08:44,2013-02-05 09:08:44,2013-02-19 06:32:17,37
189,919,1181,2289,"13 days, 21:27:41",2013-02-05 09:04:36,2013-02-05 09:04:36,2013-02-19 06:32:17,911
542,254,250,1046,"13 days, 21:40:31",2013-02-05 08:51:46,2013-02-05 08:51:46,2013-02-19 06:32:17,132
168,325,642,1135,"13 days, 21:45:21",2013-02-05 08:46:56,2013-02-05 08:46:56,2013-02-19 06:32:17,447
229,403,602,1234,"13 days, 22:03:34",2013-02-05 08:28:43,2013-02-05 08:28:43,2013-02-19 06:32:17,826
542,996,864,2402,"13 days, 22:11:41",2013-02-07 03:17:54,2012-02-02 02:46:56,2012-02-16 00:58:37,903
287,674,978,1939,"13 days, 22:13:38",2013-02-05 08:18:39,2013-02-05 08:18:39,2013-02-19 06:32:17,891
141,143,375,659,"13 days, 23:03:15",2013-02-05 07:29:02,2013-02-05 07:29:02,2013-02-19 06:32:17,545
133,434,740,1307,"13 days, 23:10:19",2013-02-05 07:21:58,2013-02-05 07:21:58,2013-02-19 06:32:17,22
230,1953,2202,4385,"13 days, 23:18:18",2013-02-07 02:33:32,2012-02-02 02:46:56,2012-02-16 02:05:14,633
32,123,241,396,"13 days, 23:46:30",2013-02-05 06:45:47,2013-02-05 06:45:47,2013-02-19 06:32:17,792
114,1090,1089,2293,"13 days, 23:48:16",2013-02-05 09:39:52,2012-02-19 09:55:03,2012-03-04 09:43:19,825
194,171,338,703,"14 days, 0:16:31",2013-02-05 06:15:46,2013-02-05 06:15:46,2013-02-19 06:32:17,484
203,725,786,1714,"14 days, 0:22:14",2013-02-05 06:10:03,2013-02-05 06:10:03,2013-02-19 06:32:17,192
51,799,817,1667,"14 days, 0:24:55",2013-02-05 06:07:22,2013-02-05 06:07:22,2013-02-19 06:32:17,892
69,202,436,707,"14 days, 0:46:57",2013-02-05 05:45:20,2013-02-05 05:45:20,2013-02-19 06:32:17,16
267,1470,1083,2820,"14 days, 0:52:56",2013-02-06 08:38:40,2012-02-02 02:46:56,2012-02-16 03:39:52,15
76,841,1175,2092,"14 days, 0:59:36",2013-02-06 11:00:12,2012-02-02 02:46:56,2012-02-16 03:46:32,228
76,500,655,1231,"14 days, 1:14:33",2013-02-05 07:19:31,2012-02-02 02:46:56,2012-02-16 04:01:29,55
149,161,222,532,"14 days, 1:20:31",2013-02-05 11:20:40,2012-02-11 01:52:21,2012-02-25 03:12:52,506
505,428,711,1644,"14 days, 1:44:25",2013-02-05 04:47:52,2013-02-05 04:47:52,2013-02-19 06:32:17,435
411,269,459,1139,"14 days, 1:53:48",2013-02-05 04:38:29,2013-02-05 04:38:29,2013-02-19 06:32:17,714
128,357,620,1105,"14 days, 1:59:23",2013-02-05 04:32:54,2013-02-05 04:32:54,2013-02-19 06:32:17,970
311,1085,1363,2759,"14 days, 2:42:49",2013-02-07 03:27:32,2012-02-02 02:46:56,2012-02-16 05:29:45,869
350,734,1248,2332,"14 days, 3:29:12",2013-02-06 10:20:13,2012-02-10 02:27:00,2012-02-24 05:56:12,5
49,209,280,538,"14 days, 3:38:13",2013-02-05 02:54:04,2013-02-05 02:54:04,2013-02-19 06:32:17,640
5,930,1594,2529,"14 days, 3:51:56",2013-02-06 00:23:02,2012-02-02 02:46:56,2012-02-16 06:38:52,300
205,142,345,692,"14 days, 4:00:58",2013-02-05 02:31:19,2013-02-05 02:31:19,2013-02-19 06:32:17,127
63,861,854,1778,"14 days, 4:13:53",2013-02-07 05:47:23,2012-02-02 02:46:56,2012-02-16 07:00:49,413
230,472,576,1278,"14 days, 4:23:41",2013-02-05 02:08:36,2013-02-05 02:08:36,2013-02-19 06:32:17,348
257,650,734,1641,"14 days, 4:51:32",2013-02-05 01:40:45,2013-02-05 01:40:45,2013-02-19 06:32:17,960
247,278,347,872,"14 days, 5:02:08",2013-02-05 01:30:09,2013-02-05 01:30:09,2013-02-19 06:32:17,232
307,64,210,581,"14 days, 5:22:12",2013-02-05 01:10:05,2013-02-05 01:10:05,2013-02-19 06:32:17,467
358,204,372,934,"14 days, 5:45:51",2013-02-05 00:46:26,2013-02-05 00:46:26,2013-02-19 06:32:17,515
165,270,313,748,"14 days, 5:58:48",2013-02-05 00:33:29,2013-02-05 00:33:29,2013-02-19 06:32:17,457
19,133,161,313,"14 days, 6:22:40",2013-02-05 09:24:48,2012-02-02 02:46:56,2012-02-16 09:09:36,88
43,362,489,894,"14 days, 6:34:38",2013-02-07 06:01:26,2012-02-02 02:46:56,2012-02-16 09:21:34,817
311,1596,1587,3494,"14 days, 6:55:00",2013-02-06 09:40:01,2012-02-02 02:46:56,2012-02-16 09:41:56,372
47,705,1459,2211,"14 days, 6:56:19",2013-02-12 05:54:08,2012-02-02 02:46:56,2012-02-16 09:43:15,437
271,316,520,1107,"14 days, 7:10:14",2013-02-05 09:36:08,2012-02-02 02:46:56,2012-02-16 09:57:10,270
546,1485,2741,4772,"14 days, 7:15:33",2013-02-07 04:41:01,2012-02-02 02:46:56,2012-02-16 10:02:29,655
84,938,1340,2362,"14 days, 8:09:28",2013-02-07 10:05:08,2012-02-02 02:46:56,2012-02-16 10:56:24,711
284,1916,2925,5125,"14 days, 8:18:55",2013-02-07 09:16:22,2012-02-02 02:46:56,2012-02-16 11:05:51,804
54,655,1095,1804,"14 days, 8:34:31",2013-02-07 07:44:07,2012-02-02 02:46:56,2012-02-16 11:21:27,174
284,1479,1323,3086,"14 days, 19:10:49",2013-02-04 11:21:28,2013-02-04 11:21:28,2013-02-19 06:32:17,713
110,364,668,1142,"14 days, 19:15:18",2013-02-04 11:16:59,2013-02-04 11:16:59,2013-02-19 06:32:17,483
203,235,614,1052,"14 days, 19:48:12",2013-02-04 10:44:05,2013-02-04 10:44:05,2013-02-19 06:32:17,351
27,2593,2269,4889,"14 days, 20:23:37",2013-02-04 10:08:40,2013-02-04 10:08:40,2013-02-19 06:32:17,323
94,461,500,1055,"14 days, 20:49:52",2013-02-04 09:42:25,2013-02-04 09:42:25,2013-02-19 06:32:17,121
35,569,936,1540,"14 days, 21:18:23",2013-02-05 07:30:36,2012-02-02 02:46:56,2012-02-17 00:05:19,978
414,1445,1067,2926,"14 days, 21:43:36",2013-02-04 08:48:41,2013-02-04 08:48:41,2013-02-19 06:32:17,871
150,951,1050,2151,"14 days, 22:06:40",2013-02-07 06:19:02,2012-02-02 02:46:56,2012-02-17 00:53:36,872
56,111,271,438,"14 days, 22:28:27",2013-02-04 08:03:50,2013-02-04 08:03:50,2013-02-19 06:32:17,784
55,492,538,1085,"14 days, 22:38:36",2013-02-04 07:53:41,2013-02-04 07:53:41,2013-02-19 06:32:17,832
443,921,1771,3135,"14 days, 23:42:05",2013-02-05 10:33:16,2012-02-02 02:46:56,2012-02-17 02:29:01,181
260,1967,1900,4127,"15 days, 0:01:38",2013-02-07 10:51:13,2012-02-02 02:46:56,2012-02-17 02:48:34,191
198,896,1035,2129,"15 days, 0:02:58",2013-02-07 07:37:52,2012-02-02 02:46:56,2012-02-17 02:49:54,91
311,224,414,949,"15 days, 0:23:13",2013-02-07 00:51:44,2012-02-02 02:46:56,2012-02-17 03:10:09,328
293,1748,1720,3761,"15 days, 0:27:46",2013-02-05 10:34:39,2012-02-02 02:46:56,2012-02-17 03:14:42,221
166,868,1073,2107,"15 days, 1:04:36",2013-02-07 11:48:34,2012-02-02 02:46:56,2012-02-17 03:51:32,342
883,1344,1833,4060,"15 days, 1:20:10",2013-02-06 08:18:14,2012-02-02 02:46:56,2012-02-17 04:07:06,361
266,847,1088,2201,"15 days, 1:47:55",2013-02-07 00:14:21,2012-02-02 02:46:56,2012-02-17 04:34:51,394
340,177,246,763,"15 days, 3:29:41",2013-02-04 03:02:36,2013-02-04 03:02:36,2013-02-19 06:32:17,641
40,1161,1588,2789,"15 days, 3:33:53",2013-02-06 11:40:13,2012-02-02 02:46:56,2012-02-17 06:20:49,76
163,2234,2939,5336,"15 days, 4:01:56",2013-02-07 10:06:03,2012-02-02 02:46:56,2012-02-17 06:48:52,814
287,308,417,1012,"15 days, 4:14:39",2013-02-05 09:06:02,2012-02-02 02:46:56,2012-02-17 07:01:35,643
378,954,1556,2888,"15 days, 4:50:48",2013-02-06 06:55:06,2012-02-02 02:46:56,2012-02-17 07:37:44,882
82,1285,1035,2402,"15 days, 4:52:36",2013-02-07 11:52:28,2012-02-02 02:46:56,2012-02-17 07:39:32,653
551,299,395,1245,"15 days, 6:19:24",2013-02-07 07:22:46,2012-02-02 02:46:56,2012-02-17 09:06:20,573
73,1542,1879,3494,"15 days, 6:21:33",2013-02-07 08:25:45,2012-02-02 02:46:56,2012-02-17 09:08:29,626
587,772,1629,2988,"15 days, 6:28:05",2013-02-06 09:36:24,2012-02-02 02:46:56,2012-02-17 09:15:01,429
161,2102,1277,3540,"15 days, 7:47:17",2013-02-16 09:11:36,2012-02-02 02:46:56,2012-02-17 10:34:13,10
153,1444,1464,3061,"15 days, 8:17:33",2013-02-07 04:23:14,2012-02-02 02:46:56,2012-02-17 11:04:29,660
151,2004,1948,4103,"15 days, 8:23:49",2013-02-07 11:43:16,2012-02-02 02:46:56,2012-02-17 11:10:45,675
317,1049,1557,2923,"15 days, 17:58:18",2013-02-05 07:13:07,2012-02-18 11:12:50,2012-03-05 05:11:08,182
49,397,624,1070,"15 days, 18:34:09",2013-02-03 11:58:08,2013-02-03 11:58:08,2013-02-19 06:32:17,454
329,1022,3307,4658,"15 days, 21:18:04",2013-02-07 10:35:49,2012-02-02 02:46:56,2012-02-18 00:05:00,565
162,1138,1270,2570,"15 days, 21:40:31",2013-02-04 11:52:21,2012-02-02 02:46:56,2012-02-18 00:27:27,379
57,733,737,1527,"15 days, 21:59:55",2013-02-07 01:15:44,2012-02-02 02:46:56,2012-02-18 00:46:51,617
349,1297,2023,3669,"15 days, 22:05:02",2013-02-07 10:32:49,2012-02-02 02:46:56,2012-02-18 00:51:58,756
209,118,308,635,"15 days, 22:16:20",2013-02-13 11:45:56,2012-02-02 02:46:56,2012-02-18 01:03:16,663
7,306,389,702,"15 days, 23:47:01",2013-02-06 02:32:13,2012-02-02 02:46:56,2012-02-18 02:33:57,108
189,242,418,849,"15 days, 23:53:25",2013-02-05 07:29:06,2012-02-26 09:52:35,2012-03-13 09:46:00,47
261,980,2374,3615,"16 days, 0:36:21",2013-02-07 11:58:19,2012-02-02 02:46:56,2012-02-18 03:23:17,599
138,411,637,1186,"16 days, 0:40:30",2013-02-06 09:53:03,2012-02-02 02:46:56,2012-02-18 03:27:26,281
272,2230,2018,4520,"16 days, 2:06:24",2013-02-07 05:10:33,2012-02-02 02:46:56,2012-02-18 04:53:20,366
292,333,676,1301,"16 days, 2:52:39",2013-02-03 03:39:38,2013-02-03 03:39:38,2013-02-19 06:32:17,264
233,175,306,714,"16 days, 2:55:34",2013-02-06 03:18:31,2012-02-02 02:46:56,2012-02-18 05:42:30,115
151,662,1137,1950,"16 days, 3:06:42",2013-02-04 09:24:22,2012-02-02 02:46:56,2012-02-18 05:53:38,350
231,77,132,440,"16 days, 3:12:14",2013-02-04 06:21:57,2012-02-02 02:46:56,2012-02-18 05:59:10,35
69,338,386,793,"16 days, 3:18:37",2013-02-05 04:46:41,2012-02-14 01:17:29,2012-03-01 04:36:06,84
272,334,552,1158,"16 days, 3:43:10",2013-02-05 10:05:50,2012-02-02 02:46:56,2012-02-18 06:30:06,274
115,136,251,502,"16 days, 3:50:59",2013-02-05 05:17:04,2012-04-11 07:35:23,2012-04-27 11:26:22,20
79,1370,1794,3243,"16 days, 4:45:33",2013-02-07 08:23:53,2012-02-02 02:46:56,2012-02-18 07:32:29,524
51,574,400,1025,"16 days, 5:13:48",2013-02-06 09:10:43,2012-02-24 03:22:25,2012-03-11 08:36:13,954
435,196,408,1039,"16 days, 5:54:10",2013-02-03 00:38:07,2013-02-03 00:38:07,2013-02-19 06:32:17,307
272,251,631,1154,"16 days, 7:02:44",2013-02-06 11:20:36,2012-02-02 02:46:56,2012-02-18 09:49:40,502
645,595,882,2122,"16 days, 7:38:31",2013-02-07 04:34:19,2012-02-02 02:46:56,2012-02-18 10:25:27,503
356,1209,1466,3031,"16 days, 7:54:39",2013-02-07 07:29:46,2012-02-02 02:46:56,2012-02-18 10:41:35,986
3,27,151,181,"16 days, 20:33:19",2013-02-07 07:17:51,2012-06-11 05:11:24,2012-06-28 01:44:43,213
345,928,1163,2436,"16 days, 21:32:11",2013-02-07 03:43:52,2012-02-02 02:46:56,2012-02-19 00:19:07,160
238,871,1186,2295,"16 days, 21:51:39",2013-02-06 05:37:34,2012-02-02 02:46:56,2012-02-19 00:38:35,980
10,13,101,124,"16 days, 21:56:19",2013-02-04 10:22:26,2012-09-11 10:54:32,2012-09-28 08:50:51,666
48,792,1542,2382,"16 days, 22:58:14",2013-02-07 00:09:22,2012-02-02 02:46:56,2012-02-19 01:45:10,309
230,14,69,313,"16 days, 23:25:42",2013-02-06 01:51:47,2012-04-13 05:04:55,2012-04-30 04:30:37,598
369,454,677,1500,"16 days, 23:41:05",2013-02-06 11:51:18,2012-02-02 02:46:56,2012-02-19 02:28:01,589
71,1586,2162,3819,"17 days, 0:12:59",2013-02-07 07:09:47,2012-02-02 02:46:56,2012-02-19 02:59:55,459
563,1165,1214,2942,"17 days, 0:13:24",2013-02-07 03:26:13,2012-02-02 02:46:56,2012-02-19 03:00:20,935
160,667,746,1573,"17 days, 2:35:05",2013-02-06 08:02:34,2012-02-02 02:46:56,2012-02-19 05:22:01,794
127,1043,1391,2561,"17 days, 2:50:49",2013-02-06 05:23:00,2012-02-02 02:46:56,2012-02-19 05:37:45,831
149,1630,1926,3705,"17 days, 3:12:30",2013-02-08 01:13:02,2012-02-02 02:46:56,2012-02-19 05:59:26,149
22,263,435,720,"17 days, 3:37:18",2013-02-06 01:00:27,2012-02-17 04:12:24,2012-03-05 07:49:42,383
659,1845,1528,4032,"17 days, 4:29:03",2013-02-06 11:08:01,2012-02-16 03:32:51,2012-03-04 08:01:54,152
146,1270,1637,3053,"17 days, 5:27:49",2013-02-07 05:09:51,2012-02-02 02:46:56,2012-02-19 08:14:45,827
125,271,355,751,"17 days, 5:59:32",2013-02-06 09:12:41,2012-02-02 02:46:56,2012-02-19 08:46:28,824
529,382,370,1281,"17 days, 6:53:50",2013-02-04 11:11:00,2012-02-02 02:46:56,2012-02-19 09:40:46,995
104,91,161,356,"17 days, 8:35:26",2013-02-03 04:30:47,2012-02-02 02:46:56,2012-02-19 11:22:22,418
67,1252,1452,2771,"17 days, 8:42:17",2013-02-07 03:13:05,2012-02-02 02:46:56,2012-02-19 11:29:13,835
286,632,778,1696,"17 days, 8:56:34",2013-02-06 10:54:35,2012-02-02 02:46:56,2012-02-19 11:43:30,867
65,712,601,1378,"17 days, 13:32:18",2013-02-06 07:52:52,2012-02-08 11:09:13,2012-02-26 00:41:31,552
415,944,715,2074,"17 days, 21:33:27",2013-02-05 01:48:48,2012-02-02 02:46:56,2012-02-20 00:20:23,790
346,156,398,900,"17 days, 22:56:16",2013-02-01 07:36:01,2013-02-01 07:36:01,2013-02-19 06:32:17,971
28,2140,2166,4334,"17 days, 23:38:48",2013-02-08 05:59:44,2012-02-02 02:46:56,2012-02-20 02:25:44,180
304,764,819,1887,"18 days, 0:08:06",2013-02-05 09:12:45,2012-02-02 02:46:56,2012-02-20 02:55:02,698
28,62,155,245,"18 days, 1:18:31",2013-02-01 05:13:46,2013-02-01 05:13:46,2013-02-19 06:32:17,555
35,1383,1847,3265,"18 days, 1:23:26",2013-02-05 03:50:24,2012-02-02 02:46:56,2012-02-20 04:10:22,230
130,818,1263,2211,"18 days, 1:27:50",2013-02-05 02:37:46,2012-02-02 02:46:56,2012-02-20 04:14:46,68
52,160,250,462,"18 days, 2:33:21",2013-02-04 11:37:22,2012-02-02 02:46:56,2012-02-20 05:20:17,717
135,180,209,524,"18 days, 3:35:56",2013-02-07 10:28:07,2012-02-02 02:46:56,2012-02-20 06:22:52,54
138,681,685,1504,"18 days, 3:38:28",2013-02-07 10:50:11,2012-02-02 02:46:56,2012-02-20 06:25:24,958
64,253,554,871,"18 days, 3:52:30",2013-02-07 01:48:00,2012-02-02 02:46:56,2012-02-20 06:39:26,888
313,372,503,1188,"18 days, 6:14:16",2013-02-07 10:15:36,2012-02-02 02:46:56,2012-02-20 09:01:12,238
36,555,853,1444,"18 days, 6:58:09",2013-02-06 03:37:29,2012-02-02 02:46:56,2012-02-20 09:45:05,311
7,65,154,226,"18 days, 7:31:17",2013-02-07 03:09:16,2012-04-08 02:45:46,2012-04-26 10:17:03,928
179,1527,2228,3934,"18 days, 21:41:35",2013-02-07 08:22:39,2012-02-02 02:46:56,2012-02-21 00:28:31,647
35,1229,1200,2464,"18 days, 22:17:22",2013-02-06 08:48:55,2012-02-02 02:46:56,2012-02-21 01:04:18,92
27,410,662,1099,"18 days, 22:37:03",2013-02-07 00:02:44,2012-02-02 02:46:56,2012-02-21 01:23:59,461
67,126,347,540,"18 days, 22:58:59",2013-02-04 10:03:30,2012-02-02 02:46:56,2012-02-21 01:45:55,632
143,1507,1750,3400,"19 days, 0:11:49",2013-02-16 09:05:04,2012-02-07 11:18:23,2012-02-26 11:30:12,592
31,903,965,1899,"19 days, 0:21:15",2013-02-06 08:00:42,2012-02-02 02:46:56,2012-02-21 03:08:11,820
20,191,331,542,"19 days, 1:02:53",2013-02-12 00:59:54,2012-02-02 02:46:56,2012-02-21 03:49:49,571
68,1544,1672,3284,"19 days, 1:24:12",2013-02-07 04:34:11,2012-02-02 02:46:56,2012-02-21 04:11:08,803
69,272,549,890,"19 days, 2:50:41",2013-02-07 03:13:20,2012-02-02 02:46:56,2012-02-21 05:37:37,3
105,65,83,253,"19 days, 3:05:38",2013-02-04 11:50:00,2012-04-09 00:31:11,2012-04-28 03:36:49,469
394,196,300,890,"19 days, 3:05:53",2013-02-06 08:09:02,2012-02-02 02:46:56,2012-02-21 05:52:49,393
44,2409,1653,4106,"19 days, 3:13:02",2013-02-06 00:46:30,2012-02-02 02:46:56,2012-02-21 05:59:58,109
98,191,303,592,"19 days, 3:19:40",2013-02-07 01:26:20,2012-02-02 02:46:56,2012-02-21 06:06:36,858
38,177,147,362,"19 days, 3:26:14",2013-01-31 03:06:03,2013-01-31 03:06:03,2013-02-19 06:32:17,58
287,875,1060,2222,"19 days, 4:10:25",2013-02-05 00:15:46,2012-02-02 02:46:56,2012-02-21 06:57:21,899
367,967,1256,2590,"19 days, 5:41:33",2013-02-05 06:39:32,2012-02-02 02:46:56,2012-02-21 08:28:29,352
396,823,1218,2437,"19 days, 5:49:26",2013-02-05 08:23:11,2012-02-02 02:46:56,2012-02-21 08:36:22,668
621,665,841,2127,"19 days, 8:15:11",2013-02-04 11:49:35,2012-02-02 02:46:56,2012-02-21 11:02:07,318
401,763,565,1729,"19 days, 8:37:06",2013-02-07 06:48:29,2012-02-02 02:46:56,2012-02-21 11:24:02,693
190,1092,2234,3516,"19 days, 8:53:29",2013-02-07 10:06:31,2012-02-02 02:46:56,2012-02-21 11:40:25,734
176,2192,1792,4160,"19 days, 9:09:59",2013-02-08 05:53:28,2012-02-02 02:46:56,2012-02-21 11:56:55,155
22,52,64,138,"19 days, 9:36:29",2013-02-01 05:04:11,2012-04-01 01:35:47,2012-04-20 11:12:16,566
534,161,273,968,"19 days, 18:48:57",2013-02-04 04:09:12,2012-02-21 09:08:25,2012-03-12 03:57:22,368
454,515,738,1707,"19 days, 22:08:27",2013-02-07 04:57:42,2012-02-02 02:46:56,2012-02-22 00:55:23,421
244,221,498,963,"19 days, 22:45:19",2013-02-06 04:52:07,2012-02-02 02:46:56,2012-02-22 01:32:15,333
84,64,173,321,"19 days, 23:04:45",2013-02-05 11:18:41,2012-02-02 02:46:56,2012-02-22 01:51:41,776
109,510,924,1543,"19 days, 23:59:39",2013-02-07 08:46:12,2012-02-02 02:46:56,2012-02-22 02:46:35,211
43,404,661,1108,"20 days, 0:27:13",2013-02-05 09:47:29,2012-02-02 02:46:56,2012-02-22 03:14:09,544
39,15,84,138,"20 days, 0:57:26",2013-02-03 00:38:45,2012-02-02 02:46:56,2012-02-22 03:44:22,579
262,449,732,1443,"20 days, 1:18:23",2013-02-06 02:25:20,2012-02-02 02:46:56,2012-02-22 04:05:19,947
43,152,246,441,"20 days, 2:07:58",2013-02-04 02:59:55,2012-02-02 02:46:56,2012-02-22 04:54:54,455
290,1111,1620,3021,"20 days, 2:17:15",2013-02-06 05:08:09,2012-02-02 02:46:56,2012-02-22 05:04:11,283
91,297,520,908,"20 days, 2:26:39",2013-02-07 05:14:44,2012-02-02 02:46:56,2012-02-22 05:13:35,356
339,47,68,454,"20 days, 5:22:56",2013-01-30 01:09:21,2013-01-30 01:09:21,2013-02-19 06:32:17,460
55,200,348,603,"20 days, 6:12:53",2013-02-07 02:08:31,2012-02-02 02:46:56,2012-02-22 08:59:49,567
95,1261,1221,2577,"20 days, 6:54:57",2013-02-05 07:58:13,2012-02-02 02:46:56,2012-02-22 09:41:53,532
151,78,269,498,"20 days, 7:06:21",2013-02-04 04:48:16,2012-02-02 02:46:56,2012-02-22 09:53:17,183
752,1082,1645,3479,"20 days, 7:28:45",2013-02-06 11:59:29,2012-02-02 02:46:56,2012-02-22 10:15:41,659
64,891,1262,2217,"20 days, 8:31:35",2013-02-05 09:37:25,2012-02-02 02:46:56,2012-02-22 11:18:31,735
285,27,70,382,"20 days, 15:06:53",2013-02-03 05:26:16,2012-04-20 11:52:20,2012-05-11 02:59:13,690
43,175,256,474,"20 days, 21:15:50",2013-02-04 06:45:45,2012-02-02 02:46:56,2012-02-23 00:02:46,233
148,554,949,1651,"20 days, 21:35:54",2013-02-05 05:19:36,2012-02-02 02:46:56,2012-02-23 00:22:50,604
22,7,64,93,"20 days, 21:54:16",2013-02-01 00:19:13,2012-03-17 11:32:07,2012-04-07 09:26:23,289
407,232,344,983,"20 days, 22:13:19",2013-02-06 00:43:32,2012-02-02 02:46:56,2012-02-23 01:00:15,26
366,440,484,1290,"20 days, 22:32:20",2013-02-05 06:47:06,2012-02-02 02:46:56,2012-02-23 01:19:16,158
59,76,163,298,"20 days, 22:45:39",2013-02-06 10:01:25,2012-02-02 02:46:56,2012-02-23 01:32:35,985
387,720,618,1725,"21 days, 0:26:57",2013-02-06 07:14:36,2012-02-23 08:52:53,2012-03-15 09:19:50,83
147,1446,1949,3542,"21 days, 1:02:30",2013-02-07 09:38:23,2012-02-02 02:46:56,2012-02-23 03:49:26,505
142,1050,2507,3699,"21 days, 1:18:38",2013-02-07 01:31:56,2012-02-02 02:46:56,2012-02-23 04:05:34,430
15,548,664,1227,"21 days, 2:00:12",2013-02-06 05:32:19,2012-02-02 02:46:56,2012-02-23 04:47:08,33
212,227,354,793,"21 days, 2:11:36",2013-02-05 11:29:52,2012-02-02 02:46:56,2012-02-23 04:58:32,71
87,586,997,1670,"21 days, 2:17:56",2013-02-05 08:05:10,2012-02-02 02:46:56,2012-02-23 05:04:52,319
157,391,738,1286,"21 days, 3:31:23",2013-02-06 07:45:11,2012-02-02 02:46:56,2012-02-23 06:18:19,245
388,1260,912,2560,"21 days, 5:47:43",2013-02-05 05:59:27,2012-02-02 02:46:56,2012-02-23 08:34:39,904
63,274,747,1084,"21 days, 6:40:00",2013-02-04 03:00:19,2012-02-02 02:46:56,2012-02-23 09:26:56,196
11,633,2036,2680,"21 days, 6:59:41",2013-02-07 04:58:14,2012-02-02 02:46:56,2012-02-23 09:46:37,667
23,47,99,169,"21 days, 7:53:38",2013-01-31 00:05:53,2012-02-02 02:46:56,2012-02-23 10:40:34,974
171,419,463,1053,"21 days, 8:18:37",2013-02-13 03:00:57,2012-02-02 02:46:56,2012-02-23 11:05:33,53
94,624,655,1373,"21 days, 9:02:06",2013-02-05 08:12:31,2012-02-02 02:46:56,2012-02-23 11:49:02,664
254,617,831,1702,"21 days, 21:16:58",2013-02-05 10:21:10,2012-02-02 02:46:56,2012-02-24 00:03:54,334
10,581,684,1275,"22 days, 0:22:49",2013-02-04 11:46:36,2012-02-02 02:46:56,2012-02-24 03:09:45,251
27,655,741,1423,"22 days, 0:52:53",2013-02-07 01:35:24,2012-02-02 02:46:56,2012-02-24 03:39:49,375
9,29,96,134,"22 days, 4:03:21",2013-02-05 01:55:13,2012-05-09 01:49:48,2012-05-31 05:53:09,788
254,161,130,545,"22 days, 5:27:41",2013-02-03 11:42:50,2012-02-02 02:46:56,2012-02-24 08:14:37,934
432,145,258,835,"22 days, 6:25:47",2013-02-04 10:12:05,2012-02-02 02:46:56,2012-02-24 09:12:43,682
113,112,234,459,"22 days, 7:42:27",2013-02-05 08:43:51,2012-02-02 02:46:56,2012-02-24 10:29:23,719
135,116,211,462,"22 days, 8:26:12",2013-02-06 03:14:33,2012-02-02 02:46:56,2012-02-24 11:13:08,997
30,689,1033,1752,"22 days, 8:58:43",2013-02-07 04:00:16,2012-02-02 02:46:56,2012-02-24 11:45:39,669
157,68,176,401,"22 days, 21:27:31",2013-02-07 03:03:52,2012-02-02 02:46:56,2012-02-25 00:14:27,885
379,693,937,2009,"22 days, 22:38:59",2013-02-07 10:55:32,2012-02-02 02:46:56,2012-02-25 01:25:55,473
344,1283,1608,3235,"23 days, 0:52:10",2013-02-06 04:12:49,2012-02-02 02:46:56,2012-02-25 03:39:06,74
15,884,713,1612,"23 days, 1:03:54",2013-02-05 03:00:56,2012-02-02 02:46:56,2012-02-25 03:50:50,339
110,452,499,1061,"23 days, 1:44:00",2013-02-04 06:29:30,2012-02-02 02:46:56,2012-02-25 04:30:56,252
150,420,466,1036,"23 days, 3:51:51",2013-02-06 02:34:50,2012-02-02 02:46:56,2012-02-25 06:38:47,791
81,97,218,396,"23 days, 5:22:03",2013-02-05 06:52:28,2012-02-02 02:46:56,2012-02-25 08:08:59,72
378,458,721,1557,"23 days, 7:29:03",2013-02-06 11:56:21,2012-02-02 02:46:56,2012-02-25 10:15:59,229
195,317,505,1017,"23 days, 8:30:44",2013-02-05 08:04:32,2012-02-02 02:46:56,2012-02-25 11:17:40,673
757,1445,1324,3526,"23 days, 21:47:17",2013-02-07 06:44:58,2012-02-02 02:46:56,2012-02-26 00:34:13,510
216,1216,2256,3688,"23 days, 22:35:53",2013-02-07 11:15:24,2012-02-02 02:46:56,2012-02-26 01:22:49,680
109,953,741,1803,"23 days, 22:36:20",2013-02-07 01:11:13,2012-02-02 02:46:56,2012-02-26 01:23:16,956
40,359,533,932,"23 days, 23:35:55",2013-02-06 07:49:40,2012-02-02 02:46:56,2012-02-26 02:22:51,725
38,862,1292,2192,"24 days, 0:34:51",2013-02-07 04:40:44,2012-02-02 02:46:56,2012-02-26 03:21:47,596
402,930,1291,2623,"24 days, 0:58:08",2013-02-07 01:16:06,2012-02-02 02:46:56,2012-02-26 03:45:04,894
249,58,208,515,"24 days, 1:02:29",2013-02-05 02:33:59,2012-02-02 02:46:56,2012-02-26 03:49:25,890
171,453,634,1258,"24 days, 1:48:25",2013-02-06 02:45:52,2012-02-02 02:46:56,2012-02-26 04:35:21,685
47,45,100,192,"24 days, 1:49:10",2013-02-04 08:23:01,2012-04-06 04:12:54,2012-04-30 06:02:04,462
252,830,1721,2803,"24 days, 2:39:20",2013-02-07 06:36:53,2012-02-02 02:46:56,2012-02-26 05:26:16,426
255,315,757,1327,"24 days, 2:44:14",2013-02-05 06:22:38,2012-02-02 02:46:56,2012-02-26 05:31:10,65
122,406,469,997,"24 days, 4:56:57",2013-02-04 08:37:09,2012-02-02 02:46:56,2012-02-26 07:43:53,697
61,711,1181,1953,"24 days, 5:17:52",2013-02-04 06:43:45,2012-02-02 02:46:56,2012-02-26 08:04:48,286
16,131,200,347,"24 days, 5:50:18",2013-02-04 07:36:44,2012-02-02 02:46:56,2012-02-26 08:37:14,96
102,837,1300,2239,"24 days, 5:58:34",2013-02-06 09:38:28,2012-02-02 02:46:56,2012-02-26 08:45:30,805
77,1338,1338,2753,"24 days, 5:59:35",2013-02-07 10:11:24,2012-02-02 02:46:56,2012-02-26 08:46:31,976
199,638,818,1655,"24 days, 6:29:17",2013-02-05 08:17:10,2012-02-02 02:46:56,2012-02-26 09:16:13,476
181,115,310,606,"24 days, 6:39:59",2013-02-04 08:04:32,2012-02-02 02:46:56,2012-02-26 09:26:55,759
98,78,220,396,"24 days, 8:22:54",2013-02-01 03:29:03,2012-02-02 02:46:56,2012-02-26 11:09:50,239
253,349,427,1029,"24 days, 22:28:12",2013-02-06 02:41:34,2012-02-02 02:46:56,2012-02-27 01:15:08,414
55,115,305,475,"24 days, 22:28:55",2013-02-06 09:58:55,2012-02-02 02:46:56,2012-02-27 01:15:51,763
48,634,1216,1898,"25 days, 1:52:13",2013-02-07 04:20:53,2012-02-02 02:46:56,2012-02-27 04:39:09,849
348,122,232,702,"25 days, 2:12:18",2013-02-06 09:03:53,2012-02-02 02:46:56,2012-02-27 04:59:14,255
157,272,405,834,"25 days, 4:11:36",2013-02-06 10:55:49,2012-02-02 02:46:56,2012-02-27 06:58:32,147
29,293,435,757,"25 days, 5:45:56",2013-02-05 03:08:52,2012-02-02 02:46:56,2012-02-27 08:32:52,120
108,542,821,1471,"25 days, 7:02:12",2013-02-06 10:24:54,2012-02-02 02:46:56,2012-02-27 09:49:08,742
61,310,557,928,"25 days, 9:09:27",2013-02-06 07:23:32,2012-02-02 02:46:56,2012-02-27 11:56:23,499
138,12,65,215,"25 days, 20:53:40",2013-01-30 01:32:46,2012-10-31 05:29:44,2012-11-26 02:23:24,753
435,116,2,553,"26 days, 0:20:33",2013-02-06 08:42:17,2012-04-27 09:34:34,2012-05-23 09:55:07,332
243,472,796,1511,"26 days, 2:24:58",2013-02-07 08:23:48,2012-02-02 02:46:56,2012-02-28 05:11:54,674
285,41,33,359,"26 days, 2:30:39",2013-02-01 02:52:34,2012-04-15 00:34:33,2012-05-11 03:05:12,523
455,1200,1007,2662,"26 days, 3:42:17",2013-02-05 09:37:33,2012-02-02 02:46:56,2012-02-28 06:29:13,378
82,738,1246,2066,"26 days, 4:46:55",2013-02-06 03:37:36,2012-02-02 02:46:56,2012-02-28 07:33:51,260
151,7,98,256,"26 days, 5:11:33",2013-02-06 10:40:31,2012-02-18 01:11:15,2012-03-15 06:22:48,376
33,309,504,846,"26 days, 6:24:35",2013-02-05 10:27:43,2012-02-02 02:46:56,2012-02-28 09:11:31,741
538,473,735,1746,"26 days, 6:29:03",2013-02-06 07:22:07,2012-02-02 02:46:56,2012-02-28 09:15:59,277
436,128,302,866,"26 days, 7:18:32",2013-02-06 00:46:06,2012-02-02 02:46:56,2012-02-28 10:05:28,564
289,101,217,607,"26 days, 7:48:10",2013-02-07 04:11:48,2012-02-02 02:46:56,2012-02-28 10:35:06,529
366,46,168,580,"26 days, 14:06:46",2013-02-02 07:51:02,2012-04-11 11:50:01,2012-05-08 01:56:47,14
384,41,76,501,"26 days, 21:26:56",2013-02-03 11:05:08,2012-02-02 02:46:56,2012-02-29 00:13:52,188
382,1171,1411,2964,"27 days, 0:31:23",2013-02-05 06:19:03,2012-02-02 02:46:56,2012-02-29 03:18:19,755
22,633,931,1586,"27 days, 0:45:03",2013-02-05 10:47:51,2012-02-02 02:46:56,2012-02-29 03:31:59,678
311,4,19,334,"27 days, 1:04:16",2013-01-23 05:28:01,2013-01-23 05:28:01,2013-02-19 06:32:17,796
363,674,610,1647,"27 days, 3:12:04",2013-02-07 03:36:04,2012-02-02 02:46:56,2012-02-29 05:59:00,364
104,577,754,1435,"27 days, 3:12:50",2013-02-07 10:18:41,2012-02-02 02:46:56,2012-02-29 05:59:46,423
51,1303,1428,2782,"27 days, 3:35:30",2013-02-07 06:41:05,2012-02-02 02:46:56,2012-02-29 06:22:26,584
375,220,241,836,"27 days, 4:28:05",2013-02-03 08:00:17,2012-02-02 02:46:56,2012-02-29 07:15:01,420
52,48,154,254,"27 days, 4:39:10",2013-01-31 06:12:54,2012-02-02 02:46:56,2012-02-29 07:26:06,672
421,361,435,1217,"27 days, 5:03:46",2013-02-05 07:01:28,2012-02-02 02:46:56,2012-02-29 07:50:42,222
22,314,429,765,"27 days, 7:16:10",2013-02-05 08:49:06,2012-02-02 02:46:56,2012-02-29 10:03:06,349
231,91,227,549,"27 days, 8:06:32",2013-02-04 08:25:02,2012-02-02 02:46:56,2012-02-29 10:53:28,531
544,599,626,1769,"27 days, 22:12:10",2013-02-05 03:54:25,2012-02-02 02:46:56,2012-03-01 00:59:06,744
26,572,893,1491,"27 days, 23:11:12",2013-02-07 11:18:36,2012-02-02 02:46:56,2012-03-01 01:58:08,593
187,1073,1290,2550,"27 days, 23:52:21",2013-02-06 08:44:08,2012-02-02 02:46:56,2012-03-01 02:39:17,746
237,13,14,264,"28 days, 2:31:22",2013-02-04 04:45:57,2012-06-25 07:28:26,2012-07-23 09:59:48,97
59,90,117,266,"28 days, 3:03:13",2013-01-31 04:48:04,2012-02-13 04:31:16,2012-03-12 07:34:29,860
14,99,136,249,"28 days, 3:30:50",2013-01-30 09:53:27,2012-02-02 02:46:56,2012-03-01 06:17:46,301
681,1456,1606,3743,"28 days, 4:41:11",2013-02-06 04:48:46,2012-02-02 02:46:56,2012-03-01 07:28:07,463
56,416,661,1133,"28 days, 4:50:08",2013-02-07 05:43:04,2012-02-02 02:46:56,2012-03-01 07:37:04,661
49,1648,2224,3921,"28 days, 5:09:46",2013-02-07 04:08:25,2012-02-02 02:46:56,2012-03-01 07:56:42,402
221,108,169,498,"28 days, 5:45:35",2013-02-06 07:04:53,2012-02-02 02:46:56,2012-03-01 08:32:31,940
481,235,491,1207,"28 days, 6:07:20",2013-02-05 06:36:16,2012-02-02 02:46:56,2012-03-01 08:54:16,275
19,272,269,560,"28 days, 6:21:54",2013-02-07 03:24:06,2012-02-02 02:46:56,2012-03-01 09:08:50,261
241,1421,1784,3446,"29 days, 0:06:13",2013-02-06 10:33:01,2012-02-02 02:46:56,2012-03-02 02:53:09,6
303,3,28,334,"29 days, 0:18:13",2013-01-31 11:48:02,2012-09-19 03:54:02,2012-10-18 04:12:15,299
128,142,194,464,"29 days, 0:48:08",2013-02-04 07:20:42,2012-02-02 02:46:56,2012-03-02 03:35:04,287
276,69,105,450,"29 days, 3:50:28",2013-02-03 07:58:38,2012-02-02 02:46:56,2012-03-02 06:37:24,254
236,121,181,538,"29 days, 4:44:31",2013-02-07 03:22:08,2012-02-02 02:46:56,2012-03-02 07:31:27,303
105,241,402,748,"29 days, 5:01:17",2013-02-04 03:35:47,2012-02-02 02:46:56,2012-03-02 07:48:13,494
19,183,213,415,"29 days, 5:23:14",2013-02-06 06:32:02,2012-02-02 02:46:56,2012-03-02 08:10:10,771
276,486,670,1432,"29 days, 8:40:21",2013-02-06 10:12:03,2012-02-02 02:46:56,2012-03-02 11:27:17,244
2,82,81,165,"29 days, 9:01:40",2013-02-03 09:08:51,2012-02-02 02:46:56,2012-03-02 11:48:36,306
54,23,69,146,"29 days, 15:12:07",2013-02-05 09:14:14,2012-11-14 10:58:20,2012-12-14 02:10:27,591
142,268,502,912,"29 days, 22:37:45",2013-02-06 11:20:47,2012-02-02 02:46:56,2012-03-03 01:24:41,408
178,404,462,1044,"30 days, 0:09:10",2013-02-06 05:21:42,2012-02-02 02:46:56,2012-03-03 02:56:06,112
36,437,653,1126,"30 days, 0:41:10",2013-02-07 00:02:05,2012-02-02 02:46:56,2012-03-03 03:28:06,184
348,20,46,414,"30 days, 1:59:50",2013-02-06 07:15:50,2012-02-02 02:46:56,2012-03-03 04:46:46,49
524,1,0,525,"30 days, 2:20:20",2013-02-04 10:01:20,2012-06-23 03:03:03,2012-07-23 05:23:23,851
353,478,657,1488,"30 days, 3:06:29",2013-02-07 01:06:33,2012-02-02 02:46:56,2012-03-03 05:53:25,21
2,36,180,218,"30 days, 3:13:04",2013-02-06 11:27:43,2012-02-02 02:46:56,2012-03-03 06:00:00,982
33,101,170,304,"30 days, 3:25:49",2013-02-04 10:12:09,2012-02-02 02:46:56,2012-03-03 06:12:45,139
43,136,208,387,"30 days, 4:53:03",2013-02-04 09:32:48,2012-02-02 02:46:56,2012-03-03 07:39:59,642
272,118,200,590,"30 days, 6:50:38",2013-02-02 02:42:23,2012-02-02 02:46:56,2012-03-03 09:37:34,179
26,51,152,229,"30 days, 7:56:02",2013-02-05 08:52:52,2012-02-23 02:18:58,2012-03-24 10:15:00,143
239,391,400,1030,"30 days, 8:06:22",2013-02-06 11:49:38,2012-02-02 02:46:56,2012-03-03 10:53:18,830
15,319,399,733,"30 days, 8:08:13",2013-02-05 00:13:18,2012-02-02 02:46:56,2012-03-03 10:55:09,358
200,244,226,670,"30 days, 23:18:50",2013-02-02 05:10:19,2012-02-02 02:46:56,2012-03-04 02:05:46,863
111,166,256,533,"31 days, 0:28:09",2013-02-06 05:20:01,2012-02-02 02:46:56,2012-03-04 03:15:05,748
52,383,411,846,"31 days, 1:03:12",2013-02-05 07:03:47,2012-02-02 02:46:56,2012-03-04 03:50:08,477
5,40,125,170,"31 days, 1:31:25",2013-02-03 09:50:27,2012-02-02 02:46:56,2012-03-04 04:18:21,733
215,861,692,1768,"31 days, 2:21:08",2013-02-06 08:18:42,2012-02-02 02:46:56,2012-03-04 05:08:04,86
227,89,201,517,"31 days, 2:51:09",2013-02-06 05:54:46,2012-02-02 02:46:56,2012-03-04 05:38:05,452
41,10,36,87,"31 days, 3:01:47",2013-02-05 06:44:09,2012-05-05 08:16:47,2012-06-05 11:18:34,909
18,53,135,206,"31 days, 6:23:25",2013-02-04 09:21:25,2012-02-02 02:46:56,2012-03-04 09:10:21,52
55,417,470,942,"31 days, 7:09:51",2013-02-04 09:33:57,2012-02-02 02:46:56,2012-03-04 09:56:47,321
13,56,237,306,"31 days, 7:37:22",2013-02-04 11:15:22,2012-02-02 02:46:56,2012-03-04 10:24:18,695
534,487,635,1656,"31 days, 9:05:32",2013-02-06 10:35:44,2012-02-02 02:46:56,2012-03-04 11:52:28,168
52,107,153,312,"31 days, 13:10:33",2013-02-01 09:18:32,2012-07-04 11:11:01,2012-08-05 00:21:34,464
128,61,145,334,"31 days, 16:21:16",2013-02-01 02:30:52,2012-04-04 10:28:31,2012-05-06 02:49:47,813
22,29,101,152,"31 days, 22:41:55",2013-02-01 03:01:14,2012-05-16 02:48:08,2012-06-17 01:30:03,124
170,222,260,652,"32 days, 2:51:13",2013-02-06 06:54:34,2012-02-02 02:46:56,2012-03-05 05:38:09,649
101,41,83,225,"32 days, 5:35:06",2013-02-05 04:09:13,2012-02-24 05:52:49,2012-03-27 11:27:55,50
38,687,329,1054,"32 days, 5:47:14",2013-02-06 10:44:21,2012-02-02 02:46:56,2012-03-05 08:34:10,13
212,99,229,540,"32 days, 6:16:50",2013-02-07 00:27:46,2012-02-02 02:46:56,2012-03-05 09:03:46,779
343,858,901,2102,"32 days, 8:23:31",2013-02-06 00:44:25,2012-02-02 02:46:56,2012-03-05 11:10:27,151
35,112,151,298,"32 days, 22:50:23",2013-02-07 05:24:30,2012-02-02 02:46:56,2012-03-06 01:37:19,134
454,335,413,1202,"32 days, 23:10:28",2013-02-05 09:37:44,2012-02-02 02:46:56,2012-03-06 01:57:24,362
23,320,370,713,"32 days, 23:58:57",2013-02-06 02:46:42,2012-02-02 02:46:56,2012-03-06 02:45:53,369
188,816,708,1712,"33 days, 5:54:29",2013-02-05 08:03:49,2012-02-02 02:46:56,2012-03-06 08:41:25,539
211,1056,653,1920,"33 days, 5:58:22",2013-02-04 11:55:40,2012-02-02 02:46:56,2012-03-06 08:45:18,11
121,88,369,578,"33 days, 8:14:51",2013-02-07 07:55:43,2012-02-02 02:46:56,2012-03-06 11:01:47,783
40,151,232,423,"33 days, 22:38:28",2013-02-02 06:54:34,2012-02-02 02:46:56,2012-03-07 01:25:24,542
589,335,617,1541,"34 days, 0:24:01",2013-02-06 00:23:38,2012-02-02 02:46:56,2012-03-07 03:10:57,570
27,25,79,131,"34 days, 0:27:36",2013-02-03 07:58:59,2012-02-02 02:46:56,2012-03-07 03:14:32,927
204,383,530,1117,"34 days, 4:24:57",2013-02-06 06:27:59,2012-02-02 02:46:56,2012-03-07 07:11:53,291
43,534,522,1099,"34 days, 4:46:27",2013-02-06 01:44:36,2012-02-02 02:46:56,2012-03-07 07:33:23,98
105,2,28,135,"34 days, 7:03:59",2013-02-05 02:49:04,2012-09-13 01:37:56,2012-10-17 08:41:55,486
257,561,1070,1888,"34 days, 21:17:26",2013-02-07 09:26:29,2012-02-02 02:46:56,2012-03-08 00:04:22,612
281,60,141,482,"34 days, 21:27:43",2013-02-02 08:13:44,2012-02-02 02:46:56,2012-03-08 00:14:39,78
16,56,201,273,"34 days, 22:48:56",2013-02-07 03:21:50,2012-02-02 02:46:56,2012-03-08 01:35:52,145
242,96,242,580,"35 days, 0:04:13",2013-02-07 11:44:19,2012-02-02 02:46:56,2012-03-08 02:51:09,828
218,223,409,850,"35 days, 3:37:25",2013-02-07 01:41:14,2012-02-02 02:46:56,2012-03-08 06:24:21,519
155,0,2,157,"35 days, 4:12:54",2013-01-31 08:33:00,2012-12-27 04:20:06,2013-01-31 08:33:00,800
349,0,0,349,"35 days, 6:10:04",2013-01-17 04:11:46,2012-05-12 01:59:03,2012-06-16 08:09:07,708
187,329,442,958,"35 days, 6:24:31",2013-02-05 07:01:36,2012-02-02 02:46:56,2012-03-08 09:11:27,95
9,32,115,156,"35 days, 6:54:05",2013-02-03 05:26:23,2012-02-02 02:46:56,2012-03-08 09:41:01,651
24,120,101,245,"35 days, 8:50:23",2013-01-30 04:44:47,2012-02-02 02:46:56,2012-03-08 11:37:19,12
310,5,20,335,"35 days, 21:28:08",2013-01-31 01:00:22,2012-11-06 05:58:42,2012-12-12 03:26:50,170
224,324,338,886,"36 days, 1:56:00",2013-02-07 00:58:54,2012-02-02 02:46:56,2012-03-09 04:42:56,167
319,40,161,520,"36 days, 4:17:37",2013-02-05 02:52:07,2012-02-02 02:46:56,2012-03-09 07:04:33,509
41,109,199,349,"36 days, 4:18:33",2013-02-06 11:33:57,2012-02-02 02:46:56,2012-03-09 07:05:29,644
15,93,106,214,"36 days, 4:48:03",2013-02-09 03:11:27,2012-02-02 02:46:56,2012-03-09 07:34:59,526
86,42,142,270,"36 days, 14:03:52",2013-02-05 07:17:31,2012-05-05 11:04:55,2012-06-11 01:08:47,729
219,109,179,507,"36 days, 21:31:02",2013-02-04 02:38:02,2012-02-02 02:46:56,2012-03-10 00:17:58,198
61,51,111,223,"36 days, 23:57:46",2013-02-03 01:38:36,2012-02-02 02:46:56,2012-03-10 02:44:42,781
9,21,53,83,"37 days, 0:08:17",2013-01-26 11:49:36,2012-02-02 02:46:56,2012-03-10 02:55:13,315
29,296,325,650,"37 days, 1:21:25",2013-02-06 07:30:04,2012-02-02 02:46:56,2012-03-10 04:08:21,153
108,7,13,128,"37 days, 3:20:07",2013-01-31 04:20:57,2012-04-18 07:55:52,2012-05-25 11:15:59,285
7,66,102,175,"37 days, 5:51:49",2013-02-02 09:06:48,2012-02-02 02:46:56,2012-03-10 08:38:45,360
200,47,111,358,"37 days, 19:54:37",2013-02-06 05:42:13,2012-04-24 11:19:06,2012-06-01 07:13:43,772
96,319,601,1016,"38 days, 0:37:24",2013-02-05 02:34:59,2012-02-02 02:46:56,2012-03-11 03:24:20,253
121,26,159,306,"38 days, 4:04:07",2013-02-06 01:11:44,2012-02-02 02:46:56,2012-03-11 06:51:03,123
38,40,112,190,"38 days, 4:56:27",2013-02-02 05:26:41,2012-02-02 02:46:56,2012-03-11 07:43:23,665
72,71,225,368,"38 days, 6:54:19",2013-02-05 09:51:57,2012-02-02 02:46:56,2012-03-11 09:41:15,736
111,47,111,269,"38 days, 8:04:04",2013-02-07 02:31:02,2012-02-02 02:46:56,2012-03-11 10:51:00,688
41,149,210,400,"38 days, 21:44:52",2013-02-04 03:51:46,2012-02-02 02:46:56,2012-03-12 00:31:48,34
20,230,199,449,"39 days, 2:15:04",2013-02-04 02:53:47,2012-02-02 02:46:56,2012-03-12 05:02:00,967
286,621,826,1733,"39 days, 3:46:14",2013-02-07 01:25:22,2012-02-02 02:46:56,2012-03-12 06:33:10,785
446,251,333,1030,"39 days, 3:55:14",2013-02-04 06:22:10,2012-02-02 02:46:56,2012-03-12 06:42:10,250
27,94,207,328,"39 days, 7:34:38",2013-02-04 09:31:59,2012-02-02 02:46:56,2012-03-12 10:21:34,701
148,545,685,1378,"39 days, 7:57:16",2013-02-04 05:41:43,2012-02-02 02:46:56,2012-03-12 10:44:12,193
197,2,8,207,"39 days, 20:23:12",2013-01-14 00:26:39,2012-03-22 07:31:04,2012-05-01 03:54:16,916
43,104,135,282,"39 days, 23:10:08",2013-02-02 11:27:45,2012-02-02 02:46:56,2012-03-13 01:57:04,704
421,535,1183,2139,"39 days, 23:38:11",2013-02-07 09:03:32,2012-02-02 02:46:56,2012-03-13 02:25:07,495
392,0,0,392,"40 days, 4:04:00",2013-01-25 05:19:14,2012-02-02 02:46:56,2012-03-13 06:50:56,206
130,328,383,841,"40 days, 6:42:21",2013-02-05 02:51:55,2012-02-02 02:46:56,2012-03-13 09:29:17,908
245,7,34,286,"40 days, 21:17:19",2013-02-02 00:28:39,2012-02-02 02:46:56,2012-03-14 00:04:15,597
34,282,457,773,"40 days, 22:57:36",2013-02-03 02:03:23,2012-02-02 02:46:56,2012-03-14 01:44:32,864
69,240,208,517,"40 days, 22:57:48",2013-02-04 10:56:26,2012-02-02 02:46:56,2012-03-14 01:44:44,380
320,14,29,363,"40 days, 23:04:04",2013-02-02 02:30:13,2012-02-02 02:46:56,2012-03-14 01:51:00,554
37,41,163,241,"41 days, 0:59:24",2013-02-05 09:10:25,2012-03-28 04:05:04,2012-05-08 05:04:28,766
20,730,965,1715,"41 days, 2:33:40",2013-02-06 09:30:20,2012-02-02 02:46:56,2012-03-14 05:20:36,525
360,38,125,523,"41 days, 4:15:29",2013-02-04 09:49:14,2012-02-02 02:46:56,2012-03-14 07:02:25,574
107,349,319,775,"41 days, 5:11:48",2013-02-03 07:07:51,2012-02-02 02:46:56,2012-03-14 07:58:44,441
69,1,17,87,"41 days, 5:49:05",2013-01-30 08:54:11,2012-02-02 02:46:56,2012-03-14 08:36:01,302
51,222,473,746,"41 days, 6:09:31",2013-02-07 00:57:48,2012-02-02 02:46:56,2012-03-14 08:56:27,727
413,624,553,1590,"41 days, 21:46:03",2013-02-05 03:11:29,2012-02-02 02:46:56,2012-03-15 00:32:59,975
57,361,407,825,"41 days, 22:37:53",2013-02-06 11:43:03,2012-02-02 02:46:56,2012-03-15 01:24:49,639
55,11,61,127,"41 days, 23:17:09",2013-01-30 03:21:23,2012-02-02 02:46:56,2012-03-15 02:04:05,879
163,20,69,252,"42 days, 2:07:39",2013-01-29 11:41:39,2012-02-02 02:46:56,2012-03-15 04:54:35,504
95,36,83,214,"42 days, 2:13:20",2013-02-03 10:19:47,2012-02-02 02:46:56,2012-03-15 05:00:16,603
9,108,162,279,"42 days, 7:49:44",2013-02-05 11:17:56,2012-02-02 02:46:56,2012-03-15 10:36:40,298
11,572,698,1281,"42 days, 23:49:20",2013-02-06 05:39:14,2012-02-02 02:46:56,2012-03-16 02:36:16,485
100,139,326,565,"43 days, 2:49:17",2013-02-07 03:23:59,2012-02-02 02:46:56,2012-03-16 05:36:13,700
89,68,96,253,"43 days, 3:01:14",2013-02-05 08:25:30,2012-02-02 02:46:56,2012-03-16 05:48:10,637
99,88,313,500,"43 days, 3:18:10",2013-02-03 10:48:38,2012-02-02 02:46:56,2012-03-16 06:05:06,475
95,192,340,627,"43 days, 6:16:46",2013-02-05 11:49:21,2012-02-02 02:46:56,2012-03-16 09:03:42,822
47,37,75,159,"43 days, 23:19:55",2013-02-04 09:08:23,2012-02-02 02:46:56,2012-03-17 02:06:51,703
10,190,431,631,"43 days, 23:33:41",2013-02-05 09:46:20,2012-02-02 02:46:56,2012-03-17 02:20:37,715
7,108,109,224,"44 days, 0:36:16",2013-02-07 03:33:19,2012-02-02 02:46:56,2012-03-17 03:23:12,416
94,64,215,373,"44 days, 0:45:53",2013-02-04 07:24:39,2012-02-02 02:46:56,2012-03-17 03:32:49,686
150,8,8,166,"44 days, 1:11:27",2013-01-14 09:10:02,2012-08-09 07:38:04,2012-09-22 08:49:31,619
70,239,488,797,"44 days, 1:29:43",2013-02-07 05:35:28,2012-02-02 02:46:56,2012-03-17 04:16:39,62
276,151,348,775,"44 days, 1:35:54",2013-02-06 05:19:10,2012-02-02 02:46:56,2012-03-17 04:22:50,777
299,124,161,584,"44 days, 4:27:16",2013-02-06 07:40:02,2012-02-02 02:46:56,2012-03-17 07:14:12,218
6,268,341,615,"44 days, 6:38:03",2013-02-05 03:14:36,2012-02-02 02:46:56,2012-03-17 09:24:59,172
48,57,82,187,"44 days, 7:01:47",2013-02-03 03:41:13,2012-02-02 02:46:56,2012-03-17 09:48:43,907
185,80,129,394,"44 days, 7:09:03",2013-02-01 09:44:25,2012-02-02 02:46:56,2012-03-17 09:55:59,202
154,20,96,270,"44 days, 8:15:39",2013-01-30 03:50:52,2012-02-02 02:46:56,2012-03-17 11:02:35,623
493,458,450,1401,"44 days, 8:50:54",2013-02-06 03:25:04,2012-02-02 02:46:56,2012-03-17 11:37:50,81
327,0,0,327,"44 days, 20:30:57",2013-01-21 09:45:00,2012-09-30 03:52:25,2012-11-14 00:23:22,382
12,186,264,462,"44 days, 22:22:32",2013-02-05 05:40:27,2012-02-02 02:46:56,2012-03-18 01:09:28,569
196,6,61,263,"44 days, 22:59:39",2013-01-28 08:45:39,2012-05-25 06:46:43,2012-07-09 05:46:22,56
53,83,192,328,"44 days, 23:28:05",2013-01-30 10:57:10,2012-02-02 02:46:56,2012-03-18 02:15:01,7
40,4,28,72,"45 days, 3:35:52",2013-01-28 07:50:01,2012-06-29 06:38:44,2012-08-13 10:14:36,893
98,49,196,343,"45 days, 4:00:48",2013-02-06 01:27:53,2012-02-02 02:46:56,2012-03-18 06:47:44,630
48,109,206,363,"45 days, 4:11:56",2013-02-06 00:47:09,2012-02-02 02:46:56,2012-03-18 06:58:52,751
65,145,309,519,"45 days, 5:47:29",2013-02-04 06:52:02,2012-02-02 02:46:56,2012-03-18 08:34:25,802
66,122,421,609,"45 days, 6:47:26",2013-02-05 06:13:52,2012-02-02 02:46:56,2012-03-18 09:34:22,312
181,3,13,197,"45 days, 8:12:59",2013-01-17 06:38:13,2012-02-02 02:46:56,2012-03-18 10:59:55,340
27,275,527,829,"46 days, 0:34:52",2013-02-06 01:21:57,2012-02-02 02:46:56,2012-03-19 03:21:48,578
41,183,319,543,"46 days, 4:28:36",2013-02-05 10:43:26,2012-02-02 02:46:56,2012-03-19 07:15:32,105
45,49,122,216,"46 days, 5:19:49",2013-02-06 06:57:42,2012-02-02 02:46:56,2012-03-19 08:06:45,549
123,274,474,871,"46 days, 9:05:59",2013-02-05 04:26:28,2012-02-02 02:46:56,2012-03-19 11:52:55,491
437,172,183,792,"46 days, 21:49:39",2013-02-06 10:45:24,2012-02-02 02:46:56,2012-03-20 00:36:35,110
9,34,78,121,"47 days, 3:01:17",2013-02-01 06:39:23,2012-03-22 06:28:22,2012-05-08 09:29:39,897
177,0,5,182,"47 days, 3:41:09",2013-01-29 06:47:08,2012-02-02 02:46:56,2012-03-20 06:28:05,308
335,5,41,381,"47 days, 21:56:58",2013-02-04 07:29:02,2012-02-02 02:46:56,2012-03-21 00:43:54,468
4,95,92,191,"48 days, 0:33:41",2013-02-06 11:03:45,2012-02-02 02:46:56,2012-03-21 03:20:37,453
67,35,68,170,"48 days, 1:39:46",2013-02-02 07:50:40,2012-02-02 02:46:56,2012-03-21 04:26:42,403
222,8,58,288,"48 days, 1:56:36",2013-01-24 00:55:52,2012-03-05 09:20:08,2012-04-22 11:16:44,176
66,3,8,77,"48 days, 2:38:19",2013-01-27 06:50:33,2012-06-03 00:27:23,2012-07-21 03:05:42,45
279,1,0,280,"48 days, 2:56:04",2013-01-25 04:03:05,2012-02-02 02:46:56,2012-03-21 05:43:00,399
41,116,120,277,"48 days, 7:45:48",2013-02-04 05:45:50,2012-02-02 02:46:56,2012-03-21 10:32:44,677
52,13,34,99,"48 days, 8:42:14",2013-02-04 06:48:18,2012-02-02 02:46:56,2012-03-21 11:29:10,390
44,10,55,109,"48 days, 8:54:08",2013-01-31 05:28:05,2012-02-02 02:46:56,2012-03-21 11:41:04,133
124,2,15,141,"48 days, 21:39:16",2013-01-30 10:50:03,2012-04-04 10:27:46,2012-05-23 08:07:02,32
270,16,51,337,"49 days, 0:55:31",2013-02-02 00:21:29,2012-02-02 02:46:56,2012-03-22 03:42:27,845
27,9,21,57,"49 days, 6:17:49",2013-01-31 02:31:34,2012-04-17 04:47:51,2012-06-05 11:05:40,175
11,15,42,68,"49 days, 7:03:29",2013-02-04 08:52:20,2012-02-02 02:46:56,2012-03-22 09:50:25,887
8,94,193,295,"49 days, 7:24:58",2013-02-05 09:48:57,2012-02-02 02:46:56,2012-03-22 10:11:54,482
9,5,44,58,"49 days, 8:47:04",2013-01-26 03:41:21,2012-04-18 02:02:34,2012-06-06 10:49:38,466
262,74,134,470,"49 days, 23:41:44",2013-02-02 11:07:48,2012-02-02 02:46:56,2012-03-23 02:28:40,329
46,39,106,191,"50 days, 0:42:49",2013-01-29 04:03:22,2012-02-02 02:46:56,2012-03-23 03:29:45,823
48,129,232,409,"50 days, 2:22:45",2013-02-03 10:29:35,2012-02-02 02:46:56,2012-03-23 05:09:41,609
368,0,18,386,"50 days, 5:10:54",2013-02-04 06:42:38,2012-02-02 02:46:56,2012-03-23 07:57:50,607
335,59,95,489,"50 days, 5:41:32",2013-02-03 00:58:56,2012-02-02 02:46:56,2012-03-23 08:28:28,125
7,0,27,34,"50 days, 7:46:35",2013-02-03 11:48:39,2012-02-02 02:46:56,2012-03-23 10:33:31,852
5,30,90,125,"51 days, 0:35:50",2013-02-05 00:00:44,2012-02-02 02:46:56,2012-03-24 03:22:46,656
312,37,96,445,"51 days, 6:32:18",2013-01-31 03:37:05,2012-02-02 02:46:56,2012-03-24 09:19:14,284
194,23,100,317,"51 days, 21:39:59",2013-01-31 07:11:37,2012-02-02 02:46:56,2012-03-25 00:26:55,241
171,88,155,414,"51 days, 22:53:36",2013-02-04 02:35:25,2012-02-02 02:46:56,2012-03-25 01:40:32,66
100,34,140,274,"52 days, 2:28:17",2013-02-05 02:05:20,2012-02-02 02:46:56,2012-03-25 05:15:13,843
34,39,135,208,"52 days, 3:24:39",2013-02-04 04:58:00,2012-02-02 02:46:56,2012-03-25 06:11:35,691
249,211,217,677,"52 days, 4:55:05",2013-02-03 05:24:05,2012-02-02 02:46:56,2012-03-25 07:42:01,82
71,20,97,188,"52 days, 9:00:21",2013-02-06 05:45:40,2012-02-02 02:46:56,2012-03-25 11:47:17,164
6,69,129,204,"52 days, 21:35:34",2013-02-03 08:52:57,2012-02-02 02:46:56,2012-03-26 00:22:30,442
178,208,475,861,"53 days, 0:08:12",2013-02-04 11:08:28,2012-02-02 02:46:56,2012-03-26 02:55:08,931
38,2,35,75,"53 days, 4:10:37",2013-02-05 10:01:38,2012-02-02 02:46:56,2012-03-26 06:57:33,923
1,94,93,188,"53 days, 5:49:01",2013-02-06 01:41:58,2012-02-02 02:46:56,2012-03-26 08:35:57,322
98,35,98,231,"53 days, 7:32:29",2013-02-06 11:38:03,2012-02-02 02:46:56,2012-03-26 10:19:25,606
82,40,148,270,"53 days, 7:56:48",2013-02-04 02:30:47,2012-02-02 02:46:56,2012-03-26 10:43:44,337
233,0,11,244,"54 days, 0:51:04",2013-01-25 03:13:42,2012-02-02 02:46:56,2012-03-27 03:38:00,163
372,59,87,518,"54 days, 1:08:58",2013-02-03 08:20:19,2012-02-02 02:46:56,2012-03-27 03:55:54,117
5,80,169,254,"54 days, 8:55:41",2013-02-02 07:00:16,2012-02-02 02:46:56,2012-03-27 11:42:37,39
28,146,237,411,"54 days, 21:47:28",2013-02-04 10:54:43,2012-02-02 02:46:56,2012-03-28 00:34:24,611
409,51,130,590,"54 days, 22:24:30",2013-02-03 06:32:34,2012-02-02 02:46:56,2012-03-28 01:11:26,585
108,47,63,218,"55 days, 1:16:21",2013-02-02 07:14:25,2012-02-02 02:46:56,2012-03-28 04:03:17,652
207,13,33,253,"55 days, 6:17:58",2013-02-02 08:45:11,2012-02-02 02:46:56,2012-03-28 09:04:54,933
140,32,109,281,"55 days, 7:01:17",2013-02-04 08:33:27,2012-02-02 02:46:56,2012-03-28 09:48:13,30
221,4,31,256,"55 days, 7:35:16",2013-01-29 10:27:45,2012-02-02 02:46:56,2012-03-28 10:22:12,67
51,49,112,212,"55 days, 8:53:41",2013-02-01 09:12:33,2012-02-02 02:46:56,2012-03-28 11:40:37,925
37,89,298,424,"56 days, 2:41:55",2013-02-07 02:24:57,2012-02-02 02:46:56,2012-03-29 05:28:51,440
83,88,156,327,"56 days, 3:49:24",2013-02-06 10:24:10,2012-02-02 02:46:56,2012-03-29 06:36:20,111
153,2,19,174,"56 days, 4:58:23",2013-02-03 07:10:13,2012-02-02 02:46:56,2012-03-29 07:45:19,906
1,75,145,221,"56 days, 5:24:16",2013-02-03 06:12:18,2012-02-02 02:46:56,2012-03-29 08:11:12,474
42,23,109,174,"56 days, 21:49:42",2013-02-02 07:59:50,2012-02-02 02:46:56,2012-03-30 00:36:38,955
261,49,84,394,"57 days, 2:06:07",2013-02-03 05:00:37,2012-02-02 02:46:56,2012-03-30 04:53:03,445
7,89,277,373,"57 days, 2:17:42",2013-02-04 08:18:35,2012-02-02 02:46:56,2012-03-30 05:04:38,224
21,87,147,255,"57 days, 5:18:37",2013-02-03 09:26:39,2012-02-02 02:46:56,2012-03-30 08:05:33,171
12,16,23,51,"57 days, 7:40:16",2013-01-29 03:10:05,2012-02-02 02:46:56,2012-03-30 10:27:12,662
0,2,36,38,"57 days, 22:45:45",2013-02-03 02:29:51,2012-05-11 04:16:16,2012-07-08 03:02:01,622
0,0,14,14,"58 days, 1:17:22",2013-01-25 02:32:51,2012-04-25 03:58:56,2012-06-22 05:16:18,645
478,196,343,1017,"58 days, 1:41:39",2013-02-04 06:46:25,2012-02-02 02:46:56,2012-03-31 04:28:35,550
193,65,189,447,"58 days, 4:24:05",2013-02-05 04:05:08,2012-02-02 02:46:56,2012-03-31 07:11:01,572
431,195,245,871,"58 days, 5:51:35",2013-02-07 07:25:08,2012-02-02 02:46:56,2012-03-31 08:38:31,745
38,28,131,197,"58 days, 5:52:38",2013-02-05 05:35:47,2012-02-02 02:46:56,2012-03-31 08:39:34,679
74,73,85,232,"58 days, 6:33:06",2013-01-30 10:11:22,2012-02-02 02:46:56,2012-03-31 09:20:02,116
360,46,102,508,"58 days, 6:48:05",2013-02-03 10:24:22,2012-02-02 02:46:56,2012-03-31 09:35:01,775
375,177,405,957,"58 days, 7:28:35",2013-02-05 10:59:26,2012-02-02 02:46:56,2012-03-31 10:15:31,118
139,121,83,343,"59 days, 3:01:44",2013-01-27 07:56:08,2012-02-02 02:46:56,2012-04-01 05:48:40,966
57,70,132,259,"59 days, 6:29:12",2013-02-03 11:07:07,2012-03-12 03:27:07,2012-05-10 09:56:19,243
111,40,119,270,"59 days, 8:12:25",2013-02-04 05:08:26,2012-02-02 02:46:56,2012-04-01 10:59:21,341
150,4,21,175,"59 days, 20:49:50",2013-01-30 08:34:01,2012-03-24 08:58:22,2012-05-23 05:48:12,154
223,1,16,240,"59 days, 23:10:54",2013-01-26 02:24:25,2012-02-02 02:46:56,2012-04-02 01:57:50,543
383,22,27,432,"60 days, 0:58:42",2013-02-03 01:21:54,2012-02-02 02:46:56,2012-04-02 03:45:38,520
65,174,566,805,"60 days, 3:06:56",2013-02-05 10:58:13,2012-02-02 02:46:56,2012-04-02 05:53:52,18
128,106,159,393,"60 days, 22:43:09",2013-02-02 02:55:16,2012-02-02 02:46:56,2012-04-03 01:30:05,226
199,2,15,216,"61 days, 7:38:35",2013-01-21 04:05:09,2012-02-02 02:46:56,2012-04-03 10:25:31,80
56,16,60,132,"62 days, 1:25:59",2013-01-25 10:16:01,2012-02-02 02:46:56,2012-04-04 04:12:55,59
0,36,85,121,"62 days, 2:27:55",2013-02-04 03:52:34,2012-04-07 08:28:32,2012-06-08 10:56:27,487
1,1,17,19,"62 days, 8:32:31",2013-01-22 07:39:30,2012-02-02 02:46:56,2012-04-04 11:19:27,853
107,227,222,556,"62 days, 8:44:18",2013-02-05 03:46:48,2012-02-02 02:46:56,2012-04-04 11:31:14,608
2,0,27,29,"62 days, 23:00:21",2013-01-24 02:07:17,2012-02-02 02:46:56,2012-04-05 01:47:17,621
26,26,36,88,"63 days, 5:54:56",2013-01-31 07:17:06,2012-02-02 02:46:56,2012-04-05 08:41:52,846
45,92,295,432,"63 days, 7:40:11",2013-02-05 01:38:29,2012-02-02 02:46:56,2012-04-05 10:27:07,613
68,687,581,1336,"63 days, 8:20:28",2013-02-07 05:04:07,2012-02-02 02:46:56,2012-04-05 11:07:24,767
1,6,38,45,"64 days, 0:55:37",2013-01-01 04:50:10,2012-02-02 02:46:56,2012-04-06 03:42:33,214
138,66,165,369,"64 days, 4:13:14",2013-02-03 00:34:39,2012-02-02 02:46:56,2012-04-06 07:00:10,657
289,0,4,293,"64 days, 4:52:17",2013-02-13 05:50:48,2012-02-02 02:46:56,2012-04-06 07:39:13,760
282,111,120,513,"64 days, 5:03:45",2013-02-03 03:13:39,2012-02-02 02:46:56,2012-04-06 07:50:41,575
24,56,77,157,"65 days, 14:43:49",2013-02-06 03:10:46,2012-05-06 09:57:24,2012-07-11 00:41:13,815
6,8,14,28,"66 days, 0:31:50",2013-01-25 10:18:36,2012-03-20 07:11:23,2012-05-25 07:43:13,443
226,0,1,227,"66 days, 8:57:23",2013-01-09 05:38:31,2012-02-02 02:46:56,2012-04-08 11:44:19,489
432,56,141,629,"66 days, 23:02:51",2013-02-07 10:06:37,2012-02-02 02:46:56,2012-04-09 01:49:47,694
142,153,183,478,"66 days, 23:12:10",2013-02-04 11:29:53,2012-02-02 02:46:56,2012-04-09 01:59:06,731
28,8,21,57,"67 days, 1:14:03",2013-01-31 02:18:47,2012-02-02 02:46:56,2012-04-09 04:00:59,259
91,71,149,311,"67 days, 5:07:49",2013-02-03 11:26:09,2012-02-02 02:46:56,2012-04-09 07:54:45,444
64,1,12,77,"67 days, 5:14:08",2013-01-31 00:23:22,2012-02-02 02:46:56,2012-04-09 08:01:04,961
314,250,263,827,"68 days, 3:40:59",2013-02-07 09:06:35,2012-02-02 02:46:56,2012-04-10 06:27:55,761
46,124,188,358,"68 days, 5:53:40",2013-02-06 06:17:37,2012-02-02 02:46:56,2012-04-10 08:40:36,320
38,4,32,74,"68 days, 21:10:14",2013-01-30 01:11:26,2012-03-03 04:24:37,2012-05-11 01:34:51,877
185,20,29,234,"69 days, 2:20:21",2013-02-06 05:37:42,2012-02-02 02:46:56,2012-04-11 05:07:17,282
326,1,10,337,"69 days, 2:57:31",2013-01-26 03:38:43,2012-02-02 02:46:56,2012-04-11 05:44:27,439
179,11,32,222,"70 days, 2:20:16",2013-02-05 01:13:18,2012-02-02 02:46:56,2012-04-12 05:07:12,743
1,1,28,30,"70 days, 4:02:47",2013-02-03 04:26:37,2012-02-02 02:46:56,2012-04-12 06:49:43,195
170,6,51,227,"70 days, 5:33:34",2013-02-04 11:45:55,2012-02-02 02:46:56,2012-04-12 08:20:30,386
111,16,26,153,"70 days, 7:27:52",2013-02-02 07:08:05,2012-02-02 02:46:56,2012-04-12 10:14:48,540
278,3,20,301,"70 days, 21:43:27",2013-01-17 06:39:39,2012-04-17 09:37:02,2012-06-27 07:20:29,9
32,65,85,182,"71 days, 1:57:50",2013-01-26 04:08:04,2012-02-02 02:46:56,2012-04-13 04:44:46,472
204,0,8,212,"71 days, 4:27:24",2013-01-31 01:25:18,2012-02-02 02:46:56,2012-04-13 07:14:20,90
82,15,61,158,"71 days, 6:52:09",2013-02-03 02:54:23,2012-02-02 02:46:56,2012-04-13 09:39:05,939
42,93,155,290,"71 days, 8:13:13",2013-02-05 11:16:41,2012-02-02 02:46:56,2012-04-13 11:00:09,425
59,11,60,130,"73 days, 0:53:20",2013-02-03 08:11:11,2012-02-02 02:46:56,2012-04-15 03:40:16,518
86,56,141,283,"73 days, 2:30:03",2013-02-03 11:47:25,2012-02-02 02:46:56,2012-04-15 05:16:59,770
33,77,174,284,"73 days, 4:02:54",2013-02-04 08:04:17,2012-02-02 02:46:56,2012-04-15 06:49:50,884
44,24,23,91,"73 days, 5:48:49",2013-02-12 07:34:17,2012-05-02 01:35:20,2012-07-14 07:24:09,601
4,1,29,34,"73 days, 21:28:56",2013-02-05 03:13:45,2012-07-25 05:04:52,2012-10-07 02:33:48,768
27,14,44,85,"73 days, 22:44:49",2013-01-28 08:52:12,2012-02-02 02:46:56,2012-04-16 01:31:45,873
34,170,120,324,"74 days, 2:51:31",2013-02-06 08:39:09,2012-02-02 02:46:56,2012-04-16 05:38:27,103
130,33,57,220,"76 days, 2:21:58",2013-02-05 06:39:41,2012-02-02 02:46:56,2012-04-18 05:08:54,446
286,0,0,286,"76 days, 23:35:33",2013-01-27 10:11:41,2012-02-02 02:46:56,2012-04-19 02:22:29,27
312,4,10,326,"77 days, 0:51:31",2013-02-07 06:16:32,2012-02-02 02:46:56,2012-04-19 03:38:27,269
7,1,0,8,"77 days, 19:42:45",2013-01-13 04:47:15,2012-07-09 08:27:07,2012-09-25 04:09:52,957
24,1,8,33,"77 days, 20:12:10",2013-01-25 11:41:09,2012-06-13 06:47:11,2012-08-30 02:59:21,757
319,48,117,484,"77 days, 22:04:26",2013-02-06 03:19:53,2012-02-02 02:46:56,2012-04-20 00:51:22,559
351,2,5,358,"78 days, 22:09:45",2013-02-14 00:16:35,2012-02-02 02:46:56,2012-04-21 00:56:41,177
18,40,136,194,"79 days, 20:24:59",2013-02-05 10:22:22,2012-04-12 04:11:32,2012-07-01 00:36:31,631
354,7,37,398,"80 days, 21:17:49",2013-01-31 00:01:17,2012-02-02 02:46:56,2012-04-23 00:04:45,387
94,28,36,158,"81 days, 5:52:53",2013-02-01 10:26:24,2012-02-02 02:46:56,2012-04-23 08:39:49,173
313,8,19,340,"81 days, 7:05:03",2013-02-02 04:58:24,2012-02-02 02:46:56,2012-04-23 09:51:59,212
201,4,27,232,"82 days, 8:52:45",2013-02-01 03:06:12,2012-02-02 02:46:56,2012-04-24 11:39:41,279
201,7,47,255,"83 days, 8:18:04",2013-02-03 09:53:48,2012-02-02 02:46:56,2012-04-25 11:05:00,276
22,0,16,38,"83 days, 22:23:32",2013-02-01 05:29:27,2012-02-02 02:46:56,2012-04-26 01:10:28,854
253,9,48,310,"84 days, 22:20:22",2013-02-05 06:12:39,2012-02-02 02:46:56,2012-04-27 01:07:18,346
93,1,9,103,"84 days, 23:31:06",2013-01-29 11:57:51,2012-02-02 02:46:56,2012-04-27 02:18:02,560
35,16,114,165,"85 days, 3:42:16",2013-02-04 03:56:16,2012-02-02 02:46:56,2012-04-27 06:29:12,490
150,84,98,332,"86 days, 7:28:48",2013-02-05 07:51:44,2012-02-02 02:46:56,2012-04-28 10:15:44,841
380,0,5,385,"88 days, 8:54:33",2013-01-31 04:21:21,2012-02-02 02:46:56,2012-04-30 11:41:29,600
250,18,33,301,"89 days, 5:22:08",2013-02-06 09:42:03,2012-04-09 06:07:30,2012-07-07 11:29:38,856
260,6,15,281,"89 days, 6:25:17",2013-01-29 10:56:02,2012-02-02 02:46:56,2012-05-01 09:12:13,217
77,19,26,122,"89 days, 19:47:55",2013-02-01 09:02:55,2012-06-25 06:00:26,2012-09-23 01:48:21,582
56,12,42,110,"89 days, 22:44:05",2013-02-04 01:37:40,2012-02-02 02:46:56,2012-05-02 01:31:01,161
15,23,137,175,"89 days, 22:46:23",2013-02-06 04:13:57,2012-02-02 02:46:56,2012-05-02 01:33:19,706
86,11,34,131,"90 days, 3:38:33",2013-01-25 11:01:03,2012-02-02 02:46:56,2012-05-02 06:25:29,335
223,0,56,279,"91 days, 2:01:22",2013-01-29 00:27:49,2012-02-02 02:46:56,2012-05-03 04:48:18,231
17,51,75,143,"91 days, 2:18:05",2013-01-29 10:54:51,2012-02-02 02:46:56,2012-05-03 05:05:01,493
20,3,46,69,"91 days, 4:42:25",2013-02-03 09:24:49,2012-02-02 02:46:56,2012-05-03 07:29:21,681
4,4,46,54,"91 days, 5:48:45",2013-02-01 03:18:56,2012-02-02 02:46:56,2012-05-03 08:35:41,988
5,1,3,9,"91 days, 12:42:25",2013-01-26 10:59:25,2012-06-23 11:25:35,2012-09-23 00:08:00,126
53,6,57,116,"92 days, 0:31:16",2013-02-01 05:21:29,2012-02-02 02:46:56,2012-05-04 03:18:12,449
110,16,74,200,"92 days, 3:27:01",2013-02-06 06:01:20,2012-02-02 02:46:56,2012-05-04 06:13:57,249
22,2,20,44,"92 days, 20:37:08",2013-02-06 09:02:08,2012-09-19 05:39:24,2012-12-21 02:16:32,148
22,0,26,48,"93 days, 8:54:54",2013-01-17 02:25:30,2012-03-01 01:10:47,2012-06-02 10:05:41,932
0,5,6,11,"93 days, 20:38:07",2013-01-13 04:46:30,2012-07-10 05:31:14,2012-10-12 02:09:21,371
3,7,55,65,"94 days, 3:00:09",2013-02-04 00:54:12,2012-03-24 03:42:03,2012-06-26 06:42:12,948
272,3,27,302,"94 days, 5:20:07",2013-01-29 04:19:26,2012-02-02 02:46:56,2012-05-06 08:07:03,388
74,1,1,76,"94 days, 6:36:47",2013-01-31 02:07:51,2012-03-21 01:01:03,2012-06-23 07:37:50,130
5,2,3,10,"95 days, 0:07:10",2013-01-25 04:59:19,2012-02-02 02:46:56,2012-05-07 02:54:06,187
365,2,13,380,"95 days, 3:12:35",2013-01-29 07:02:57,2012-02-02 02:46:56,2012-05-07 05:59:31,354
155,7,46,208,"95 days, 3:58:13",2013-01-29 04:41:10,2012-02-02 02:46:56,2012-05-07 06:45:09,204
95,0,11,106,"95 days, 23:28:25",2013-01-22 04:42:33,2012-02-02 02:46:56,2012-05-08 02:15:21,563
19,0,42,61,"96 days, 6:01:38",2013-01-31 07:20:28,2012-02-02 02:46:56,2012-05-08 08:48:34,178
160,1,5,166,"96 days, 9:03:32",2013-01-31 04:23:17,2012-02-02 02:46:56,2012-05-08 11:50:28,615
25,28,158,211,"99 days, 1:53:39",2013-02-04 09:41:40,2012-02-02 02:46:56,2012-05-11 04:40:35,205
5,26,47,78,"99 days, 4:03:58",2013-01-30 05:48:27,2012-02-02 02:46:56,2012-05-11 06:50:54,498
224,15,30,269,"99 days, 6:15:22",2013-01-25 03:23:50,2012-02-02 02:46:56,2012-05-11 09:02:18,419
134,1,21,156,"100 days, 4:43:53",2013-02-06 01:06:29,2012-02-02 02:46:56,2012-05-12 07:30:49,624
107,15,85,207,"100 days, 6:25:43",2013-01-29 11:03:25,2012-02-02 02:46:56,2012-05-12 09:12:39,534
126,48,86,260,"101 days, 8:50:16",2013-02-07 06:39:15,2012-02-02 02:46:56,2012-05-13 11:37:12,144
94,0,20,114,"102 days, 8:13:47",2013-01-18 05:46:09,2012-02-02 02:46:56,2012-05-14 11:00:43,381
3,11,59,73,"102 days, 13:51:53",2013-02-05 06:58:38,2012-04-08 11:05:10,2012-07-20 00:57:03,343
33,10,31,74,"102 days, 22:27:38",2013-02-02 09:32:53,2012-02-02 02:46:56,2012-05-15 01:14:34,646
70,0,85,155,"102 days, 22:54:41",2013-02-06 11:24:35,2012-02-02 02:46:56,2012-05-15 01:41:37,946
29,98,92,219,"103 days, 1:28:53",2013-02-05 04:42:59,2012-02-02 02:46:56,2012-05-15 04:15:49,969
101,44,80,225,"104 days, 23:45:42",2013-02-04 10:01:08,2012-02-02 02:46:56,2012-05-17 02:32:38,411
6,0,5,11,"107 days, 0:14:59",2012-12-15 05:07:41,2012-05-26 04:40:45,2012-09-10 04:55:44,809
35,40,60,135,"107 days, 0:16:58",2013-02-01 11:03:38,2012-02-02 02:46:56,2012-05-19 03:03:54,936
299,10,79,388,"108 days, 8:33:19",2013-02-03 08:37:42,2012-02-02 02:46:56,2012-05-20 11:20:15,707
230,0,4,234,"108 days, 23:02:54",2013-01-30 07:31:10,2012-02-02 02:46:56,2012-05-21 01:49:50,114
65,0,2,67,"111 days, 3:52:17",2013-02-01 07:26:41,2012-02-02 02:46:56,2012-05-23 06:39:13,203
72,1,13,86,"111 days, 21:23:16",2013-01-26 11:21:42,2012-02-02 02:46:56,2012-05-24 00:10:12,806
238,13,19,270,"111 days, 23:01:16",2013-02-01 07:56:40,2012-02-02 02:46:56,2012-05-24 01:48:12,787
3,1,7,11,"112 days, 2:22:49",2013-01-20 01:15:43,2012-04-21 08:53:18,2012-08-11 11:16:07,234
94,2,4,100,"113 days, 1:02:01",2013-02-10 08:01:10,2012-07-07 09:24:56,2012-10-28 10:26:57,521
116,1,8,125,"114 days, 13:24:54",2013-01-28 06:25:31,2012-05-14 10:45:28,2012-09-06 00:10:22,821
289,1,1,291,"114 days, 21:35:45",2013-01-18 00:09:12,2012-02-02 02:46:56,2012-05-27 00:22:41,917
81,0,5,86,"115 days, 23:44:00",2013-01-27 10:37:03,2012-02-02 02:46:56,2012-05-28 02:30:56,561
8,4,7,19,"116 days, 0:11:41",2013-01-24 02:37:31,2012-02-02 02:46:56,2012-05-28 02:58:37,902
1,8,5,14,"116 days, 12:10:46",2013-02-01 01:38:28,2012-04-11 11:55:28,2012-08-06 00:06:14,223
8,1,11,20,"118 days, 1:54:32",2013-01-23 02:20:15,2012-09-27 00:25:36,2013-01-23 02:20:08,837
78,0,6,84,"119 days, 5:23:13",2013-01-23 07:12:09,2012-02-02 02:46:56,2012-05-31 08:10:09,330
20,12,15,47,"119 days, 6:53:37",2013-02-01 08:17:08,2012-02-02 02:46:56,2012-05-31 09:40:33,926
126,0,6,132,"119 days, 21:55:26",2013-01-26 07:59:43,2012-02-02 02:46:56,2012-06-01 00:42:22,595
177,0,0,177,"120 days, 7:32:46",2013-01-24 10:52:47,2012-02-02 02:46:56,2012-06-01 10:19:42,44
128,0,4,132,"120 days, 22:43:56",2013-01-25 11:28:43,2012-02-02 02:46:56,2012-06-02 01:30:52,874
27,0,3,30,"121 days, 0:21:57",2013-01-25 03:46:28,2012-02-02 02:46:56,2012-06-02 03:08:53,710
2,1,3,6,"121 days, 4:23:57",2012-12-28 04:05:54,2012-05-11 07:34:09,2012-09-09 11:58:06,718
159,3,10,172,"121 days, 5:38:26",2013-01-25 02:12:52,2012-02-02 02:46:56,2012-06-02 08:25:22,535
8,7,38,53,"122 days, 1:47:29",2013-02-06 04:37:24,2012-02-02 02:46:56,2012-06-03 04:34:25,992
3,4,14,21,"122 days, 5:09:12",2013-02-01 09:24:56,2012-02-02 02:46:56,2012-06-03 07:56:08,258
5,1,18,24,"122 days, 23:39:57",2013-01-31 06:05:33,2012-02-02 02:46:56,2012-06-04 02:26:53,705
174,1,2,177,"125 days, 6:14:33",2013-02-05 06:54:59,2012-02-02 02:46:56,2012-06-06 09:01:29,994
81,1,4,86,"125 days, 22:39:26",2013-01-26 10:17:10,2012-02-02 02:46:56,2012-06-07 01:26:22,989
183,9,15,207,"126 days, 8:30:52",2013-02-04 00:11:14,2012-02-02 02:46:56,2012-06-07 11:17:48,972
5,2,53,60,"127 days, 1:30:31",2013-02-04 08:25:06,2012-02-02 02:46:56,2012-06-08 04:17:27,937
160,1,10,171,"128 days, 9:11:23",2013-01-26 07:19:37,2012-02-02 02:46:56,2012-06-09 11:58:19,363
3,1,12,16,"129 days, 22:12:01",2013-01-26 09:05:13,2012-02-02 02:46:56,2012-06-11 00:58:57,511
7,0,0,7,"129 days, 22:24:18",2013-01-30 09:49:38,2012-02-02 02:46:56,2012-06-11 01:11:14,57
52,10,28,90,"130 days, 0:09:55",2013-02-04 04:43:04,2012-02-02 02:46:56,2012-06-11 02:56:51,634
17,1,13,31,"130 days, 5:23:39",2013-02-03 05:36:18,2012-02-02 02:46:56,2012-06-11 08:10:35,142
81,3,31,115,"131 days, 22:35:43",2013-02-12 00:36:17,2012-02-02 02:46:56,2012-06-13 01:22:39,1
88,3,20,111,"132 days, 1:25:58",2013-01-26 04:26:24,2012-02-02 02:46:56,2012-06-13 04:12:54,85
186,4,4,194,"132 days, 3:36:24",2013-01-29 06:38:31,2012-02-02 02:46:56,2012-06-13 06:23:20,497
48,1,10,59,"132 days, 23:20:50",2013-01-17 05:19:51,2012-02-02 02:46:56,2012-06-14 02:07:46,881
46,1,4,51,"133 days, 6:13:15",2013-02-05 08:29:56,2012-02-02 02:46:56,2012-06-14 09:00:11,949
2,16,16,34,"133 days, 22:31:43",2013-01-29 11:20:24,2012-04-12 11:14:13,2012-08-24 09:45:56,293
99,0,5,104,"133 days, 22:49:32",2013-01-28 11:22:44,2012-02-02 02:46:56,2012-06-15 01:36:28,689
118,2,28,148,"134 days, 4:43:11",2013-02-05 01:44:33,2012-02-02 02:46:56,2012-06-15 07:30:07,536
258,1,0,259,"138 days, 6:36:02",2013-01-27 03:57:03,2012-02-02 02:46:56,2012-06-19 09:22:58,216
17,15,55,87,"139 days, 8:28:02",2013-02-02 08:27:48,2012-02-02 02:46:56,2012-06-20 11:14:58,207
5,0,0,5,"140 days, 0:51:39",2012-12-28 06:33:48,2012-02-02 02:46:56,2012-06-21 03:38:35,720
2,3,43,48,"141 days, 4:08:26",2013-02-03 10:14:55,2012-02-02 02:46:56,2012-06-22 06:55:22,829
5,0,1,6,"141 days, 6:05:00",2013-01-21 08:13:37,2012-05-28 04:19:29,2012-10-16 10:24:29,61
9,3,17,29,"141 days, 23:49:21",2013-01-26 04:12:29,2012-02-02 02:46:56,2012-06-23 02:36:17,436
2,1,9,12,"143 days, 23:59:08",2013-01-31 00:31:25,2012-02-02 02:46:56,2012-06-25 02:46:04,516
0,1,5,6,"144 days, 2:57:03",2012-11-22 08:20:29,2012-02-02 02:46:56,2012-06-25 05:43:59,527
25,1,11,37,"145 days, 1:04:29",2013-02-02 06:56:14,2012-02-02 02:46:56,2012-06-26 03:51:25,977
0,0,12,12,"145 days, 8:40:56",2013-01-30 07:13:48,2012-02-02 02:46:56,2012-06-26 11:27:52,190
49,54,87,190,"145 days, 22:01:43",2013-01-31 01:35:02,2012-02-02 02:46:56,2012-06-27 00:48:39,42
295,0,3,298,"147 days, 9:09:06",2013-01-31 07:04:03,2012-02-02 02:46:56,2012-06-28 11:56:02,602
133,1,6,140,"148 days, 0:22:30",2013-02-04 00:58:13,2012-02-02 02:46:56,2012-06-29 03:09:26,818
0,2,12,14,"148 days, 6:46:49",2013-01-30 03:19:59,2012-02-02 02:46:56,2012-06-29 09:33:45,75
237,1,13,251,"149 days, 3:35:24",2013-02-03 05:59:01,2012-02-02 02:46:56,2012-06-30 06:22:20,749
202,0,4,206,"149 days, 3:48:40",2013-01-27 07:26:04,2012-02-02 02:46:56,2012-06-30 06:35:36,638
154,29,21,204,"149 days, 16:44:16",2013-02-04 02:07:04,2012-04-25 09:21:50,2012-09-22 02:06:06,17
105,0,4,109,"150 days, 4:51:30",2013-02-03 05:38:57,2012-02-02 02:46:56,2012-07-01 07:38:26,331
122,8,1,131,"151 days, 23:28:57",2013-02-02 06:53:49,2012-02-02 02:46:56,2012-07-03 02:15:53,317
178,0,0,178,"152 days, 0:22:40",2012-11-20 05:24:05,2012-02-02 02:46:56,2012-07-03 03:09:36,990
2,0,5,7,"153 days, 7:40:12",2013-01-25 07:28:34,2012-02-02 02:46:56,2012-07-04 10:27:08,373
130,2,17,149,"153 days, 8:01:03",2013-01-22 05:32:33,2012-02-02 02:46:56,2012-07-04 10:47:59,235
172,23,67,262,"153 days, 23:43:37",2013-02-03 09:22:41,2012-02-02 02:46:56,2012-07-05 02:30:33,737
207,2,17,226,"154 days, 21:14:46",2013-01-24 10:01:54,2012-02-02 02:46:56,2012-07-06 00:01:42,185
111,20,29,160,"155 days, 4:34:16",2013-02-03 01:03:00,2012-02-02 02:46:56,2012-07-06 07:21:12,850
30,0,7,37,"156 days, 23:26:08",2013-01-30 11:04:09,2012-02-02 02:46:56,2012-07-08 02:13:04,247
135,0,2,137,"158 days, 2:32:25",2013-01-10 07:11:38,2012-02-02 02:46:56,2012-07-09 05:19:21,248
135,9,28,172,"158 days, 5:46:44",2013-02-02 03:30:11,2012-02-02 02:46:56,2012-07-09 08:33:40,79
0,2,16,18,"159 days, 0:42:53",2013-01-28 04:06:18,2012-02-02 02:46:56,2012-07-10 03:29:49,537
129,0,4,133,"160 days, 8:00:51",2013-01-31 04:30:15,2012-02-02 02:46:56,2012-07-11 10:47:47,816
49,5,100,154,"163 days, 8:47:30",2013-02-06 00:55:25,2012-02-02 02:46:56,2012-07-14 11:34:26,496
301,4,5,310,"163 days, 22:49:55",2013-01-31 02:57:47,2012-02-02 02:46:56,2012-07-15 01:36:51,687
143,0,4,147,"164 days, 3:38:31",2013-01-20 10:32:14,2012-02-02 02:46:56,2012-07-15 06:25:27,51
15,0,15,30,"164 days, 4:39:28",2013-01-24 09:16:51,2012-02-02 02:46:56,2012-07-15 07:26:24,374
143,0,3,146,"164 days, 7:57:11",2013-01-17 03:04:55,2012-02-02 02:46:56,2012-07-15 10:44:07,263
133,1,7,141,"164 days, 8:24:33",2013-01-11 05:48:02,2012-02-02 02:46:56,2012-07-15 11:11:29,508
44,3,51,98,"165 days, 9:05:29",2013-01-27 04:34:20,2012-02-02 02:46:56,2012-07-16 11:52:25,889
31,11,28,70,"167 days, 1:27:27",2013-02-04 04:29:29,2012-02-15 08:57:56,2012-07-31 10:25:23,150
198,0,0,198,"167 days, 7:29:14",2013-01-28 06:41:02,2012-02-02 02:46:56,2012-07-18 10:16:10,513
222,0,0,222,"169 days, 3:30:15",2013-01-31 02:13:14,2012-02-02 02:46:56,2012-07-20 06:17:11,77
23,6,14,43,"169 days, 7:33:09",2013-02-02 06:29:34,2012-02-02 02:46:56,2012-07-20 10:20:05,19
197,3,23,223,"173 days, 2:15:03",2013-01-30 09:57:34,2012-02-02 02:46:56,2012-07-24 05:01:59,257
177,1,3,181,"173 days, 4:51:28",2013-01-31 05:47:16,2012-02-02 02:46:56,2012-07-24 07:38:24,288
96,1,8,105,"173 days, 23:17:48",2013-01-17 04:04:06,2012-02-02 02:46:56,2012-07-25 02:04:44,765
1,3,32,36,"181 days, 23:58:25",2013-01-31 10:56:16,2012-02-02 02:46:56,2012-08-02 02:45:21,553
64,14,41,119,"185 days, 21:39:19",2013-01-31 05:39:19,2012-02-02 02:46:56,2012-08-06 00:26:15,384
2,0,0,2,"189 days, 1:00:54",2012-08-14 05:31:23,2012-08-14 05:31:23,2013-02-19 06:32:17,397
20,11,48,79,"191 days, 7:36:28",2013-01-30 06:23:05,2012-02-02 02:46:56,2012-08-11 10:23:24,857
115,0,0,115,"192 days, 5:19:39",2013-01-30 06:10:42,2012-02-02 02:46:56,2012-08-12 08:06:35,528
2,0,10,12,"193 days, 2:09:07",2013-01-22 10:36:57,2012-02-02 02:46:56,2012-08-13 04:56:03,314
21,5,15,41,"193 days, 21:54:46",2013-01-31 08:50:57,2012-02-02 02:46:56,2012-08-14 00:41:42,709
77,2,10,89,"194 days, 5:04:22",2013-02-06 00:46:15,2012-02-02 02:46:56,2012-08-14 07:51:18,963
144,0,6,150,"197 days, 1:08:31",2013-01-16 05:07:02,2012-02-02 02:46:56,2012-08-17 03:55:27,428
209,0,0,209,"199 days, 0:23:05",2013-01-25 10:04:30,2012-02-02 02:46:56,2012-08-19 03:10:01,113
4,0,0,4,"199 days, 5:12:22",2013-01-14 11:23:49,2012-02-02 02:46:56,2012-08-19 07:59:18,964
18,0,16,34,"200 days, 1:59:24",2013-01-30 00:55:17,2012-02-02 02:46:56,2012-08-20 04:46:20,355
66,0,4,70,"202 days, 1:24:22",2013-01-29 08:28:15,2012-02-02 02:46:56,2012-08-22 04:11:18,220
121,2,17,140,"203 days, 0:23:05",2013-01-28 02:25:00,2012-02-02 02:46:56,2012-08-23 03:10:01,671
101,17,26,144,"203 days, 5:55:17",2013-01-29 10:27:52,2012-02-02 02:46:56,2012-08-23 08:42:13,209
2,15,54,71,"207 days, 3:22:23",2013-02-05 01:00:25,2012-02-02 02:46:56,2012-08-27 06:09:19,588
8,3,0,11,"208 days, 0:34:24",2013-01-30 05:40:56,2012-06-24 10:39:33,2013-01-18 11:13:57,616
165,1,8,174,"208 days, 21:56:19",2013-01-31 09:36:22,2012-02-02 02:46:56,2012-08-29 00:43:15,412
4,0,0,4,"209 days, 5:44:19",2012-07-25 00:47:58,2012-07-25 00:47:58,2013-02-19 06:32:17,533
227,0,2,229,"212 days, 3:36:21",2013-01-25 11:40:39,2012-02-02 02:46:56,2012-09-01 06:23:17,242
78,1,8,87,"213 days, 1:09:41",2013-01-28 00:25:09,2012-02-02 02:46:56,2012-09-02 03:56:37,577
56,2,2,60,"216 days, 3:07:41",2013-01-29 00:11:02,2012-06-02 07:02:06,2013-01-04 10:09:47,684
31,2,8,41,"216 days, 4:30:13",2013-02-06 08:00:17,2012-02-02 02:46:56,2012-09-05 07:17:09,865
37,0,11,48,"217 days, 7:46:58",2013-01-29 06:58:47,2012-02-02 02:46:56,2012-09-06 10:33:54,128
57,0,10,67,"218 days, 21:56:55",2013-02-04 10:16:08,2012-02-02 02:46:56,2012-09-08 00:43:51,594
61,4,5,70,"219 days, 4:22:31",2013-02-06 06:22:59,2012-02-02 02:46:56,2012-09-08 07:09:27,25
118,1,5,124,"219 days, 6:02:44",2013-01-14 10:05:52,2012-02-02 02:46:56,2012-09-08 08:49:40,87
92,0,0,92,"221 days, 23:00:50",2013-01-26 03:48:44,2012-02-02 02:46:56,2012-09-11 01:47:46,580
75,1,4,80,"225 days, 4:15:51",2013-01-23 02:01:46,2012-02-02 02:46:56,2012-09-14 07:02:47,391
123,0,2,125,"226 days, 6:13:22",2013-01-28 05:31:55,2012-02-02 02:46:56,2012-09-15 09:00:18,210
36,0,2,38,"227 days, 22:00:05",2013-01-31 03:01:53,2012-02-02 02:46:56,2012-09-17 00:47:01,201
2,0,0,2,"228 days, 0:01:02",2012-12-05 00:44:43,2012-02-02 02:46:56,2012-09-17 02:47:58,769
128,0,5,133,"228 days, 23:29:22",2013-01-29 04:12:55,2012-02-02 02:46:56,2012-09-18 02:16:18,400
5,0,11,16,"230 days, 7:32:52",2013-01-31 10:23:13,2012-02-02 02:46:56,2012-09-19 10:19:48,140
4,0,4,8,"233 days, 4:48:21",2013-01-30 03:50:45,2012-02-02 02:46:56,2012-09-22 07:35:17,914
144,4,4,152,"236 days, 8:49:11",2013-01-27 09:04:21,2012-02-02 02:46:56,2012-09-25 11:36:07,898
0,1,1,2,"239 days, 20:01:02",2012-11-19 07:32:23,2012-03-24 11:31:21,2012-11-19 07:32:23,636
77,1,5,83,"243 days, 8:06:08",2013-01-23 08:38:05,2012-02-02 02:46:56,2012-10-02 10:53:04,774
116,0,6,122,"244 days, 7:19:23",2013-02-07 03:32:19,2012-02-02 02:46:56,2012-10-03 10:06:19,256
1,0,4,5,"245 days, 6:57:59",2013-01-27 01:08:18,2012-02-02 02:46:56,2012-10-04 09:44:55,470
125,1,0,126,"246 days, 0:30:41",2013-01-27 07:50:08,2012-02-02 02:46:56,2012-10-05 03:17:37,739
2,0,8,10,"248 days, 2:27:46",2013-02-02 02:09:55,2012-02-02 02:46:56,2012-10-07 05:14:42,313
89,1,1,91,"252 days, 0:01:24",2013-02-02 00:05:31,2012-02-02 02:46:56,2012-10-11 02:48:20,551
190,0,0,190,"254 days, 1:37:53",2013-01-29 10:00:29,2012-02-02 02:46:56,2012-10-13 04:24:49,764
0,1,3,4,"255 days, 7:55:42",2012-12-31 11:54:33,2012-02-02 02:46:56,2012-10-14 10:42:38,268
31,0,1,32,"259 days, 4:31:12",2013-01-30 04:52:49,2012-02-02 02:46:56,2012-10-18 07:18:08,730
74,2,1,77,"263 days, 2:24:41",2013-02-02 02:03:21,2012-02-02 02:46:56,2012-10-22 05:11:37,747
78,0,0,78,"264 days, 23:46:48",2013-01-24 04:09:50,2012-02-02 02:46:56,2012-10-24 02:33:44,215
30,5,1,36,"265 days, 4:25:23",2013-02-04 01:43:00,2012-02-02 02:46:56,2012-10-24 07:12:19,433
56,0,5,61,"266 days, 1:53:29",2013-01-25 01:31:52,2012-02-02 02:46:56,2012-10-25 04:40:25,628
16,2,1,19,"267 days, 0:48:51",2013-02-05 03:29:59,2012-03-28 08:04:19,2012-12-20 08:53:10,912
12,1,2,15,"275 days, 2:40:02",2013-01-31 02:58:02,2012-02-02 02:46:56,2012-11-03 05:26:58,952
0,0,7,7,"280 days, 1:47:13",2012-12-16 03:12:33,2012-02-02 02:46:56,2012-11-08 04:34:09,847
52,1,2,55,"280 days, 6:50:49",2013-01-25 06:56:20,2012-02-02 02:46:56,2012-11-08 09:37:45,920
152,0,0,152,"280 days, 9:01:42",2013-01-30 09:46:08,2012-02-02 02:46:56,2012-11-08 11:48:38,478
0,0,2,2,"280 days, 22:14:32",2013-01-01 06:33:02,2012-02-02 02:46:56,2012-11-09 01:01:28,883
96,0,0,96,"281 days, 6:50:02",2013-01-26 04:04:26,2012-02-02 02:46:56,2012-11-09 09:36:58,758
74,0,1,75,"285 days, 21:19:05",2013-01-30 09:36:54,2012-02-02 02:46:56,2012-11-14 00:06:01,94
44,0,0,44,"289 days, 4:09:04",2013-01-25 07:23:25,2012-02-02 02:46:56,2012-11-17 06:56:00,137
70,0,1,71,"291 days, 1:30:33",2013-01-28 04:48:10,2012-02-02 02:46:56,2012-11-19 04:17:29,159
87,0,0,87,"293 days, 21:41:39",2013-01-19 08:25:44,2012-02-02 02:46:56,2012-11-22 00:28:35,392
5,0,0,5,"333 days, 0:45:36",2012-12-31 03:32:36,2012-02-02 02:46:56,2012-12-31 03:32:32,106
42,0,3,45,"336 days, 21:31:57",2013-01-20 02:46:11,2012-02-02 02:46:56,2013-01-04 00:18:53,981
5,0,0,5,"339 days, 2:39:59",2013-01-31 09:32:13,2012-02-02 02:46:56,2013-01-06 05:26:55,2
0,1,2,3,"340 days, 7:11:02",2013-02-03 06:42:36,2012-02-02 02:46:56,2013-01-07 09:57:58,431
1,0,0,1,"354 days, 0:39:54",2013-01-21 03:26:50,2012-02-02 02:46:56,2013-01-21 03:26:50,605
16,0,0,16,"363 days, 22:04:04",2013-01-31 02:30:23,2012-02-02 02:46:56,2013-01-31 00:51:00,999
